"","season","team","Clutch_Shots_Attempted","Clutch_Shots_Made","Clutch_FG_Percentage","tORB","tDRB","FTa","FTm","tDunks","tPF","tTF","tMadeLayups","tMissedLayups","tLayupAttempts","tSteals","tTurnovers","t2Pt_Attempts","t2Pt_Makes","t2Pt_Misses","t3Pt_Attempts","t3Pt_Makes","t3Pt_Misses","success_conv","oRebConv_rate","tPossessions","STL_Percentage"
"1",2008,"Fairfield",1,1,100,73,123,33,17,0,76,0,53,44,97,40,0,142,50,92,85,33,52,25,0.342465753424658,340,11.7647058823529
"2",2008,"Iowa State",2,2,100,315,630,273,173,0,334,1,100,69,169,125,0,631,260,371,583,218,365,89,0.282539682539683,1597,7.82717595491547
"3",2008,"Virginia",3,3,100,334,616,402,258,0,404,2,393,262,655,171,0,578,179,399,265,103,162,100,0.29940119760479,1751,9.76584808680754
"4",2009,"Louisville",1,1,100,444,737,425,282,0,522,3,335,206,541,270,0,770,260,510,378,120,258,111,0.25,2016,13.3928571428571
"5",2012,"Austin Peay",1,1,100,74,132,78,47,0,122,0,41,37,78,61,0,156,45,111,125,38,87,16,0.216216216216216,346,17.6300578034682
"6",2013,"Cincinnati",1,1,100,321,619,351,223,0,414,2,246,219,465,179,0,661,189,472,285,74,211,73,0.227414330218069,1540,11.6233766233766
"7",2013,"Kansas State",1,1,100,331,635,263,176,0,407,0,291,223,514,241,0,339,83,256,876,267,609,76,0.229607250755287,1680,14.3452380952381
"8",2013,"Minnesota",2,2,100,385,820,421,289,0,606,0,151,110,261,238,0,1183,522,661,406,140,266,104,0.27012987012987,2123,11.2105511069242
"9",2013,"Notre Dame",1,1,100,618,956,545,400,0,512,3,598,430,1028,394,0,832,294,538,464,158,306,152,0.245954692556634,2797,14.0865212727923
"10",2014,"BYU",1,1,100,97,262,116,74,0,151,1,68,38,106,30,141,188,59,129,159,58,101,29,0.298969072164948,707,4.24328147100424
"11",2014,"Fairfield",1,1,100,50,122,51,32,0,70,0,57,45,102,16,85,83,28,55,75,27,48,14,0.28,377,4.24403183023873
"12",2014,"Hampton",1,1,100,99,134,106,62,0,115,1,37,40,77,43,75,163,42,121,114,31,83,18,0.181818181818182,440,9.77272727272727
"13",2010,"LSU",6,4,66.7,348,611,372,241,0,348,4,223,136,359,224,0,801,283,518,296,90,206,76,0.218390804597701,1652,13.5593220338983
"14",2011,"Louisiana Tech",3,2,66.7,54,94,57,32,0,74,0,45,36,81,49,0,108,38,70,70,23,47,13,0.240740740740741,268,18.2835820895522
"15",2008,"Saint Louis",2,1,50,175,271,142,99,0,218,0,116,105,221,48,0,305,99,206,126,31,95,46,0.262857142857143,739,6.49526387009472
"16",2008,"Utah",2,1,50,258,580,264,177,0,337,0,240,82,322,175,0,537,196,341,317,124,193,59,0.228682170542636,1468,11.9209809264305
"17",2009,"Charleston",2,1,50,62,108,41,26,0,89,1,36,44,80,40,0,124,44,80,78,27,51,14,0.225806451612903,289,13.840830449827
"18",2009,"Milwaukee",2,1,50,67,136,67,42,0,81,0,44,39,83,33,0,141,50,91,87,27,60,17,0.253731343283582,342,9.64912280701754
"19",2009,"Rutgers",4,2,50,402,621,348,226,0,498,2,263,189,452,183,0,746,272,474,399,135,264,107,0.266169154228856,1805,10.1385041551247
"20",2009,"Western Carolina",2,1,50,43,80,49,30,0,46,0,16,24,40,14,0,105,33,72,45,20,25,9,0.209302325581395,204,6.86274509803922
"21",2012,"Arkansas",2,1,50,432,640,366,219,0,422,6,290,164,454,269,0,687,205,482,496,145,351,106,0.24537037037037,1820,14.7802197802198
"22",2012,"Kansas",2,1,50,333,696,288,178,0,428,2,338,189,527,224,0,845,313,532,306,104,202,101,0.303303303303303,1858,12.0559741657696
"23",2013,"Duquesne",2,1,50,157,224,115,70,0,180,0,99,74,173,129,0,297,89,208,167,41,126,38,0.24203821656051,642,20.0934579439252
"24",2013,"Villanova",4,2,50,259,679,228,140,0,365,1,241,172,413,197,0,455,153,302,664,214,450,59,0.227799227799228,1602,12.2971285892634
"25",2014,"Auburn",2,1,50,446,731,460,281,0,600,2,387,254,641,306,520,792,262,530,325,84,241,123,0.275784753363229,2529,12.0996441281139
"26",2014,"Sacred Heart",2,1,50,29,54,25,17,0,48,0,29,19,48,7,39,47,20,27,49,16,33,7,0.241379310344828,193,3.62694300518135
"27",2010,"Ole Miss",5,2,40,193,293,179,108,0,255,2,135,86,221,92,0,300,102,198,272,88,184,49,0.253886010362694,855,10.7602339181287
"28",2013,"Syracuse",5,2,40,483,747,396,257,0,353,2,336,219,555,347,0,669,225,444,560,169,391,126,0.260869565217391,2071,16.7551907291164
"29",2012,"Nebraska",14,5,35.7,450,782,452,299,0,458,0,235,158,393,240,0,724,256,468,656,194,462,106,0.235555555555556,2037,11.7820324005891
"30",2009,"Iowa",3,1,33.3,279,634,292,211,0,338,1,136,53,189,120,0,739,283,456,391,150,241,71,0.254480286738351,1554,7.72200772200772
"31",2011,"Virginia",6,2,33.3,178,315,215,144,0,299,0,100,116,216,124,0,397,126,271,210,62,148,33,0.185393258426966,839,14.7794994040524
"32",2013,"Arizona State",3,1,33.3,384,601,290,178,0,461,1,287,282,569,239,0,520,166,354,409,105,304,79,0.205729166666667,1625,14.7076923076923
"33",2013,"Oregon",3,1,33.3,430,858,361,232,0,434,3,214,219,433,186,0,731,215,516,634,171,463,73,0.169767441860465,1992,9.33734939759036
"34",2013,"Portland State",3,1,33.3,52,81,48,29,0,60,0,26,32,58,25,0,112,32,80,42,13,29,15,0.288461538461538,219,11.4155251141553
"35",2013,"Virginia",3,1,33.3,339,622,325,219,0,399,0,240,241,481,217,0,525,192,333,355,102,253,73,0.215339233038348,1602,13.5455680399501
"36",2014,"Kentucky",3,1,33.3,508,864,577,354,0,656,3,411,244,655,315,505,862,294,568,518,178,340,114,0.224409448818898,2907,10.8359133126935
"37",2014,"Wyoming",7,2,28.6,49,89,64,39,0,51,0,23,17,40,26,43,104,30,74,59,16,43,12,0.244897959183673,266,9.77443609022556
"38",2008,"Duquesne",4,1,25,276,515,327,209,0,326,1,220,181,401,138,0,431,134,297,358,119,239,78,0.282608695652174,1349,10.229799851742
"39",2011,"NC State",4,1,25,161,294,180,113,0,214,0,118,67,185,95,0,362,135,227,191,56,135,39,0.24223602484472,816,11.6421568627451
"40",2012,"Purdue",8,2,25,433,776,411,269,0,540,2,160,146,306,291,0,1090,446,644,442,140,302,106,0.244803695150115,2060,14.126213592233
"41",2013,"George Washington",4,1,25,136,208,115,63,0,163,2,87,76,163,85,0,231,61,170,108,32,76,28,0.205882352941176,553,15.370705244123
"42",2014,"Baylor",4,1,25,634,1112,654,435,0,687,8,547,325,872,262,459,1049,361,688,593,199,394,209,0.329652996845426,3482,7.52441125789776
"43",2010,"Kansas",5,1,20,163,382,183,123,0,274,0,155,108,263,87,0,400,147,253,165,54,111,36,0.220858895705521,953,9.12906610703043
"44",2007,"Kentucky",1,0,0,154,303,137,86,0,183,0,126,88,214,11,0,290,95,195,162,42,120,30,0.194805194805195,755,1.45695364238411
"45",2007,"Mississippi State",1,0,0,30,57,20,13,0,39,0,26,15,41,7,0,48,13,35,51,14,37,6,0.2,147,4.76190476190476
"46",2008,"Colorado",3,0,0,241,488,225,157,0,316,1,198,150,348,106,0,343,129,214,411,129,282,60,0.24896265560166,1240,8.54838709677419
"47",2008,"Fordham",3,0,0,199,427,196,125,0,327,0,138,144,282,119,0,448,133,315,316,83,233,35,0.175879396984925,1031,11.5421920465567
"48",2008,"Georgia Tech",3,0,0,250,321,255,161,0,319,4,195,170,365,209,0,406,150,256,262,93,169,64,0.256,1081,19.3339500462535
"49",2008,"Maryland",1,0,0,284,645,413,281,0,329,3,296,182,478,62,0,436,182,254,330,112,218,82,0.288732394366197,1631,3.80134886572655
"50",2008,"Oral Roberts",1,0,0,117,261,138,83,0,207,1,104,106,210,89,0,223,86,137,203,70,133,22,0.188034188034188,677,13.1462333825702
"51",2008,"Stanford",2,0,0,233,530,238,160,0,269,1,232,152,384,21,0,388,136,252,321,112,209,59,0.253218884120172,1315,1.59695817490494
"52",2008,"Tulsa",4,0,0,221,404,212,120,0,237,1,161,102,263,145,0,413,131,282,199,63,136,64,0.289592760180996,1032,14.0503875968992
"53",2008,"UAB",3,0,0,100,215,83,60,0,140,0,81,49,130,65,0,193,66,127,172,62,110,23,0.23,547,11.8829981718464
"54",2009,"Georgetown",1,0,0,176,269,177,102,0,247,1,86,96,182,101,0,271,83,188,225,72,153,29,0.164772727272727,734,13.7602179836512
"55",2009,"Penn State",1,0,0,233,456,221,139,0,314,0,179,141,320,123,0,500,164,336,240,75,165,53,0.227467811158798,1179,10.4325699745547
"56",2009,"Wisconsin",3,0,0,256,591,293,182,0,445,1,209,182,391,206,0,659,215,444,351,120,231,66,0.2578125,1479,13.9283299526707
"57",2010,"Clemson",1,0,0,209,332,180,105,0,246,0,165,148,313,143,0,339,103,236,215,60,155,46,0.220095693779904,917,15.5943293347873
"58",2010,"Georgetown",2,0,0,273,338,171,115,0,300,2,108,108,216,186,0,416,135,281,358,108,250,58,0.212454212454212,1008,18.452380952381
"59",2010,"North Carolina",1,0,0,473,758,468,281,0,480,2,122,140,262,279,0,1118,497,621,398,116,282,127,0.268498942917548,2098,13.2983794089609
"60",2010,"South Carolina",1,0,0,168,274,163,90,0,199,0,119,72,191,90,0,347,108,239,149,47,102,44,0.261904761904762,753,11.9521912350598
"61",2010,"Virginia",2,0,0,353,585,358,232,0,427,2,287,225,512,273,0,655,227,428,333,81,252,91,0.257790368271955,1638,16.6666666666667
"62",2011,"Fresno State",3,0,0,82,104,77,51,0,92,0,45,64,109,62,0,70,21,49,141,43,98,12,0.146341463414634,309,20.0647249190939
"63",2011,"New Mexico",2,0,0,18,55,20,13,0,43,0,14,12,26,23,0,66,21,45,31,11,20,7,0.388888888888889,124,18.5483870967742
"64",2011,"Oklahoma State",2,0,0,181,297,166,107,0,265,0,114,98,212,93,0,340,105,235,229,55,174,48,0.265193370165746,795,11.6981132075472
"65",2012,"Florida",2,0,0,529,740,371,217,0,510,2,364,282,646,267,0,644,214,430,555,163,392,105,0.198487712665406,2093,12.7568084089823
"66",2012,"Iowa State",1,0,0,320,735,366,244,0,386,1,189,88,277,163,0,545,176,369,611,202,409,89,0.278125,1721,9.4712376525276
"67",2012,"Morehead State",1,0,0,18,26,18,11,0,23,0,14,11,25,10,0,24,8,16,19,7,12,1,0.0555555555555556,77,12.987012987013
"68",2012,"Northern Arizona",1,0,0,51,98,41,23,0,77,0,34,25,59,41,0,104,23,81,82,29,53,12,0.235294117647059,245,16.734693877551
"69",2012,"Virginia",4,0,0,457,678,443,301,0,476,2,328,288,616,413,0,784,252,532,411,117,294,113,0.2472647702407,1945,21.2339331619537
"70",2013,"Alabama",2,0,0,374,567,335,196,0,439,9,195,181,376,248,0,753,215,538,529,133,396,78,0.20855614973262,1559,15.9076330981398
"71",2013,"Arizona",3,0,0,352,625,320,207,0,371,1,255,232,487,219,0,597,173,424,456,136,320,68,0.193181818181818,1621,13.5101789019124
"72",2013,"Boston College",1,0,0,249,653,286,190,0,436,0,294,265,559,217,0,385,130,255,585,196,389,52,0.208835341365462,1599,13.5709818636648
"73",2013,"Dayton",1,0,0,353,695,323,206,0,386,1,329,173,502,232,0,617,213,404,460,150,310,96,0.271954674220963,1824,12.719298245614
"74",2013,"Ohio State",2,0,0,302,706,352,233,0,349,1,360,224,584,209,0,576,206,370,413,125,288,78,0.258278145695364,1808,11.5597345132743
"75",2013,"Pittsburgh",6,0,0,399,646,323,195,0,418,3,251,183,434,178,0,828,245,583,315,83,232,90,0.225563909774436,1701,10.4644326866549
"76",2013,"Providence",2,0,0,364,529,244,166,0,432,1,259,250,509,220,0,742,224,518,332,89,243,86,0.236263736263736,1531,14.3696930111039
"77",2013,"St. John's",2,0,0,317,655,350,226,0,363,2,231,172,403,204,0,758,261,497,249,69,180,82,0.258675078864353,1616,12.6237623762376
"78",2013,"Wake Forest",1,0,0,331,522,300,178,0,456,5,333,226,559,190,0,491,130,361,376,123,253,87,0.262839879154079,1519,12.5082290980909
"79",2013,"Washington State",2,0,0,394,760,311,193,0,494,1,277,268,545,282,0,808,252,556,480,117,363,77,0.195431472081218,1889,14.9285336156697
"80",2013,"Western Illinois",1,0,0,56,119,60,37,0,71,0,53,37,90,50,0,76,30,46,131,56,75,12,0.214285714285714,329,15.1975683890577
"81",2014,"Alabama",2,0,0,376,679,419,243,0,490,1,239,145,384,211,453,761,246,515,503,154,349,96,0.25531914893617,2250,9.37777777777778
"82",2014,"Bryant",1,0,0,33,54,24,15,0,21,0,38,45,83,18,31,30,7,23,22,10,12,12,0.363636363636364,179,10.0558659217877
"83",2014,"Colorado State",3,0,0,43,114,77,54,0,83,1,44,27,71,25,40,96,33,63,94,18,76,15,0.348837209302326,307,8.14332247557003
"84",2014,"Creighton",1,0,0,115,258,108,69,0,195,1,73,72,145,57,127,178,54,124,247,71,176,22,0.191304347826087,720,7.91666666666667
"85",2014,"Kansas State",1,0,0,281,527,295,182,0,479,1,218,170,388,160,375,410,139,271,515,146,369,70,0.249110320284698,1739,9.20069005175388
"86",2014,"Mississippi State",1,0,0,536,780,668,433,0,687,3,244,132,376,318,542,1270,437,833,359,108,251,130,0.242537313432836,2823,11.2646121147715
"87",2014,"St. John's",1,0,0,88,188,122,71,0,177,0,97,76,173,44,134,173,55,118,78,27,51,26,0.295454545454545,614,7.16612377850163
"88",2015,"Florida Gulf Coast",1,1,100,115,287,148,95,0,199,0,163,132,295,96,143,70,14,56,321,113,208,33,0.28695652173913,872,11.0091743119266
"89",2015,"LSU",1,1,100,431,656,381,227,0,564,0,289,186,475,315,500,966,317,649,271,95,176,119,0.276102088167053,2367,13.3079847908745
"90",2015,"Texas",2,2,100,458,931,463,289,0,618,0,390,239,629,227,536,931,319,612,409,123,286,142,0.310043668122271,2864,7.92597765363128
"91",2016,"Abilene Christian",2,2,100,58,67,57,36,0,57,0,12,22,34,27,56,75,19,56,77,19,58,12,0.206896551724138,238,11.3445378151261
"92",2016,"American University",1,1,100,50,92,45,31,0,84,0,33,32,65,19,63,92,37,55,67,22,45,15,0.3,310,6.12903225806452
"93",2016,"Appalachian State",1,1,100,53,94,41,29,0,86,1,21,15,36,28,70,127,36,91,52,8,44,14,0.264150943396226,297,9.42760942760943
"94",2016,"Coastal Carolina",1,1,100,26,42,29,20,0,36,0,20,16,36,25,29,41,17,24,42,8,34,9,0.346153846153846,151,16.5562913907285
"95",2016,"Delaware State",1,1,100,35,64,31,16,0,57,0,32,27,59,13,59,66,15,51,45,11,34,10,0.285714285714286,221,5.88235294117647
"96",2016,"East Tennessee State",1,1,100,33,79,45,25,0,65,1,23,29,52,28,89,63,21,42,75,29,46,8,0.242424242424242,286,9.79020979020979
"97",2016,"Florida Gulf Coast",1,1,100,92,241,97,61,0,129,0,115,135,250,55,79,47,13,34,247,84,163,24,0.260869565217391,652,8.43558282208589
"98",2016,"Houston",1,1,100,63,104,44,25,0,91,0,36,61,97,41,87,125,29,96,85,28,57,11,0.174603174603175,359,11.4206128133705
"99",2016,"IUPUI",1,1,100,44,88,39,23,0,75,0,37,21,58,24,84,72,27,45,75,17,58,11,0.25,309,7.76699029126214
"100",2016,"Jacksonville",2,2,100,108,211,109,63,0,171,1,86,90,176,67,150,172,49,123,113,32,81,40,0.37037037037037,661,10.1361573373676
"101",2016,"Louisiana",1,1,100,57,111,73,46,0,92,2,62,39,101,49,72,120,39,81,61,17,44,16,0.280701754385965,379,12.9287598944591
"102",2016,"Loyola Maryland",1,1,100,34,85,40,23,0,70,0,36,39,75,24,54,56,17,39,67,22,45,8,0.235294117647059,254,9.4488188976378
"103",2016,"Monmouth",1,1,100,20,67,32,20,0,38,0,25,20,45,11,37,24,6,18,41,11,30,8,0.4,172,6.3953488372093
"104",2016,"Old Dominion",1,1,100,90,167,103,66,0,126,0,50,60,110,35,110,150,39,111,111,32,79,22,0.244444444444444,514,6.80933852140078
"105",2016,"Oral Roberts",2,2,100,66,163,60,30,0,134,0,60,57,117,51,111,134,41,93,152,49,103,15,0.227272727272727,502,10.1593625498008
"106",2016,"Pennsylvania",1,1,100,18,49,13,9,0,28,0,9,11,20,10,35,40,14,26,54,15,39,4,0.222222222222222,146,6.84931506849315
"107",2016,"Purdue Fort Wayne",1,1,100,35,35,26,17,0,52,0,21,31,52,15,29,37,13,24,42,12,30,7,0.2,150,10
"108",2016,"Rider",3,3,100,23,48,46,29,0,47,0,15,27,42,27,52,35,11,24,28,8,20,1,0.0434782608695652,167,16.1676646706587
"109",2016,"South Carolina Upstate",1,1,100,79,150,77,50,0,91,1,58,51,109,34,98,183,49,134,86,25,61,25,0.316455696202532,481,7.06860706860707
"110",2016,"Stephen F. Austin",1,1,100,24,27,18,11,0,40,0,27,27,54,20,28,32,10,22,38,13,25,4,0.166666666666667,137,14.5985401459854
"111",2016,"Troy",1,1,100,72,118,48,36,0,88,0,36,38,74,53,95,156,43,113,102,26,76,26,0.361111111111111,404,13.1188118811881
"112",2016,"UMass",1,1,100,50,108,66,38,0,69,0,48,53,101,21,65,94,35,59,51,11,40,13,0.26,333,6.30630630630631
"113",2016,"Vermont",2,2,100,27,50,27,14,0,34,0,11,8,19,9,50,44,16,28,45,9,36,3,0.111111111111111,167,5.38922155688623
"114",2016,"Xavier",1,1,100,33,63,43,24,0,41,0,34,37,71,21,52,39,10,29,49,11,38,13,0.393939393939394,214,9.81308411214953
"115",2017,"Alcorn State",1,1,100,63,88,63,30,0,111,0,32,40,72,51,99,142,34,108,87,24,63,13,0.206349206349206,348,14.6551724137931
"116",2017,"Army",1,1,100,69,67,60,35,0,60,0,22,29,51,28,37,99,28,71,50,12,38,14,0.202898550724638,247,11.336032388664
"117",2017,"Campbell",1,1,100,31,52,29,17,0,45,0,24,32,56,15,30,22,6,16,43,11,32,3,0.0967741935483871,158,9.49367088607595
"118",2017,"East Carolina",1,1,100,53,112,56,31,0,107,0,58,58,116,31,98,92,26,66,62,19,43,14,0.264150943396226,379,8.17941952506596
"119",2017,"Fordham",1,1,100,90,158,64,45,0,114,1,45,49,94,23,84,147,47,100,156,39,117,21,0.233333333333333,477,4.82180293501048
"120",2017,"George Mason",1,1,100,23,45,32,20,0,31,0,10,10,20,21,31,66,28,38,31,6,25,7,0.304347826086957,150,14
"121",2017,"Jacksonville",1,1,100,81,124,94,56,0,132,4,65,60,125,41,120,109,34,75,88,25,63,22,0.271604938271605,478,8.57740585774059
"122",2017,"Montana State",3,3,100,60,128,45,35,0,60,0,32,45,77,23,52,80,26,54,100,25,75,18,0.3,331,6.94864048338369
"123",2017,"Pittsburgh",2,2,100,247,641,254,174,0,479,1,293,243,536,204,418,478,175,303,489,139,350,71,0.287449392712551,1970,10.3553299492386
"124",2017,"Quinnipiac",1,1,100,66,150,86,54,0,127,1,59,65,124,50,78,94,35,59,131,37,94,17,0.257575757575758,444,11.2612612612613
"125",2017,"Saint Louis",1,1,100,85,193,98,65,0,135,0,93,81,174,59,101,139,55,84,162,53,109,22,0.258823529411765,606,9.73597359735974
"126",2017,"South Alabama",1,1,100,53,89,38,22,0,63,1,13,31,44,29,79,86,18,68,75,24,51,12,0.226415094339623,284,10.2112676056338
"127",2017,"Toledo",2,2,100,65,173,75,47,0,108,2,91,80,171,44,106,87,32,55,102,37,65,18,0.276923076923077,522,8.42911877394636
"128",2017,"Xavier",1,1,100,51,125,52,34,0,71,0,57,64,121,34,76,81,24,57,85,24,61,9,0.176470588235294,372,9.13978494623656
"129",2018,"Denver",1,1,100,13,20,5,5,0,19,0,6,10,16,4,12,19,4,15,29,14,15,3,0.230769230769231,71,5.63380281690141
"130",2018,"Elon",1,1,100,61,143,50,28,0,86,1,66,55,121,32,83,86,36,50,79,21,58,10,0.163934426229508,421,7.60095011876485
"131",2018,"Florida Atlantic",1,1,100,39,62,47,32,0,52,1,35,35,70,23,38,82,21,61,48,17,31,10,0.256410256410256,229,10.0436681222707
"132",2018,"Green Bay",2,2,100,298,694,319,194,0,385,0,341,223,564,222,303,348,134,214,405,133,272,92,0.308724832214765,1979,11.2177867609904
"133",2018,"High Point",1,1,100,56,88,45,28,0,89,0,25,46,71,26,72,86,28,58,76,25,51,13,0.232142857142857,302,8.60927152317881
"134",2018,"Houston",2,2,100,82,170,93,58,0,121,3,70,73,143,65,93,122,34,88,119,41,78,20,0.24390243902439,507,12.8205128205128
"135",2018,"Kent State",2,2,100,38,91,39,25,0,60,0,25,22,47,19,72,85,27,58,79,28,51,10,0.263157894736842,290,6.55172413793103
"136",2018,"LIU Brooklyn",1,1,100,27,58,30,16,0,45,0,23,30,53,17,50,42,18,24,55,15,40,4,0.148148148148148,197,8.62944162436548
"137",2018,"Lafayette",2,2,100,28,52,13,9,0,35,0,11,20,31,16,42,50,10,40,35,15,20,5,0.178571428571429,163,9.8159509202454
"138",2018,"Lipscomb",1,1,100,29,92,43,28,0,75,0,35,38,73,33,49,58,15,43,116,48,68,10,0.344827586206897,279,11.8279569892473
"139",2018,"Monmouth",1,1,100,47,96,27,16,0,64,1,42,44,86,22,89,52,17,35,74,18,56,11,0.234042553191489,317,6.94006309148265
"140",2018,"Oregon",3,3,100,339,797,357,241,0,414,2,422,216,638,231,363,379,147,232,638,256,382,84,0.247787610619469,2403,9.61298377028714
"141",2018,"Saint Joseph's",2,2,100,71,155,79,56,0,101,0,86,69,155,41,97,145,45,100,71,17,54,15,0.211267605633803,490,8.36734693877551
"142",2018,"San Diego",1,1,100,48,63,32,23,0,47,0,24,26,50,21,52,98,41,57,30,8,22,18,0.375,245,8.57142857142857
"143",2018,"South Dakota",5,5,100,92,217,82,55,0,152,0,97,61,158,61,115,144,48,96,246,88,158,23,0.25,677,9.01033973412112
"144",2018,"Stony Brook",1,1,100,26,57,17,8,0,28,0,26,22,48,15,33,24,4,20,55,12,43,10,0.384615384615385,161,9.3167701863354
"145",2018,"Tulsa",1,1,100,44,95,44,27,0,64,0,39,29,68,23,44,113,33,80,72,21,51,11,0.25,288,7.98611111111111
"146",2018,"UC Santa Barbara",1,1,100,38,51,11,8,0,44,0,27,40,67,15,48,51,20,31,59,16,43,12,0.31578947368421,202,7.42574257425743
"147",2019,"Air Force",1,1,100,35,70,32,17,0,57,0,21,40,61,21,48,65,18,47,53,13,40,3,0.0857142857142857,211,9.95260663507109
"148",2019,"Albany",1,1,100,25,61,24,15,0,28,0,24,30,54,16,40,45,14,31,51,14,37,8,0.32,184,8.69565217391304
"149",2019,"Arkansas State",1,1,100,42,74,74,39,0,88,0,39,45,84,28,60,72,21,51,57,14,43,9,0.214285714285714,266,10.5263157894737
"150",2019,"Buffalo",1,1,100,68,128,69,52,0,83,0,70,56,126,37,60,69,22,47,124,39,85,18,0.264705882352941,409,9.04645476772616
"151",2019,"Charlotte",2,2,100,55,115,58,38,0,87,0,35,47,82,34,68,109,35,74,84,22,62,22,0.4,344,9.88372093023256
"152",2019,"Coastal Carolina",1,1,100,73,101,48,26,0,78,1,59,49,108,31,78,76,22,54,56,11,45,23,0.315068493150685,352,8.80681818181818
"153",2019,"Colorado State",2,2,100,25,65,30,18,0,23,14,29,29,58,13,46,46,11,35,39,11,28,5,0.2,196,6.63265306122449
"154",2019,"Hawai'i",1,1,100,48,107,35,24,0,76,1,36,60,96,26,69,77,25,52,99,36,63,14,0.291666666666667,333,7.80780780780781
"155",2019,"Louisiana",1,1,100,63,97,52,31,0,81,0,38,34,72,42,93,164,44,120,70,19,51,14,0.222222222222222,367,11.4441416893733
"156",2019,"Maryland",2,2,100,383,816,400,260,0,440,0,419,261,680,213,424,572,209,363,438,162,276,130,0.339425587467363,2519,8.45573640333466
"157",2019,"Montana",1,1,100,38,60,34,22,0,52,0,12,10,22,15,53,102,36,66,41,12,29,10,0.263157894736842,222,6.75675675675676
"158",2019,"Norfolk State",1,1,100,59,128,60,43,0,74,1,49,64,113,46,88,71,17,54,82,26,56,12,0.203389830508475,376,12.2340425531915
"159",2019,"Old Dominion",2,2,100,82,112,57,30,0,74,2,68,87,155,37,45,41,8,33,105,23,82,21,0.25609756097561,353,10.4815864022663
"160",2019,"Oral Roberts",1,1,100,65,148,73,45,0,131,0,46,60,106,30,83,94,28,66,167,58,109,19,0.292307692307692,444,6.75675675675676
"161",2019,"Portland State",2,2,100,37,81,33,29,0,33,0,20,15,35,26,40,85,34,51,48,15,33,13,0.351351351351351,232,11.2068965517241
"162",2019,"San Francisco",1,1,100,62,145,74,43,0,108,0,84,73,157,39,104,96,24,72,87,22,65,18,0.290322580645161,461,8.45986984815618
"163",2019,"San José State",1,1,100,17,67,16,12,0,47,0,19,26,45,23,44,44,12,32,90,38,52,3,0.176470588235294,200,11.5
"164",2019,"Southeast Missouri State",1,1,100,20,36,19,11,0,55,0,11,3,14,11,32,79,30,49,18,7,11,5,0.25,140,7.85714285714286
"165",2019,"Southern",1,1,100,79,157,63,36,0,177,3,48,54,102,45,169,164,47,117,148,48,100,13,0.164556962025316,563,7.99289520426288
"166",2019,"Texas State",2,2,100,30,66,27,18,0,46,0,22,22,44,27,47,43,16,27,79,22,57,8,0.266666666666667,210,12.8571428571429
"167",2019,"Towson",2,2,100,60,98,45,29,0,70,0,46,35,81,38,95,89,23,66,54,13,41,17,0.283333333333333,348,10.9195402298851
"168",2019,"Utah Valley",2,2,100,26,40,14,10,0,30,0,20,20,40,15,41,46,18,28,27,10,17,8,0.307692307692308,158,9.49367088607595
"169",2019,"Western Illinois",1,1,100,42,94,72,48,0,69,0,49,57,106,27,57,32,8,24,107,20,87,7,0.166666666666667,286,9.44055944055944
"170",2019,"Western Kentucky",1,1,100,115,193,122,79,0,140,0,113,105,218,67,133,132,39,93,180,54,126,36,0.31304347826087,678,9.88200589970502
"171",2020,"Central Baptist College",1,1,100,48,69,47,25,0,49,0,35,24,59,31,60,56,8,48,53,15,38,17,0.354166666666667,248,12.5
"172",2020,"LSU Shreveport",1,1,100,25,106,31,22,0,57,0,30,38,68,22,91,59,23,36,32,12,20,5,0.2,294,7.48299319727891
"173",2020,"Mount Olive",2,2,100,19,22,5,4,0,15,0,11,10,21,10,17,40,14,26,16,4,12,9,0.473684210526316,89,11.2359550561798
"174",2020,"St. Martins",1,1,100,17,20,8,6,0,24,0,9,8,17,4,21,25,10,15,26,11,15,6,0.352941176470588,90,4.44444444444444
"175",2020,"Providence",7,6,85.7,265,814,324,207,0,474,3,307,310,617,180,495,610,188,422,328,120,208,78,0.294339622641509,2269,7.93301013662406
"176",2018,"Belmont",6,5,83.3,142,319,97,67,0,101,0,72,44,116,45,87,96,40,56,228,80,148,26,0.183098591549296,760,5.92105263157895
"177",2017,"Ball State",4,3,75,21,43,16,10,0,36,0,26,22,48,14,27,38,11,27,37,12,25,7,0.333333333333333,146,9.58904109589041
"178",2017,"Butler",4,3,75,62,131,76,50,0,108,0,58,59,117,54,104,113,32,81,97,30,67,14,0.225806451612903,439,12.3006833712984
"179",2017,"Hawai'i",4,3,75,49,138,58,40,0,101,0,24,31,55,42,104,141,51,90,117,36,81,11,0.224489795918367,417,10.0719424460432
"180",2017,"Idaho State",4,3,75,93,210,86,58,0,134,1,57,75,132,48,140,135,41,94,159,51,108,18,0.193548387096774,613,7.83034257748776
"181",2018,"Fordham",8,6,75,104,201,83,59,0,131,1,70,65,135,45,127,171,56,115,175,52,123,34,0.326923076923077,632,7.12025316455696
"182",2019,"Mississippi State",4,3,75,474,694,440,292,0,465,3,344,149,493,254,347,916,390,526,371,140,231,160,0.337552742616034,2490,10.2008032128514
"183",2019,"South Alabama",8,6,75,82,229,114,66,0,128,0,101,73,174,54,138,125,46,79,157,57,100,30,0.365853658536585,683,7.90629575402635
"184",2017,"Utah State",7,5,71.4,53,112,45,26,0,85,2,42,28,70,38,68,139,49,90,71,14,57,11,0.207547169811321,347,10.9510086455331
"185",2016,"Delaware",3,2,66.7,23,82,33,25,0,46,1,20,12,32,12,45,85,27,58,28,7,21,3,0.130434782608696,212,5.66037735849057
"186",2016,"Florida State",3,2,66.7,512,842,457,295,0,553,1,518,282,800,322,584,742,237,505,469,161,308,180,0.3515625,2971,10.8381016492763
"187",2016,"Idaho",3,2,66.7,102,219,103,65,0,117,0,68,79,147,52,105,120,39,81,251,85,166,22,0.215686274509804,647,8.0370942812983
"188",2016,"Idaho State",3,2,66.7,85,197,72,45,0,142,0,73,84,157,51,127,120,34,86,126,36,90,26,0.305882352941176,564,9.04255319148936
"189",2016,"Marquette",6,4,66.7,75,120,71,43,0,100,0,64,34,98,34,81,96,37,59,124,32,92,16,0.213333333333333,427,7.96252927400468
"190",2016,"Radford",3,2,66.7,66,123,79,50,0,99,0,51,53,104,35,83,104,32,72,51,11,40,15,0.227272727272727,387,9.04392764857881
"191",2016,"SMU",3,2,66.7,134,251,106,75,0,170,0,102,90,192,61,206,238,61,177,178,47,131,34,0.253731343283582,826,7.38498789346247
"192",2016,"San Francisco",6,4,66.7,27,88,76,46,0,79,0,41,35,76,32,44,86,27,59,64,25,39,6,0.222222222222222,274,11.6788321167883
"193",2016,"Texas",3,2,66.7,501,997,515,328,0,682,1,465,288,753,290,571,917,312,605,504,167,337,156,0.311377245508982,3146,9.21805467260013
"194",2016,"Texas Southern",3,2,66.7,48,151,82,51,0,121,0,50,45,95,40,133,95,28,67,91,30,61,12,0.25,460,8.69565217391304
"195",2016,"UNLV",3,2,66.7,47,79,44,29,0,43,1,32,38,70,22,40,74,19,55,38,15,23,12,0.25531914893617,243,9.05349794238683
"196",2016,"Weber State",3,2,66.7,50,139,49,34,0,78,0,60,52,112,39,57,93,32,61,122,49,73,9,0.18,401,9.72568578553616
"197",2017,"American University",3,2,66.7,26,56,19,11,0,52,0,27,30,57,16,41,67,22,45,43,14,29,10,0.384615384615385,193,8.29015544041451
"198",2017,"Buffalo",3,2,66.7,44,83,32,20,0,50,1,44,40,84,27,35,65,24,41,48,10,38,15,0.340909090909091,249,10.8433734939759
"199",2017,"Marist",3,2,66.7,20,81,30,20,0,38,0,24,25,49,13,53,23,8,15,73,23,50,5,0.25,215,6.04651162790698
"200",2017,"Mercer",6,4,66.7,99,176,76,47,0,120,0,49,49,98,74,81,282,85,197,125,34,91,27,0.272727272727273,538,13.7546468401487
"201",2017,"Milwaukee",3,2,66.7,73,165,62,48,0,88,1,71,56,127,36,85,93,39,54,136,39,97,29,0.397260273972603,487,7.39219712525667
"202",2017,"New Hampshire",3,2,66.7,35,98,41,29,0,60,0,27,23,50,13,57,95,32,63,68,15,53,8,0.228571428571429,273,4.76190476190476
"203",2017,"Old Dominion",3,2,66.7,68,118,72,47,0,109,2,46,37,83,37,108,104,36,68,95,33,62,22,0.323529411764706,420,8.80952380952381
"204",2017,"Southern Illinois",3,2,66.7,54,94,32,18,0,65,0,33,18,51,23,57,121,33,88,81,22,59,17,0.314814814814815,302,7.6158940397351
"205",2017,"Western Kentucky",3,2,66.7,75,125,81,61,0,103,0,49,42,91,38,55,139,58,81,121,42,79,26,0.346666666666667,427,8.89929742388759
"206",2018,"Idaho",3,2,66.7,76,194,67,48,0,115,0,87,73,160,30,111,95,36,59,223,73,150,25,0.328947368421053,590,5.08474576271187
"207",2018,"Mercer",3,2,66.7,56,115,49,36,0,74,0,52,38,90,37,37,170,71,99,70,25,45,16,0.285714285714286,369,10.0271002710027
"208",2018,"Portland State",3,2,66.7,51,117,61,49,0,62,0,59,45,104,35,45,91,35,56,65,26,39,21,0.411764705882353,344,10.1744186046512
"209",2019,"BYU",3,2,66.7,71,154,68,44,0,123,0,88,60,148,34,95,125,45,80,116,38,78,22,0.309859154929577,510,6.66666666666667
"210",2019,"Middle Tennessee",3,2,66.7,73,173,73,48,0,135,0,82,55,137,36,105,100,33,67,120,44,76,18,0.246575342465753,531,6.77966101694915
"211",2019,"Sacramento State",3,2,66.7,41,52,23,16,0,43,1,19,21,40,20,23,47,15,32,84,28,56,13,0.317073170731707,183,10.9289617486339
"212",2020,"Clemson",9,6,66.7,445,766,361,217,0,535,4,337,300,637,229,626,821,273,548,291,87,204,117,0.262921348314607,2624,8.72713414634146
"213",2020,"Presbyterian",6,4,66.7,364,655,343,210,0,492,2,275,280,555,227,472,577,179,398,362,108,254,112,0.307692307692308,2124,10.6873822975518
"214",2020,"Tulsa",15,10,66.7,317,639,298,184,0,454,1,283,268,551,235,437,579,166,413,339,90,249,101,0.318611987381703,1998,11.7617617617618
"215",2018,"TCU",11,7,63.6,334,876,449,310,0,569,4,464,311,775,251,488,459,151,308,587,219,368,95,0.284431137724551,2650,9.47169811320755
"216",2018,"Northwestern",8,5,62.5,326,710,351,229,0,397,1,293,227,520,193,423,615,226,389,310,104,206,81,0.248466257668712,2179,8.8572739788894
"217",2020,"Arkansas State",8,5,62.5,355,664,396,247,0,459,1,324,311,635,250,420,622,190,432,338,99,239,123,0.346478873239437,2154,11.6063138347261
"218",2020,"Jackson State",8,5,62.5,554,750,509,283,0,519,0,364,299,663,236,526,719,212,507,201,56,145,213,0.384476534296029,2577,9.15793558401242
"219",2020,"Cal State Northridge",13,8,61.5,436,716,279,164,1,455,0,262,295,557,257,429,802,247,555,366,103,263,146,0.334862385321101,2269,11.3265755839577
"220",2016,"Belmont",5,3,60,113,208,83,56,0,99,0,79,61,140,25,100,145,54,91,142,58,84,38,0.336283185840708,632,3.95569620253165
"221",2016,"Campbell",5,3,60,22,56,22,15,0,30,0,13,12,25,12,34,62,16,46,28,9,19,6,0.272727272727273,155,7.74193548387097
"222",2016,"Central Michigan",5,3,60,56,119,42,31,0,46,0,39,41,80,21,56,85,28,57,88,36,52,14,0.25,346,6.06936416184971
"223",2016,"James Madison",5,3,60,98,182,76,52,0,132,1,57,53,110,44,89,200,56,144,148,43,105,18,0.183673469387755,540,8.14814814814815
"224",2017,"Mississippi State",10,6,60,413,643,419,272,0,530,5,255,129,384,249,377,886,353,533,434,149,285,128,0.309927360774818,2284,10.9019264448336
"225",2017,"Morehead State",5,3,60,44,110,47,32,0,82,0,18,28,46,29,63,138,44,94,71,18,53,5,0.113636363636364,309,9.38511326860841
"226",2017,"North Carolina",10,6,60,331,689,327,215,0,482,4,223,115,338,203,447,695,279,416,722,235,487,102,0.308157099697885,2282,8.89570552147239
"227",2017,"Southern Miss",5,3,60,50,114,43,30,0,92,1,41,31,72,33,63,155,58,97,62,19,43,16,0.32,350,9.42857142857143
"228",2017,"Texas Tech",5,3,60,317,877,332,211,0,462,4,313,169,482,182,449,858,288,570,532,195,337,100,0.315457413249211,2521,7.21935739785799
"229",2018,"Eastern Michigan",5,3,60,39,66,33,21,0,52,0,42,49,91,31,31,76,22,54,50,16,34,7,0.17948717948718,229,13.5371179039301
"230",2018,"Miami",10,6,60,388,745,431,271,0,503,3,384,259,643,278,474,525,163,362,458,137,321,95,0.244845360824742,2393,11.6172168825742
"231",2018,"Stanford",5,3,60,371,788,319,191,0,446,3,359,276,635,213,374,379,133,246,603,183,420,117,0.315363881401617,2289,9.30537352555701
"232",2019,"Missouri State",10,6,60,77,155,65,47,0,117,0,44,38,82,50,79,207,74,133,93,32,61,24,0.311688311688312,475,10.5263157894737
"233",2020,"Brown",10,6,60,302,628,261,168,0,478,1,251,251,502,177,446,686,224,462,355,103,252,81,0.268211920529801,2019,8.7667161961367
"234",2018,"Texas A&M",22,13,59.1,451,845,467,333,0,477,3,428,279,707,215,407,759,281,478,383,138,245,139,0.30820399113082,2669,8.05545147995504
"235",2019,"West Virginia",12,7,58.3,351,808,434,291,0,481,7,278,220,498,266,444,638,231,407,547,196,351,98,0.279202279202279,2417,11.0053785684733
"236",2016,"Green Bay",7,4,57.1,82,151,74,48,0,141,0,71,76,147,50,101,86,35,51,158,47,111,21,0.25609756097561,501,9.98003992015968
"237",2016,"Minnesota",28,16,57.1,424,780,337,237,0,474,0,144,96,240,186,370,1054,470,584,717,257,460,146,0.344339622641509,2535,7.33727810650888
"238",2016,"Saint Mary's",7,4,57.1,72,154,64,47,0,67,0,62,67,129,27,88,101,36,65,68,28,40,17,0.236111111111111,455,5.93406593406593
"239",2017,"Weber State",7,4,57.1,28,71,39,21,0,50,0,33,24,57,30,37,62,15,47,80,27,53,15,0.535714285714286,219,13.6986301369863
"240",2018,"Drake",7,4,57.1,136,231,124,89,0,137,0,120,69,189,72,125,130,44,86,261,90,171,32,0.235294117647059,782,9.20716112531969
"241",2020,"Morehead State",14,8,57.1,376,691,369,249,0,512,5,292,295,587,214,484,703,215,488,313,86,227,103,0.273936170212766,2225,9.61797752808989
"242",2020,"South Dakota",7,4,57.1,355,729,357,240,0,454,1,398,240,638,256,335,659,256,403,441,171,270,122,0.343661971830986,2341,10.9354976505767
"243",2017,"Missouri",16,9,56.2,281,764,347,260,0,512,6,280,158,438,180,452,445,146,299,577,202,375,88,0.313167259786477,2209,8.14848347668628
"244",2017,"Rutgers",16,9,56.2,363,584,209,131,0,514,6,232,247,479,258,455,671,196,475,417,117,300,96,0.264462809917355,1990,12.964824120603
"245",2020,"Houston Christian",16,9,56.2,420,679,406,245,0,535,0,284,325,609,247,506,828,281,547,227,56,171,132,0.314285714285714,2330,10.6008583690987
"246",2020,"Middle Tennessee",16,9,56.2,398,695,405,236,0,455,0,299,240,539,220,403,612,215,397,439,140,299,146,0.366834170854271,2253,9.7647581003107
"247",2016,"Akron",9,5,55.6,19,53,23,14,0,41,0,17,23,40,15,24,42,20,22,54,22,32,7,0.368421052631579,159,9.43396226415094
"248",2017,"James Madison",9,5,55.6,177,280,169,103,0,204,1,119,127,246,80,163,227,80,147,225,73,152,53,0.299435028248588,931,8.59291084854995
"249",2017,"Memphis",9,5,55.6,81,177,101,62,0,135,2,86,81,167,80,108,186,53,133,117,40,77,19,0.234567901234568,565,14.1592920353982
"250",2018,"Alabama",27,15,55.6,444,822,506,343,0,442,2,207,128,335,255,422,901,342,559,466,131,335,111,0.25,2471,10.3197086199919
"251",2016,"Nebraska",11,6,54.5,311,852,351,227,0,422,2,216,120,336,174,442,1005,429,576,436,165,271,90,0.289389067524116,2480,7.01612903225806
"252",2020,"Canisius",11,6,54.5,350,701,320,212,0,435,1,281,266,547,178,506,809,257,552,273,102,171,97,0.277142857142857,2265,7.85871964679912
"253",2019,"Arkansas",24,13,54.2,338,785,406,280,0,514,3,351,242,593,255,354,641,205,436,767,250,517,93,0.275147928994083,2376,10.7323232323232
"254",2019,"Pepperdine",13,7,53.8,142,224,117,79,0,143,0,70,83,153,39,92,294,100,194,138,55,83,42,0.295774647887324,712,5.47752808988764
"255",2017,"Penn State",15,8,53.3,387,713,363,237,0,522,1,355,267,622,185,363,651,233,418,502,170,332,129,0.333333333333333,2315,7.99136069114471
"256",2017,"Virginia Tech",15,8,53.3,422,844,448,282,0,547,0,419,350,769,219,459,586,205,381,805,247,558,141,0.334123222748815,2702,8.10510732790526
"257",2020,"Michigan State",15,8,53.3,488,724,362,225,1,584,1,386,359,745,254,461,661,198,463,427,141,286,155,0.317622950819672,2496,10.1762820512821
"258",2020,"Appalachian State",17,9,52.9,305,556,230,147,0,351,2,216,258,474,151,362,537,175,362,248,69,179,98,0.321311475409836,1752,8.61872146118722
"259",2020,"Rider",17,9,52.9,309,719,252,167,0,453,0,300,251,551,204,399,729,277,452,226,73,153,107,0.346278317152104,2140,9.53271028037383
"260",2020,"Utah",19,10,52.6,372,756,315,203,0,481,1,347,306,653,190,475,594,209,385,428,151,277,130,0.349462365591398,2387,7.95978215333054
"261",2016,"Austin Peay",2,1,50,35,95,38,23,0,85,0,40,27,67,21,65,88,24,64,76,26,50,12,0.342857142857143,295,7.11864406779661
"262",2016,"Cal State Bakersfield",2,1,50,78,141,75,51,0,113,0,44,72,116,41,82,135,34,101,123,35,88,20,0.256410256410256,435,9.42528735632184
"263",2016,"Kansas City",2,1,50,25,81,28,20,0,45,0,22,23,45,10,50,69,22,47,33,7,26,7,0.28,218,4.58715596330275
"264",2016,"Long Beach State",2,1,50,33,75,45,29,0,72,0,39,35,74,35,54,71,29,42,76,18,58,8,0.242424242424242,258,13.5658914728682
"265",2016,"Maryland",4,2,50,503,984,397,270,0,480,1,499,238,737,284,526,864,334,530,529,211,318,155,0.308151093439364,3170,8.9589905362776
"266",2016,"New Hampshire",6,3,50,30,65,33,24,0,58,0,12,16,28,22,51,93,32,61,38,10,28,5,0.166666666666667,204,10.7843137254902
"267",2016,"New Mexico State",2,1,50,47,110,37,25,0,81,0,54,47,101,48,86,74,23,51,106,35,71,12,0.25531914893617,364,13.1868131868132
"268",2016,"Niagara",2,1,50,28,66,31,16,0,44,0,23,18,41,16,60,62,22,40,38,15,23,8,0.285714285714286,217,7.37327188940092
"269",2016,"Northern Kentucky",4,2,50,41,95,53,34,0,68,1,40,30,70,36,55,65,22,43,97,38,59,13,0.317073170731707,300,12
"270",2016,"Northwestern State",2,1,50,26,46,20,14,0,48,0,24,25,49,16,47,54,12,42,61,19,42,5,0.192307692307692,183,8.7431693989071
"271",2016,"Quinnipiac",2,1,50,53,129,53,34,0,92,2,68,55,123,44,63,81,29,52,92,31,61,22,0.415094339622642,387,11.3695090439276
"272",2016,"Seton Hall",4,2,50,131,230,92,63,0,165,3,111,91,202,60,136,180,63,117,204,62,142,32,0.244274809160305,756,7.93650793650794
"273",2016,"Southern Illinois",6,3,50,54,106,48,32,0,67,0,36,25,61,19,46,122,38,84,83,26,57,15,0.277777777777778,316,6.0126582278481
"274",2016,"St. John's",4,2,50,129,290,157,101,0,199,1,147,104,251,86,188,310,117,193,120,38,82,46,0.356589147286822,949,9.06217070600632
"275",2016,"Toledo",4,2,50,39,100,59,40,0,72,0,36,42,78,27,66,72,21,51,66,24,42,12,0.307692307692308,301,8.97009966777409
"276",2016,"UC Santa Barbara",2,1,50,60,115,76,46,0,96,0,52,56,108,45,85,82,24,58,79,18,61,12,0.2,371,12.1293800539084
"277",2016,"Valparaiso",2,1,50,28,95,43,26,0,80,0,38,32,70,23,87,46,12,34,97,35,62,6,0.214285714285714,303,7.59075907590759
"278",2016,"Wisconsin",18,9,50,327,664,294,187,0,460,1,274,228,502,161,411,782,282,500,442,155,287,92,0.281345565749235,2175,7.40229885057471
"279",2017,"Abilene Christian",2,1,50,63,94,40,27,0,92,0,43,52,95,45,93,59,15,44,117,28,89,9,0.142857142857143,344,13.0813953488372
"280",2017,"Baylor",4,2,50,529,993,486,309,0,456,3,338,180,518,202,371,1078,491,587,405,168,237,206,0.389413988657845,3015,6.69983416252073
"281",2017,"Belmont",6,3,50,98,181,74,48,0,77,1,49,19,68,21,85,171,65,106,150,48,102,21,0.214285714285714,538,3.90334572490706
"282",2017,"Boise State",10,5,50,55,133,37,27,0,82,0,36,43,79,25,65,138,45,93,111,43,68,11,0.2,385,6.49350649350649
"283",2017,"Brown",6,3,50,29,86,25,16,0,45,0,29,25,54,21,43,57,24,33,84,32,52,10,0.344827586206897,250,8.4
"284",2017,"DePaul",6,3,50,380,707,282,179,0,463,0,350,219,569,220,351,505,198,307,720,240,480,119,0.313157894736842,2291,9.60279353993889
"285",2017,"Eastern Kentucky",2,1,50,22,82,43,28,0,64,0,25,12,37,18,40,95,43,52,37,7,30,5,0.227272727272727,227,7.9295154185022
"286",2017,"Evansville",2,1,50,33,93,44,29,0,57,0,11,21,32,23,60,112,43,69,82,29,53,9,0.272727272727273,281,8.18505338078292
"287",2017,"Georgetown",2,1,50,80,113,53,32,0,114,0,50,46,96,42,72,145,49,96,100,21,79,17,0.2125,395,10.6329113924051
"288",2017,"Hartford",2,1,50,33,66,24,15,0,51,0,20,15,35,37,43,75,36,39,68,23,45,12,0.363636363636364,227,16.2995594713656
"289",2017,"Holy Cross",2,1,50,26,48,20,12,0,34,0,15,30,45,17,37,32,7,25,36,9,27,7,0.269230769230769,147,11.5646258503401
"290",2017,"Houston",2,1,50,62,124,63,36,0,105,0,58,31,89,42,95,109,34,75,97,26,71,16,0.258064516129032,411,10.2189781021898
"291",2017,"Lamar",4,2,50,84,89,62,34,0,92,0,59,81,140,64,78,107,25,82,86,23,63,16,0.19047619047619,371,17.2506738544474
"292",2017,"Little Rock",2,1,50,81,173,72,43,0,140,1,45,52,97,42,117,238,107,131,96,29,67,27,0.333333333333333,570,7.36842105263158
"293",2017,"Louisiana",4,2,50,42,91,47,34,0,64,0,62,48,110,29,47,79,25,54,63,17,46,15,0.357142857142857,297,9.76430976430976
"294",2017,"Louisiana Tech",10,5,50,70,146,99,66,0,139,3,51,54,105,40,107,122,45,77,98,36,62,20,0.285714285714286,478,8.36820083682008
"295",2017,"Minnesota",10,5,50,446,776,422,283,0,457,1,159,129,288,212,443,974,387,587,570,184,386,141,0.316143497757848,2493,8.50381066987565
"296",2017,"NJIT",2,1,50,12,24,9,6,0,16,0,13,7,20,4,14,21,8,13,13,3,10,6,0.5,77,5.1948051948052
"297",2017,"New Mexico",2,1,50,37,97,19,9,0,33,1,44,47,91,20,31,42,10,32,89,21,68,13,0.351351351351351,242,8.26446280991736
"298",2017,"Niagara",4,2,50,41,71,40,26,0,73,0,40,40,80,23,89,61,13,48,71,29,42,15,0.365853658536585,291,7.90378006872852
"299",2017,"Sacred Heart",2,1,50,43,97,36,23,0,73,1,47,43,90,25,50,54,18,36,109,32,77,10,0.232558139534884,294,8.50340136054422
"300",2017,"South Carolina",2,1,50,300,616,364,228,0,328,3,267,128,395,203,279,579,249,330,356,121,235,116,0.386666666666667,1922,10.5619146722164
"301",2017,"South Dakota State",8,4,50,86,201,56,39,0,101,0,79,75,154,37,128,111,34,77,162,55,107,31,0.36046511627907,599,6.17696160267112
"302",2017,"St. Francis (PA)",2,1,50,41,107,46,29,0,98,0,50,42,92,43,64,41,14,27,160,50,110,12,0.292682926829268,336,12.797619047619
"303",2017,"TCU",10,5,50,302,753,390,267,0,630,1,389,346,735,238,446,401,104,297,606,213,393,87,0.288079470198675,2296,10.3658536585366
"304",2017,"UT Martin",2,1,50,61,162,74,50,0,129,0,59,38,97,31,98,155,57,98,155,48,107,12,0.19672131147541,505,6.13861386138614
"305",2017,"Utah Valley",4,2,50,39,63,30,21,0,35,0,36,26,62,22,49,56,18,38,41,10,31,6,0.153846153846154,222,9.90990990990991
"306",2017,"VCU",4,2,50,87,107,76,45,0,86,0,65,50,115,38,64,134,33,101,70,18,52,12,0.137931034482759,393,9.66921119592875
"307",2017,"Western Michigan",6,3,50,63,124,39,24,0,91,0,55,65,120,35,73,119,34,85,90,28,62,14,0.222222222222222,382,9.16230366492147
"308",2017,"Wyoming",6,3,50,30,124,54,38,0,99,0,47,33,80,31,75,79,26,53,91,37,54,12,0.4,349,8.88252148997135
"309",2018,"American University",2,1,50,37,119,54,41,0,71,0,24,32,56,31,54,94,35,59,77,21,56,3,0.0810810810810811,298,10.4026845637584
"310",2018,"Arkansas State",2,1,50,97,121,73,39,0,118,0,51,90,141,44,101,157,45,112,101,31,70,21,0.216494845360825,464,9.48275862068965
"311",2018,"Army",6,3,50,26,53,27,16,0,40,0,20,24,44,10,28,44,10,34,29,9,20,10,0.384615384615385,151,6.62251655629139
"312",2018,"BYU",2,1,50,55,120,81,49,0,109,0,44,31,75,48,90,111,29,82,87,31,56,11,0.2,388,12.3711340206186
"313",2018,"Boston College",10,5,50,232,711,291,188,0,428,4,253,245,498,139,455,389,131,258,515,167,348,58,0.25,2018,6.88800792864222
"314",2018,"Central Arkansas",2,1,50,117,210,108,69,0,160,0,100,75,175,54,139,199,64,135,144,46,98,36,0.307692307692308,701,7.70328102710414
"315",2018,"Colorado",14,7,50,434,805,388,248,0,505,3,422,368,790,260,466,484,153,331,570,176,394,122,0.28110599078341,2560,10.15625
"316",2018,"Colorado State",4,2,50,37,161,50,32,0,90,0,42,40,82,29,80,130,49,81,123,41,82,12,0.324324324324324,425,6.82352941176471
"317",2018,"Dayton",4,2,50,65,191,80,62,0,96,1,38,27,65,28,84,160,54,106,113,38,75,16,0.246153846153846,486,5.76131687242798
"318",2018,"George Mason",6,3,50,88,143,74,48,0,111,0,64,61,125,35,100,121,53,68,124,38,86,36,0.409090909090909,506,6.91699604743083
"319",2018,"Hawai'i",2,1,50,58,127,67,44,0,106,0,36,32,68,20,95,150,58,92,107,31,76,17,0.293103448275862,427,4.68384074941452
"320",2018,"Illinois",6,3,50,382,732,293,198,0,527,2,175,136,311,184,429,919,330,589,544,166,378,116,0.303664921465969,2291,8.03142732431253
"321",2018,"Illinois State",4,2,50,46,98,62,43,0,64,0,32,32,64,20,72,60,11,49,61,10,51,8,0.173913043478261,284,7.04225352112676
"322",2018,"James Madison",2,1,50,103,202,99,68,0,150,0,85,84,169,59,129,163,53,110,152,38,114,34,0.330097087378641,632,9.33544303797468
"323",2018,"Loyola Maryland",2,1,50,30,69,27,19,0,43,0,26,20,46,15,56,66,21,45,58,13,45,8,0.266666666666667,225,6.66666666666667
"324",2018,"Montana State",4,2,50,36,73,28,16,0,52,0,30,27,57,10,34,36,9,27,91,30,61,10,0.277777777777778,218,4.58715596330275
"325",2018,"New Mexico",4,2,50,97,237,127,93,0,136,3,140,112,252,97,112,128,38,90,223,79,144,37,0.381443298969072,735,13.1972789115646
"326",2018,"North Carolina A&T",4,2,50,76,135,72,42,0,99,0,51,52,103,38,87,110,32,78,97,26,71,21,0.276315789473684,422,9.00473933649289
"327",2018,"Northern Iowa",4,2,50,128,242,100,72,0,167,0,77,89,166,71,139,164,48,116,240,86,154,34,0.265625,745,9.53020134228188
"328",2018,"Pennsylvania",4,2,50,64,110,56,36,0,77,2,33,36,69,39,65,111,34,77,103,34,69,15,0.234375,348,11.2068965517241
"329",2018,"Prairie View A&M",4,2,50,68,129,68,46,0,98,0,53,49,102,35,90,159,52,107,69,16,53,28,0.411764705882353,424,8.25471698113208
"330",2018,"San Francisco",2,1,50,55,97,61,37,0,65,0,37,27,64,25,66,74,24,50,98,33,65,13,0.236363636363636,326,7.66871165644172
"331",2018,"South Florida",6,3,50,253,597,232,163,0,202,0,211,171,382,105,185,210,88,122,402,156,246,74,0.292490118577075,1543,6.8049254698639
"332",2018,"Southern",6,3,50,108,196,103,69,0,196,2,91,79,170,70,121,231,66,165,185,48,137,29,0.268518518518519,656,10.6707317073171
"333",2018,"Texas Tech",4,2,50,397,797,401,215,0,448,0,353,212,565,171,555,578,179,399,435,120,315,120,0.302267002518892,2507,6.82090147586757
"334",2018,"UIC",2,1,50,42,82,36,20,0,57,0,28,21,49,26,64,54,17,37,58,13,45,10,0.238095238095238,253,10.2766798418972
"335",2018,"UT Martin",8,4,50,63,146,70,52,0,112,0,46,32,78,44,94,160,46,114,144,49,95,16,0.253968253968254,463,9.50323974082074
"336",2018,"UTEP",2,1,50,22,98,37,28,0,40,0,29,24,53,10,59,54,23,31,37,18,19,7,0.318181818181818,259,3.86100386100386
"337",2018,"Virginia Tech",20,10,50,471,999,479,318,0,545,3,397,284,681,265,502,634,222,412,857,286,571,129,0.273885350318471,2997,8.84217550884218
"338",2018,"Western Kentucky",10,5,50,92,165,101,70,0,136,0,88,58,146,62,70,199,66,133,110,42,68,30,0.326086956521739,551,11.2522686025408
"339",2019,"American University",2,1,50,43,141,60,41,0,95,0,61,55,116,32,76,94,32,62,101,31,70,16,0.372093023255814,401,7.98004987531172
"340",2019,"Appalachian State",2,1,50,90,194,81,46,0,88,0,73,81,154,37,102,148,59,89,125,38,87,27,0.3,576,6.42361111111111
"341",2019,"Cal State Northridge",2,1,50,85,151,58,30,0,75,1,54,60,114,31,84,134,35,99,105,24,81,22,0.258823529411765,445,6.96629213483146
"342",2019,"Central Michigan",8,4,50,65,121,43,33,0,84,0,51,47,98,26,61,85,35,50,127,54,73,25,0.384615384615385,397,6.54911838790932
"343",2019,"Creighton",2,1,50,76,228,80,58,0,152,0,102,70,172,37,143,104,45,59,219,80,139,33,0.43421052631579,697,5.30846484935438
"344",2019,"Eastern Michigan",4,2,50,38,77,34,20,0,61,1,29,31,60,20,42,66,18,48,81,26,55,12,0.31578947368421,239,8.36820083682008
"345",2019,"Gardner-Webb",2,1,50,26,41,14,10,0,28,1,23,27,50,17,33,34,11,23,41,11,30,6,0.230769230769231,148,11.4864864864865
"346",2019,"Holy Cross",2,1,50,33,61,26,17,0,32,12,32,32,64,13,47,47,17,30,45,14,31,9,0.272727272727273,212,6.13207547169811
"347",2019,"Illinois",24,12,50,290,672,278,182,0,481,0,221,140,361,169,344,740,295,445,555,172,383,71,0.244827586206897,2060,8.20388349514563
"348",2019,"Lamar",2,1,50,90,95,64,40,0,110,1,52,45,97,60,72,149,36,113,116,33,83,27,0.3,395,15.1898734177215
"349",2019,"Louisville",4,2,50,333,666,301,206,0,420,8,365,187,552,230,322,496,200,296,564,210,354,136,0.408408408408408,2180,10.5504587155963
"350",2019,"Milwaukee",4,2,50,32,100,45,27,0,92,0,40,27,67,22,63,70,21,49,85,31,54,17,0.53125,300,7.33333333333333
"351",2019,"Mount St. Mary's",4,2,50,43,83,50,32,0,81,0,62,59,121,34,73,19,4,15,89,18,71,13,0.302325581395349,295,11.5254237288136
"352",2019,"Northern Colorado",12,6,50,62,104,37,21,0,75,0,25,17,42,21,46,109,40,69,110,33,77,18,0.290322580645161,323,6.5015479876161
"353",2019,"Notre Dame",8,4,50,311,644,322,221,3,284,0,425,232,657,203,332,477,213,264,281,105,176,112,0.360128617363344,2102,9.65746907706946
"354",2019,"Oklahoma",8,4,50,328,718,416,259,0,546,0,332,295,627,213,534,520,170,350,470,177,293,92,0.280487804878049,2356,9.04074702886248
"355",2019,"Oklahoma State",6,3,50,401,768,338,227,0,453,0,239,213,452,197,383,790,260,530,585,192,393,127,0.316708229426434,2322,8.48406546080965
"356",2019,"Oregon",10,5,50,302,669,248,172,0,310,2,404,188,592,180,254,379,156,223,577,243,334,113,0.374172185430464,2093,8.6000955566173
"357",2019,"Saint Joseph's",6,3,50,30,75,36,23,0,68,0,19,26,45,12,37,68,17,51,54,23,31,10,0.333333333333333,216,5.55555555555556
"358",2019,"Seton Hall",2,1,50,84,158,86,49,0,114,0,88,65,153,56,106,118,29,89,164,49,115,27,0.321428571428571,535,10.4672897196262
"359",2019,"Stony Brook",2,1,50,65,84,32,21,0,63,0,43,46,89,30,68,52,17,35,98,34,64,15,0.230769230769231,316,9.49367088607595
"360",2019,"Troy",2,1,50,77,73,45,24,0,73,1,38,31,69,25,52,103,23,80,67,19,48,23,0.298701298701299,294,8.50340136054422
"361",2019,"UNC Asheville",2,1,50,31,67,26,15,0,45,0,35,32,67,13,44,48,14,34,50,18,32,9,0.290322580645161,219,5.93607305936073
"362",2019,"UNLV",2,1,50,46,81,51,30,0,63,3,35,44,79,32,68,75,24,51,59,20,39,13,0.282608695652174,289,11.0726643598616
"363",2019,"UTEP",2,1,50,23,91,42,23,0,49,0,29,23,52,12,60,41,11,30,48,11,37,7,0.304347826086957,233,5.15021459227468
"364",2019,"Western Michigan",4,2,50,24,66,36,19,0,49,0,38,34,72,20,32,28,11,17,81,17,64,11,0.458333333333333,195,10.2564102564103
"365",2019,"Wright State",2,1,50,55,119,49,34,0,63,1,28,32,60,28,60,108,46,62,73,21,52,14,0.254545454545455,342,8.18713450292398
"366",2020,"Baylor",4,2,50,308,587,281,171,0,287,2,255,126,381,191,254,679,297,382,163,65,98,121,0.392857142857143,1841,10.3747963063552
"367",2020,"Boston College",6,3,50,451,765,413,262,0,524,1,464,333,797,230,507,670,212,458,335,109,226,150,0.332594235033259,2626,8.75856816450876
"368",2020,"Bowling Green",26,13,50,281,841,311,192,0,491,3,386,308,694,158,462,653,228,425,392,149,243,89,0.316725978647687,2421,6.52622883106155
"369",2020,"Central Washington",2,1,50,4,25,6,3,0,12,0,12,11,23,3,22,9,2,7,20,11,9,0,0,77,3.8961038961039
"370",2020,"East Tennessee State",12,6,50,271,644,373,240,0,407,1,286,307,593,189,404,569,171,398,243,64,179,85,0.313653136531365,1933,9.77754785307812
"371",2020,"Elon",18,9,50,350,655,347,236,1,551,2,271,331,602,204,445,617,212,405,282,91,191,88,0.251428571428571,2097,9.72818311874106
"372",2020,"Grambling",16,8,50,231,442,269,176,0,383,4,202,139,341,145,423,530,157,373,173,41,132,86,0.372294372294372,1559,9.30083386786402
"373",2020,"Iowa",14,7,50,314,731,394,268,0,407,0,419,243,662,205,424,562,213,349,343,133,210,113,0.359872611464968,2330,8.79828326180258
"374",2020,"Jacksonville",24,12,50,517,740,402,244,0,558,3,370,377,747,310,492,785,283,502,327,108,219,172,0.332688588007737,2607,11.8910625239739
"375",2020,"Kansas",12,6,50,357,777,395,229,0,510,1,447,379,826,245,478,589,178,411,385,120,265,101,0.282913165266106,2436,10.0574712643678
"376",2020,"Maryland",6,3,50,489,753,385,246,0,458,4,489,318,807,353,416,757,275,482,351,126,225,170,0.347648261758691,2652,13.3107088989442
"377",2020,"Maryland-Eastern Shore",10,5,50,342,653,301,166,0,474,4,217,242,459,198,447,733,234,499,336,90,246,91,0.266081871345029,2060,9.61165048543689
"378",2020,"Mid-America Christian",2,1,50,12,27,9,5,0,18,0,5,2,7,9,16,24,3,21,29,13,16,3,0.25,77,11.6883116883117
"379",2020,"Monmouth",16,8,50,408,760,331,175,0,439,2,306,340,646,204,531,548,150,398,399,104,295,108,0.264705882352941,2333,8.74410630090013
"380",2020,"Murray State",8,4,50,404,701,342,226,0,444,5,305,304,609,174,471,604,170,434,378,120,258,153,0.378712871287129,2251,7.72989782318969
"381",2020,"Northern Kentucky",20,10,50,387,814,411,266,0,506,0,336,308,644,240,451,800,274,526,379,116,263,113,0.291989664082687,2479,9.68132311415894
"382",2020,"Oklahoma",26,13,50,372,749,391,252,0,553,1,391,332,723,227,545,625,217,408,426,160,266,127,0.341397849462366,2512,9.03662420382166
"383",2020,"Oregon",2,1,50,279,583,215,154,0,247,4,352,180,532,186,241,351,154,197,405,150,255,111,0.397849462365591,1812,10.2649006622517
"384",2020,"Princeton",2,1,50,376,684,328,214,0,358,1,314,264,578,268,302,717,250,467,286,96,190,128,0.340425531914894,2112,12.6893939393939
"385",2020,"Seattle U",18,9,50,420,771,412,259,0,523,1,389,405,794,246,394,606,186,420,385,118,267,126,0.3,2376,10.3535353535354
"386",2020,"St. Francis (PA)",18,9,50,271,752,239,158,0,395,0,288,272,560,121,499,553,186,367,354,111,243,81,0.298892988929889,2165,5.58891454965358
"387",2020,"Stanford",18,9,50,398,769,262,166,0,374,1,374,259,633,218,361,633,241,392,388,141,247,148,0.371859296482412,2350,9.27659574468085
"388",2020,"Tennessee State",6,3,50,290,577,341,227,0,471,2,252,288,540,233,474,662,183,479,246,66,180,84,0.289655172413793,1930,12.0725388601036
"389",2020,"Valparaiso",8,4,50,202,540,303,224,0,497,1,286,248,534,246,397,410,133,277,344,116,228,60,0.297029702970297,1747,14.0812821980538
"390",2020,"Villanova",30,15,50,330,863,272,175,0,435,1,341,241,582,158,423,676,202,474,503,149,354,101,0.306060606060606,2381,6.63586728265435
"391",2020,"Virginia",14,7,50,368,746,373,255,0,509,0,314,297,611,220,498,748,245,503,262,83,179,112,0.304347826086957,2349,9.36568752660707
"392",2020,"Western Illinois",4,2,50,369,694,467,280,1,455,0,310,267,577,247,398,627,207,420,501,158,343,119,0.322493224932249,2225,11.1011235955056
"393",2020,"Air Force",25,12,48,497,699,336,209,0,490,1,298,251,549,314,491,938,291,647,391,104,287,145,0.291750503018109,2459,12.7694184627898
"394",2019,"North Carolina",23,11,47.8,387,806,410,279,0,538,4,293,191,484,245,431,763,304,459,787,260,527,125,0.322997416020672,2579,9.49980612640558
"395",2020,"Utah State",23,11,47.8,343,675,319,208,0,437,5,264,308,572,216,469,718,230,488,309,95,214,116,0.338192419825073,2149,10.0511865984179
"396",2020,"Mount St. Mary's",21,10,47.6,326,684,328,214,0,476,2,352,332,684,277,488,530,169,361,449,147,302,87,0.266871165644172,2257,12.2729286663713
"397",2020,"Toledo",21,10,47.6,415,789,403,259,0,553,1,374,311,685,195,495,706,244,462,404,121,283,135,0.325301204819277,2531,7.70446463848281
"398",2020,"New Hampshire",19,9,47.4,343,578,275,179,0,499,0,324,364,688,216,369,616,195,421,271,67,204,114,0.332361516034985,1937,11.15126484254
"399",2020,"Oral Roberts",17,8,47.1,393,848,413,286,0,527,2,316,334,650,240,492,729,247,482,438,149,289,128,0.325699745547074,2555,9.39334637964775
"400",2020,"South Alabama",17,8,47.1,519,813,463,256,0,510,4,407,403,810,222,487,586,189,397,456,139,317,193,0.371868978805395,2639,8.41227737779462
"401",2020,"UMass Lowell",17,8,47.1,427,717,356,216,0,445,2,339,351,690,244,537,651,177,474,338,90,248,125,0.292740046838407,2377,10.2650399663441
"402",2020,"Northern Illinois",32,15,46.9,378,891,318,201,0,485,1,314,297,611,208,514,796,264,532,416,131,285,124,0.328042328042328,2568,8.09968847352025
"403",2018,"LSU",15,7,46.7,390,605,385,226,0,455,3,262,154,416,262,330,809,297,512,283,72,211,97,0.248717948717949,2057,12.7369956246962
"404",2020,"Northwestern",15,7,46.7,358,681,345,225,1,381,0,337,237,574,277,318,764,279,485,279,91,188,131,0.365921787709497,2155,12.8538283062645
"405",2016,"Texas A&M",26,12,46.2,453,831,440,287,0,564,4,354,253,607,275,477,1098,438,660,257,75,182,136,0.300220750551876,2750,10
"406",2020,"Hawai'i",13,6,46.2,262,824,320,217,0,431,2,316,247,563,160,373,639,203,436,438,132,306,84,0.320610687022901,2181,7.3360843649702
"407",2020,"NJIT",13,6,46.2,267,723,336,217,0,433,3,254,248,502,160,558,562,182,380,377,114,263,70,0.262172284644195,2170,7.37327188940092
"408",2020,"South Florida",13,6,46.2,506,816,349,224,0,501,2,326,281,607,192,492,631,205,426,464,156,308,169,0.33399209486166,2593,7.40455071345931
"409",2020,"TCU",13,6,46.2,407,739,439,271,0,539,0,373,330,703,267,412,690,204,486,376,130,246,129,0.316953316953317,2367,11.2801013941698
"410",2020,"UC Irvine",13,6,46.2,345,624,290,172,0,426,1,291,264,555,185,337,709,214,495,324,106,218,115,0.333333333333333,1976,9.36234817813765
"411",2019,"Arizona State",24,11,45.8,359,694,313,195,0,410,1,282,197,479,179,343,587,220,367,506,165,341,97,0.270194986072423,2139,8.36839644693782
"412",2020,"Ball State",24,11,45.8,360,900,460,270,0,504,2,336,285,621,198,475,725,253,472,350,115,235,131,0.363888888888889,2547,7.77385159010601
"413",2018,"Charlotte",11,5,45.5,72,168,85,54,0,102,1,69,52,121,44,107,153,51,102,67,25,42,25,0.347222222222222,508,8.66141732283465
"414",2019,"Colorado",11,5,45.5,469,722,319,205,0,438,21,384,360,744,213,443,378,117,261,635,180,455,145,0.309168443496802,2384,8.93456375838926
"415",2019,"Miami",11,5,45.5,458,864,422,265,0,526,3,442,326,768,195,478,418,135,283,600,214,386,155,0.338427947598253,2688,7.25446428571429
"416",2020,"Maine",11,5,45.5,194,506,176,128,0,318,1,239,213,452,157,264,535,192,343,279,81,198,64,0.329896907216495,1528,10.2748691099476
"417",2020,"Marquette",11,5,45.5,472,860,358,232,0,494,1,478,335,813,207,521,657,213,444,313,113,200,168,0.35593220338983,2738,7.56026296566837
"418",2020,"UMass",11,5,45.5,346,650,310,196,0,408,2,343,360,703,229,328,544,177,367,389,132,257,96,0.277456647398844,2061,11.1111111111111
"419",2020,"Wofford",22,10,45.5,366,650,278,188,0,445,0,263,251,514,218,327,855,295,560,407,148,259,90,0.245901639344262,2106,10.3513770180437
"420",2020,"Lamar",31,14,45.2,389,624,367,218,2,548,0,292,261,553,284,460,830,236,594,327,88,239,109,0.280205655526992,2180,13.0275229357798
"421",2020,"Grand Canyon",20,9,45,324,686,315,190,0,420,3,339,275,614,172,424,587,191,396,243,82,161,124,0.382716049382716,2116,8.12854442344045
"422",2016,"Northwestern",29,13,44.8,443,835,404,252,0,564,1,397,319,716,313,398,869,321,548,644,197,447,134,0.302483069977427,2696,11.6097922848665
"423",2016,"Holy Cross",9,4,44.4,41,96,58,32,0,78,0,31,43,74,26,64,58,20,38,85,24,61,11,0.268292682926829,287,9.05923344947735
"424",2016,"Maine",9,4,44.4,108,218,89,56,0,126,0,74,62,136,57,142,190,70,120,192,58,134,22,0.203703703703704,696,8.18965517241379
"425",2016,"South Florida",27,12,44.4,432,968,418,297,0,471,1,329,300,629,195,423,847,310,537,601,209,392,124,0.287037037037037,2768,7.04479768786127
"426",2017,"Clemson",9,4,44.4,414,650,379,241,0,505,3,327,327,654,204,482,583,166,417,401,114,287,99,0.239130434782609,2245,9.08685968819599
"427",2017,"Drexel",9,4,44.4,74,150,51,41,0,114,0,50,56,106,56,80,119,53,66,194,64,130,24,0.324324324324324,484,11.5702479338843
"428",2017,"Oregon State",9,4,44.4,401,992,364,228,0,403,2,364,257,621,163,466,620,217,403,564,215,349,124,0.309226932668329,2748,5.9315866084425
"429",2017,"Wisconsin",9,4,44.4,412,802,449,271,0,561,1,333,323,656,196,594,593,174,419,508,159,349,112,0.271844660194175,2575,7.61165048543689
"430",2018,"Hampton",9,4,44.4,73,118,76,47,0,115,0,60,59,119,63,102,102,28,74,124,44,80,17,0.232876712328767,446,14.1255605381166
"431",2018,"Minnesota",18,8,44.4,409,757,385,270,0,421,2,182,129,311,238,324,823,342,481,619,229,390,115,0.281173594132029,2323,10.2453723633233
"432",2018,"Tennessee",9,4,44.4,351,738,389,261,0,343,1,336,191,527,221,381,546,206,340,372,118,254,107,0.304843304843305,2217,9.96842580063148
"433",2020,"DePaul",9,4,44.4,515,729,328,233,0,554,1,370,328,698,349,410,900,352,548,651,229,422,173,0.335922330097087,2678,13.0321135175504
"434",2020,"Miami (OH)",18,8,44.4,449,760,375,244,0,612,0,352,283,635,286,466,973,347,626,454,125,329,141,0.314031180400891,2595,11.0211946050096
"435",2020,"UL Monroe",9,4,44.4,338,636,322,187,0,481,5,232,237,469,161,479,674,201,473,239,68,171,83,0.245562130177515,2017,7.98215171046108
"436",2017,"Virginia",34,15,44.1,407,767,376,239,0,513,1,335,271,606,262,499,722,238,484,434,152,282,119,0.292383292383292,2494,10.5052125100241
"437",2016,"Florida",16,7,43.8,490,751,481,302,0,656,4,473,311,784,380,644,612,195,417,559,173,386,135,0.275510204081633,2827,13.4418111071808
"438",2018,"Rutgers",16,7,43.8,454,719,371,231,0,535,5,367,325,692,375,452,676,250,426,450,130,320,114,0.251101321585903,2465,15.2129817444219
"439",2016,"Iowa",23,10,43.5,360,826,428,286,0,493,0,399,117,516,182,496,735,232,503,574,187,387,111,0.308333333333333,2610,6.97318007662835
"440",2020,"VCU",23,10,43.5,365,768,449,291,0,490,3,334,294,628,247,470,744,242,502,240,69,171,116,0.317808219178082,2350,10.5106382978723
"441",2016,"Charlotte",7,3,42.9,55,114,62,41,0,94,1,48,33,81,45,79,129,44,85,80,28,52,14,0.254545454545455,380,11.8421052631579
"442",2016,"Colorado",7,3,42.9,349,713,298,196,0,602,2,271,266,537,206,480,788,273,515,412,141,271,77,0.220630372492837,2286,9.01137357830271
"443",2016,"Duke",14,6,42.9,426,858,418,260,0,519,5,448,270,718,257,579,625,186,439,441,151,290,141,0.330985915492958,2750,9.34545454545455
"444",2016,"Kansas State",7,3,42.9,306,835,403,244,0,486,3,399,322,721,289,491,406,120,286,676,218,458,87,0.284313725490196,2460,11.7479674796748
"445",2016,"Liberty",7,3,42.9,130,188,104,61,0,127,0,64,71,135,39,128,164,55,109,117,27,90,32,0.246153846153846,616,6.33116883116883
"446",2016,"Mississippi State",14,6,42.9,559,754,450,307,0,644,1,275,160,435,262,491,1102,386,716,533,156,377,152,0.271914132379249,2735,9.57952468007313
"447",2016,"Saint Louis",7,3,42.9,75,131,58,45,0,81,0,67,64,131,29,61,84,26,58,99,23,76,16,0.213333333333333,398,7.28643216080402
"448",2016,"Temple",14,6,42.9,217,357,177,115,0,229,2,172,173,345,116,216,310,88,222,275,79,196,53,0.244239631336406,1172,9.89761092150171
"449",2016,"Utah",14,6,42.9,390,847,385,264,0,503,1,420,393,813,153,470,442,130,312,491,157,334,113,0.28974358974359,2495,6.13226452905812
"450",2017,"Colorado State",7,3,42.9,50,213,86,59,0,135,0,71,41,112,44,93,157,55,102,180,53,127,21,0.42,556,7.9136690647482
"451",2017,"Duke",7,3,42.9,347,847,383,261,0,495,1,444,233,677,346,481,663,235,428,440,170,270,96,0.276657060518732,2615,13.2313575525813
"452",2017,"Florida",14,6,42.9,444,780,404,249,0,576,4,400,243,643,257,564,793,306,487,398,107,291,123,0.277027027027027,2700,9.51851851851852
"453",2018,"East Tennessee State",7,3,42.9,123,225,128,75,0,194,0,100,115,215,86,154,168,51,117,189,44,145,27,0.219512195121951,726,11.8457300275482
"454",2019,"Duke",7,3,42.9,350,716,325,198,0,446,1,346,280,626,255,530,542,187,355,470,163,307,89,0.254285714285714,2364,10.7868020304569
"455",2019,"IUPUI",7,3,42.9,88,152,62,42,0,92,0,55,39,94,31,88,126,33,93,130,35,95,24,0.272727272727273,467,6.63811563169165
"456",2019,"New Mexico",7,3,42.9,65,111,55,35,0,55,1,64,45,109,39,62,51,11,40,125,30,95,21,0.323076923076923,351,11.1111111111111
"457",2020,"Green Bay",21,9,42.9,337,757,286,192,0,429,0,360,293,653,192,333,602,210,392,380,118,262,103,0.305637982195846,2186,8.78316559926807
"458",2020,"Lafayette",14,6,42.9,340,699,296,182,1,395,1,196,246,442,194,401,721,252,469,281,91,190,119,0.35,2055,9.44038929440389
"459",2020,"Mississippi Valley State",7,3,42.9,176,292,168,95,0,234,1,119,97,216,102,268,390,111,279,128,37,91,59,0.335227272727273,1038,9.82658959537572
"460",2020,"South Carolina State",7,3,42.9,191,313,238,145,0,256,2,127,148,275,121,284,374,98,276,203,46,157,52,0.272251308900524,1105,10.9502262443439
"461",2020,"Troy",7,3,42.9,723,892,516,322,1,539,6,398,375,773,221,426,882,263,619,396,108,288,243,0.336099585062241,2927,7.55039289374786
"462",2020,"UIC",7,3,42.9,361,742,354,196,0,554,1,277,334,611,214,624,726,195,531,253,63,190,109,0.301939058171745,2336,9.16095890410959
"463",2017,"Tennessee",26,11,42.3,337,785,395,270,0,389,4,308,184,492,162,365,776,264,512,391,136,255,98,0.29080118694362,2290,7.07423580786026
"464",2020,"Boise State",26,11,42.3,388,898,306,211,0,510,0,446,241,687,219,468,874,312,562,451,152,299,126,0.324742268041237,2749,7.96653328483085
"465",2019,"Texas",19,8,42.1,422,798,363,242,0,497,2,377,226,603,195,464,729,279,450,429,142,287,138,0.327014218009479,2583,7.54936120789779
"466",2020,"Prairie View A&M",19,8,42.1,344,598,297,178,0,536,0,170,161,331,230,472,849,281,568,271,71,200,111,0.322674418604651,2005,11.4713216957606
"467",2018,"West Virginia",12,5,41.7,430,960,442,293,0,543,3,426,249,675,363,494,716,239,477,628,225,403,140,0.325581395348837,2883,12.5910509885536
"468",2020,"North Dakota State",12,5,41.7,309,682,302,213,0,457,2,288,248,536,142,401,580,219,361,302,93,209,108,0.349514563106796,2067,6.86985970004838
"469",2017,"Georgia Tech",29,12,41.4,582,868,563,330,0,749,11,429,348,777,335,584,871,279,592,593,191,402,164,0.281786941580756,3076,10.890767230169
"470",2018,"Kansas State",17,7,41.2,316,816,418,286,0,439,1,306,200,506,284,394,660,244,416,669,208,461,86,0.272151898734177,2386,11.9027661357921
"471",2018,"Ole Miss",17,7,41.2,381,693,395,255,0,530,3,270,146,416,205,431,664,193,471,580,190,390,95,0.249343832020997,2249,9.11516229435305
"472",2019,"Oregon State",17,7,41.2,317,922,306,205,0,371,3,386,242,628,119,361,451,184,267,650,256,394,109,0.34384858044164,2506,4.74860335195531
"473",2020,"Miami",17,7,41.2,446,724,401,243,0,530,4,334,293,627,247,495,663,202,461,404,117,287,131,0.29372197309417,2418,10.2150537634409
"474",2016,"Boise State",5,2,40,30,49,16,11,0,32,0,20,11,31,16,31,49,13,36,62,12,50,11,0.366666666666667,160,10
"475",2016,"Boston College",5,2,40,239,706,229,153,0,470,0,322,311,633,192,503,368,141,227,434,155,279,60,0.251046025104602,2118,9.06515580736544
"476",2016,"Chattanooga",5,2,40,131,289,107,69,0,145,1,130,82,212,87,205,226,52,174,184,49,135,50,0.381679389312977,880,9.88636363636364
"477",2016,"Detroit Mercy",5,2,40,42,79,34,23,0,65,1,34,55,89,24,52,74,22,52,102,28,74,14,0.333333333333333,262,9.16030534351145
"478",2016,"Evansville",5,2,40,35,89,25,17,0,46,0,22,20,42,29,52,97,29,68,103,27,76,10,0.285714285714286,259,11.1969111969112
"479",2016,"North Texas",5,2,40,39,96,48,31,0,90,0,37,29,66,31,81,79,28,51,63,22,41,12,0.307692307692308,319,9.71786833855799
"480",2016,"Northern Iowa",5,2,40,73,191,70,46,0,126,1,71,57,128,58,93,145,49,96,197,57,140,21,0.287671232876712,553,10.4882459312839
"481",2016,"Oregon",5,2,40,394,863,434,278,0,537,2,438,309,747,244,520,530,171,359,644,271,373,98,0.248730964467005,2762,8.83417813178856
"482",2017,"Florida State",5,2,40,430,738,433,284,0,497,1,427,269,696,293,423,685,274,411,432,158,274,156,0.362790697674419,2554,11.4722004698512
"483",2017,"Northwestern",10,4,40,358,830,397,267,0,483,0,354,266,620,271,445,776,273,503,479,156,323,112,0.312849162011173,2512,10.7882165605096
"484",2017,"Omaha",5,2,40,39,101,31,23,0,61,0,25,25,50,20,48,82,29,53,107,38,69,12,0.307692307692308,285,7.01754385964912
"485",2017,"Oral Roberts",5,2,40,74,178,79,44,0,134,0,64,64,128,62,105,194,71,123,123,33,90,17,0.22972972972973,537,11.5456238361266
"486",2017,"Providence",5,2,40,26,90,23,13,0,63,0,39,31,70,25,54,80,25,55,70,26,44,7,0.269230769230769,267,9.36329588014981
"487",2017,"Western Illinois",5,2,40,46,101,54,35,0,61,0,40,43,83,46,43,47,15,32,133,51,82,9,0.195652173913043,313,14.6964856230032
"488",2018,"Delaware",5,2,40,28,86,51,32,0,54,0,28,33,61,24,57,62,22,40,34,9,25,9,0.321428571428571,245,9.79591836734694
"489",2018,"Drexel",5,2,40,111,169,95,60,0,163,1,93,98,191,90,128,148,42,106,184,58,126,30,0.27027027027027,628,14.3312101910828
"490",2018,"Florida State",10,4,40,377,711,363,247,0,376,1,343,212,555,190,320,549,223,326,463,170,293,135,0.358090185676393,2236,8.49731663685152
"491",2018,"Jacksonville",5,2,40,107,145,82,54,0,118,1,69,69,138,59,117,162,54,108,127,37,90,26,0.242990654205607,552,10.6884057971014
"492",2018,"Lamar",5,2,40,64,65,54,31,0,88,0,28,36,64,39,53,122,38,84,94,29,65,17,0.265625,292,13.3561643835616
"493",2018,"North Carolina",25,10,40,396,798,389,266,0,452,6,245,131,376,226,460,923,358,565,554,182,372,113,0.285353535353535,2532,8.92575039494471
"494",2018,"Rice",5,2,40,86,166,93,69,0,127,0,70,52,122,45,115,93,31,62,185,68,117,24,0.27906976744186,559,8.05008944543828
"495",2018,"Savannah State",5,2,40,76,133,80,50,0,102,0,27,63,90,46,98,158,37,121,93,18,75,16,0.210526315789474,406,11.3300492610837
"496",2018,"Texas",5,2,40,372,694,288,190,0,389,0,345,159,504,222,328,638,242,396,365,121,244,125,0.336021505376344,2182,10.1741521539872
"497",2018,"Utah",10,4,40,375,869,410,274,0,482,3,452,326,778,212,446,396,117,279,539,174,365,117,0.312,2530,8.3794466403162
"498",2019,"Little Rock",5,2,40,66,117,61,41,0,97,0,57,60,117,41,86,151,48,103,62,20,42,22,0.333333333333333,406,10.0985221674877
"499",2019,"Mercer",5,2,40,70,180,55,35,0,83,0,54,42,96,49,79,244,95,149,84,33,51,22,0.314285714285714,526,9.31558935361217
"500",2019,"Michigan",10,4,40,446,824,451,287,0,549,2,573,452,1025,234,520,450,139,311,446,146,300,144,0.322869955156951,2748,8.51528384279476
"501",2019,"Southern Illinois",5,2,40,35,59,34,21,0,58,1,26,34,60,8,47,53,19,34,52,15,37,13,0.371428571428571,208,3.84615384615385
"502",2019,"Tulsa",5,2,40,69,149,42,29,0,89,0,56,63,119,47,97,148,42,106,99,38,61,16,0.231884057971014,461,10.1952277657267
"503",2019,"Wisconsin",10,4,40,418,808,483,273,1,471,3,398,347,745,223,442,587,162,425,435,133,302,121,0.289473684210526,2480,8.99193548387097
"504",2020,"Colorado",10,4,40,481,714,390,243,0,485,5,363,351,714,216,466,555,167,388,365,116,249,157,0.326403326403326,2393,9.02632678646051
"505",2020,"Davidson",30,12,40,358,756,274,177,0,483,1,331,328,659,133,394,682,222,460,350,116,234,103,0.287709497206704,2247,5.9190031152648
"506",2020,"Dayton",15,6,40,424,829,391,254,0,526,2,236,227,463,180,427,976,327,649,391,132,259,140,0.330188679245283,2468,7.2933549432739
"507",2020,"Florida Gulf Coast",5,2,40,342,786,322,217,2,459,1,409,332,741,330,304,559,204,355,666,218,448,124,0.362573099415205,2351,14.0365801786474
"508",2020,"Lipscomb",10,4,40,187,680,315,223,0,531,3,245,195,440,128,429,587,190,397,428,130,298,53,0.283422459893048,1936,6.61157024793388
"509",2020,"North Carolina",15,6,40,340,667,359,239,0,406,6,271,212,483,180,309,761,245,516,345,120,225,106,0.311764705882353,2028,8.87573964497041
"510",2020,"Purdue Fort Wayne",10,4,40,360,528,241,159,0,457,2,136,197,333,193,454,832,288,544,375,114,261,103,0.286111111111111,1934,9.97931747673216
"511",2020,"Syracuse",20,8,40,433,709,328,213,0,504,1,321,204,525,205,409,741,212,529,492,136,356,129,0.297921478060046,2301,8.90916992611908
"512",2020,"USC",15,6,40,283,744,298,211,0,405,3,333,300,633,191,388,684,243,441,255,70,185,109,0.385159010600707,2139,8.92940626460963
"513",2019,"Boston College",28,11,39.3,391,583,277,171,0,463,19,391,303,694,196,448,369,117,252,577,187,390,122,0.312020460358056,2184,8.97435897435897
"514",2016,"USC",23,9,39.1,342,605,347,227,0,475,3,341,341,682,255,384,545,180,365,390,119,271,112,0.327485380116959,2050,12.4390243902439
"515",2018,"Washington",23,9,39.1,342,563,311,203,0,459,0,231,213,444,260,379,501,177,324,690,230,460,87,0.254385964912281,2001,12.9935032483758
"516",2016,"Arkansas",18,7,38.9,405,703,357,223,0,518,3,273,161,434,193,430,886,250,636,397,107,290,118,0.291358024691358,2266,8.51721094439541
"517",2019,"Auburn",18,7,38.9,387,609,386,253,0,541,3,327,209,536,356,382,727,254,473,550,174,376,128,0.330749354005168,2240,15.8928571428571
"518",2020,"Binghamton",18,7,38.9,415,807,352,241,0,474,1,293,281,574,221,420,870,310,560,410,143,267,161,0.387951807228916,2468,8.95461912479741
"519",2020,"Kennesaw State",18,7,38.9,344,719,369,266,0,527,1,363,266,629,199,474,816,304,512,266,74,192,110,0.319767441860465,2388,8.33333333333333
"520",2020,"West Virginia",18,7,38.9,446,776,344,213,0,515,1,293,257,550,195,430,823,266,557,333,105,228,159,0.356502242152466,2402,8.11823480432973
"521",2016,"Kentucky",13,5,38.5,412,874,451,293,0,562,0,396,185,581,214,495,925,322,603,419,151,268,110,0.266990291262136,2765,7.73960216998192
"522",2016,"Virginia Tech",13,5,38.5,334,749,344,214,0,537,2,286,249,535,214,466,551,161,390,573,177,396,78,0.233532934131737,2236,9.57066189624329
"523",2017,"Missouri State",13,5,38.5,112,184,82,57,0,132,1,51,30,81,38,120,219,70,149,151,50,101,26,0.232142857142857,607,6.26029654036244
"524",2017,"Navy",13,5,38.5,82,180,52,32,0,117,1,71,82,153,89,99,166,52,114,182,66,116,21,0.25609756097561,562,15.8362989323843
"525",2018,"Arkansas",13,5,38.5,393,781,354,223,0,474,5,237,150,387,211,337,781,252,529,768,222,546,97,0.246819338422392,2312,9.12629757785467
"526",2018,"Clemson",13,5,38.5,334,641,326,199,0,476,2,256,278,534,240,459,593,171,422,270,55,215,73,0.218562874251497,1982,12.108980827447
"527",2019,"Ohio State",13,5,38.5,264,690,375,226,0,450,3,307,246,553,193,446,370,106,264,470,154,316,77,0.291666666666667,2045,9.43765281173594
"528",2019,"Pittsburgh",13,5,38.5,340,610,275,158,0,486,0,248,291,539,239,479,533,173,360,491,163,328,80,0.235294117647059,2072,11.534749034749
"529",2020,"Iowa State",13,5,38.5,344,821,363,254,0,368,1,299,141,440,175,462,737,218,519,393,140,253,122,0.354651162790698,2378,7.35912531539109
"530",2020,"North Dakota",13,5,38.5,265,437,225,148,0,358,0,162,174,336,103,328,380,125,255,261,70,191,91,0.343396226415094,1440,7.15277777777778
"531",2020,"Penn State",13,5,38.5,407,717,383,264,0,497,2,375,365,740,238,547,696,216,480,314,102,212,137,0.336609336609337,2470,9.63562753036437
"532",2020,"UC Riverside",13,5,38.5,389,750,280,182,0,448,2,251,192,443,152,525,945,300,645,241,62,179,114,0.29305912596401,2341,6.4929517300299
"533",2020,"Utah Valley",13,5,38.5,305,667,319,219,1,405,1,293,300,593,161,341,529,168,361,295,82,213,87,0.285245901639344,1927,8.35495588998443
"534",2020,"Washington State",13,5,38.5,328,749,245,168,0,475,1,371,294,665,193,431,753,272,481,332,117,215,96,0.292682926829268,2323,8.30822212656048
"535",2018,"Iowa",21,8,38.1,298,870,388,279,0,337,0,393,96,489,167,420,667,223,444,405,142,263,103,0.345637583892617,2465,6.77484787018256
"536",2020,"Duke",21,8,38.1,329,601,296,191,0,392,0,313,225,538,257,456,636,229,407,285,94,191,105,0.319148936170213,2093,12.2790253225036
"537",2020,"San Diego",21,8,38.1,488,709,370,237,0,555,5,314,275,589,338,472,938,291,647,262,71,191,164,0.336065573770492,2427,13.9266584260404
"538",2020,"Lehigh",29,11,37.9,384,690,285,176,0,374,1,275,288,563,200,362,724,274,450,342,102,240,122,0.317708333333333,2147,9.31532370749884
"539",2016,"George Mason",8,3,37.5,90,172,97,61,0,125,0,65,52,117,54,126,179,55,124,108,30,78,22,0.244444444444444,562,9.6085409252669
"540",2016,"LSU",16,6,37.5,413,622,396,245,0,585,3,227,145,372,245,510,1041,332,709,174,50,124,111,0.268765133171913,2253,10.8743897026187
"541",2016,"Western Illinois",8,3,37.5,60,148,65,40,0,89,0,57,52,109,44,71,104,31,73,144,42,102,19,0.316666666666667,425,10.3529411764706
"542",2017,"Elon",8,3,37.5,101,189,105,63,0,133,1,105,67,172,62,105,142,48,94,112,39,73,30,0.297029702970297,614,10.0977198697068
"543",2017,"IUPUI",8,3,37.5,49,148,75,53,0,92,1,48,29,77,42,95,141,51,90,95,39,56,13,0.26530612244898,449,9.35412026726058
"544",2017,"UC Riverside",8,3,37.5,60,142,59,39,0,111,0,44,31,75,38,84,188,74,114,105,39,66,19,0.316666666666667,454,8.37004405286344
"545",2018,"IUPUI",8,3,37.5,52,104,35,22,0,63,0,34,25,59,32,81,82,31,51,92,22,70,17,0.326923076923077,332,9.63855421686747
"546",2018,"Michigan",8,3,37.5,355,793,336,238,0,440,0,439,270,709,203,473,502,171,331,486,195,291,134,0.377464788732394,2510,8.08764940239044
"547",2018,"Syracuse",16,6,37.5,424,748,336,230,0,441,2,343,243,586,252,406,357,126,231,871,270,601,106,0.25,2399,10.5043768236765
"548",2019,"Florida State",16,6,37.5,394,669,338,224,0,475,2,357,256,613,217,372,545,193,352,567,159,408,106,0.269035532994924,2232,9.72222222222222
"549",2019,"Harvard",8,3,37.5,98,190,69,44,0,161,2,79,75,154,37,122,114,34,80,215,78,137,25,0.255102040816327,611,6.0556464811784
"550",2019,"Northwestern",32,12,37.5,451,880,483,309,0,492,2,369,325,694,327,454,869,294,575,468,144,324,145,0.321507760532151,2715,12.0441988950276
"551",2019,"San Diego",8,3,37.5,69,109,71,37,0,106,0,46,56,102,28,82,147,46,101,41,10,31,17,0.246376811594203,378,7.40740740740741
"552",2019,"Syracuse",16,6,37.5,390,699,286,197,0,474,2,347,277,624,247,419,393,162,231,757,267,490,106,0.271794871794872,2350,10.5106382978723
"553",2020,"Alabama State",8,3,37.5,461,648,494,292,0,551,1,306,277,583,199,518,648,165,483,246,59,187,133,0.288503253796095,2262,8.79752431476569
"554",2020,"George Mason",16,6,37.5,469,674,381,227,0,505,4,265,256,521,207,438,775,228,547,411,119,292,136,0.28997867803838,2257,9.17146654851573
"555",2020,"Georgia",16,6,37.5,377,808,342,227,0,543,1,364,245,609,228,532,917,294,623,301,82,219,128,0.339522546419098,2546,8.95522388059701
"556",2020,"Illinois State",32,12,37.5,335,777,396,262,0,462,2,344,266,610,208,449,693,258,435,304,103,201,107,0.319402985074627,2366,8.79120879120879
"557",2020,"Northern Iowa",8,3,37.5,344,767,347,245,0,474,2,319,231,550,184,435,644,202,442,454,147,307,98,0.284883720930233,2295,8.01742919389978
"558",2020,"Pittsburgh",8,3,37.5,432,773,355,207,0,512,2,299,282,581,177,547,851,233,618,339,96,243,89,0.206018518518519,2451,7.22154222766218
"559",2020,"Texas State",24,9,37.5,347,650,342,216,0,505,2,275,296,571,231,392,773,269,504,325,94,231,93,0.268011527377522,2112,10.9375
"560",2020,"Mercer",35,13,37.1,293,628,292,174,0,437,0,205,137,342,210,341,1081,340,741,226,58,168,75,0.255972696245734,1945,10.7969151670951
"561",2020,"Tulane",35,13,37.1,466,782,381,210,0,467,2,277,226,503,213,538,743,207,536,385,125,260,141,0.302575107296137,2478,8.5956416464891
"562",2016,"Georgia",19,7,36.8,425,779,344,208,0,570,5,298,214,512,235,466,711,218,493,521,165,356,104,0.244705882352941,2436,9.64696223316913
"563",2018,"Indiana",19,7,36.8,340,849,461,302,0,540,1,461,394,855,242,474,397,142,255,546,198,348,104,0.305882352941176,2562,9.44574551131928
"564",2018,"Vanderbilt",19,7,36.8,242,665,323,219,0,515,2,256,166,422,151,467,553,215,338,484,182,302,90,0.371900826446281,2104,7.17680608365019
"565",2020,"Alabama A&M",19,7,36.8,364,600,350,209,0,437,2,323,256,579,179,381,639,187,452,172,43,129,104,0.285714285714286,1975,9.06329113924051
"566",2020,"Fresno State",19,7,36.8,400,834,345,242,0,386,4,501,323,824,273,367,717,239,478,437,128,309,142,0.355,2569,10.6267029972752
"567",2020,"Loyola Chicago",19,7,36.8,357,795,325,206,0,483,0,337,310,647,162,426,745,262,483,286,95,191,106,0.296918767507003,2347,6.90242863229655
"568",2020,"Richmond",19,7,36.8,389,751,365,228,0,502,2,319,305,624,242,535,612,207,405,427,131,296,128,0.329048843187661,2430,9.95884773662551
"569",2017,"Arizona",11,4,36.4,341,692,351,227,0,566,0,355,274,629,228,501,688,225,463,398,116,282,100,0.293255131964809,2313,9.85732814526589
"570",2017,"Arizona State",22,8,36.4,425,696,401,249,0,456,1,301,250,551,231,437,744,278,466,342,105,237,110,0.258823529411765,2326,9.93121238177128
"571",2017,"Miami",11,4,36.4,401,743,383,239,0,562,2,365,221,586,280,474,675,251,424,546,188,358,114,0.28428927680798,2523,11.097899326199
"572",2017,"Temple",11,4,36.4,137,271,121,86,0,161,1,114,100,214,58,133,199,71,128,217,66,151,36,0.262773722627737,826,7.02179176755448
"573",2017,"UCLA",11,4,36.4,419,763,400,268,0,510,2,343,221,564,300,358,728,247,481,603,177,426,121,0.288782816229117,2400,12.5
"574",2018,"Oklahoma State",11,4,36.4,376,811,463,319,0,423,1,395,262,657,259,321,598,197,401,580,198,382,119,0.316489361702128,2412,10.7379767827529
"575",2019,"Utah",11,4,36.4,325,793,311,220,0,434,1,498,365,863,241,421,260,82,178,638,239,399,114,0.350769230769231,2429,9.92177850967476
"576",2020,"Columbia",11,4,36.4,299,640,262,161,0,330,3,265,224,489,178,394,613,217,396,265,93,172,78,0.260869565217391,1964,9.06313645621181
"577",2020,"Minnesota",11,4,36.4,428,754,383,264,0,499,0,374,386,760,245,410,725,226,499,410,155,255,149,0.348130841121495,2444,10.0245499181669
"578",2020,"NC State",11,4,36.4,349,869,323,211,1,346,1,359,256,615,167,404,535,184,351,493,180,313,136,0.389684813753582,2421,6.89797604295746
"579",2020,"Alabama",25,9,36,370,785,410,266,0,466,2,404,293,697,182,431,602,194,408,411,144,267,128,0.345945945945946,2422,7.51445086705202
"580",2020,"Saint Peter's",25,9,36,322,658,293,212,0,506,2,227,290,517,234,447,879,338,541,352,116,236,110,0.341614906832298,2180,10.7339449541284
"581",2016,"Purdue",28,10,35.7,350,697,361,246,0,462,3,341,188,529,266,422,788,246,542,391,134,257,95,0.271428571428571,2276,11.6871704745167
"582",2017,"Texas A&M",28,10,35.7,428,787,418,298,0,510,3,385,292,677,222,449,817,289,528,341,130,211,137,0.320093457943925,2566,8.65159781761496
"583",2020,"Coastal Carolina",14,5,35.7,409,786,421,292,0,445,6,392,298,690,205,427,648,217,431,297,106,191,133,0.32518337408313,2435,8.41889117043121
"584",2020,"Cornell",14,5,35.7,414,594,291,181,1,481,2,340,295,635,220,483,603,196,407,196,65,131,121,0.292270531400966,2159,10.1899027327466
"585",2020,"Missouri",14,5,35.7,298,822,395,272,0,577,2,331,275,606,173,517,662,218,444,441,153,288,81,0.271812080536913,2442,7.08435708435708
"586",2016,"Indiana",17,6,35.3,361,872,534,356,0,513,5,481,390,871,229,477,514,173,341,541,175,366,110,0.304709141274238,2685,8.52886405959032
"587",2020,"California Baptist",17,6,35.3,294,875,330,218,0,413,1,407,400,807,216,380,483,151,332,563,186,377,100,0.340136054421769,2370,9.11392405063291
"588",2020,"North Carolina Central",17,6,35.3,354,674,395,249,0,518,5,338,301,639,236,481,598,192,406,297,66,231,108,0.305084745762712,2194,10.7566089334549
"589",2020,"SIU Edwardsville",17,6,35.3,445,619,348,196,0,511,3,282,307,589,259,532,706,225,481,301,69,232,133,0.298876404494382,2251,11.505997334518
"590",2017,"Nebraska",20,7,35,326,700,344,197,0,475,5,166,74,240,174,467,804,269,535,578,188,390,78,0.239263803680982,2206,7.88757932910245
"591",2018,"Nebraska",20,7,35,375,803,352,212,0,463,6,217,137,354,206,397,692,265,427,597,206,391,108,0.288,2351,8.762228838792
"592",2019,"USC",20,7,35,319,662,405,264,0,507,2,377,292,669,241,355,444,145,299,569,171,398,109,0.341692789968652,2141,11.2564222326016
"593",2020,"Army",20,7,35,336,787,368,219,0,440,0,300,358,658,155,499,487,171,316,382,126,256,119,0.354166666666667,2309,6.71286271113036
"594",2020,"Montana",20,7,35,389,747,380,266,1,433,2,305,214,519,213,353,892,302,590,256,90,166,136,0.34961439588689,2280,9.34210526315789
"595",2017,"Arkansas",23,8,34.8,405,745,334,208,0,513,1,267,119,386,223,434,879,271,608,535,177,358,116,0.28641975308642,2381,9.36581268374633
"596",2020,"Duquesne",23,8,34.8,341,859,366,232,0,481,0,306,249,555,187,415,766,277,489,391,140,251,109,0.319648093841642,2417,7.73686388084402
"597",2020,"Southern Miss",23,8,34.8,388,691,367,234,0,549,3,277,174,451,276,526,993,364,629,227,65,162,112,0.288659793814433,2418,11.4143920595534
"598",2016,"UCLA",26,9,34.6,523,865,485,312,0,582,2,390,308,698,319,459,1014,340,674,422,139,283,163,0.311663479923518,2838,11.2403100775194
"599",2020,"San José State",29,10,34.5,347,815,351,245,0,486,2,328,311,639,303,429,817,291,526,439,165,274,123,0.354466858789625,2475,12.2424242424242
"600",2020,"Wagner",38,13,34.2,363,650,273,185,0,590,2,221,222,443,230,551,843,275,568,391,130,261,105,0.289256198347107,2247,10.2358700489542
"601",2015,"Green Bay",3,1,33.3,91,186,106,66,0,171,1,116,72,188,69,117,133,42,91,215,64,151,31,0.340659340659341,636,10.8490566037736
"602",2015,"Kentucky",3,1,33.3,517,769,601,367,0,646,2,381,281,662,301,505,845,265,580,470,134,336,91,0.176015473887814,2694,11.1729769858946
"603",2015,"Northwestern",3,1,33.3,292,712,328,212,0,446,1,400,297,697,255,398,500,157,343,459,153,306,84,0.287671232876712,2179,11.7026158788435
"604",2015,"Santa Clara",3,1,33.3,46,79,34,23,0,89,0,26,47,73,17,43,103,33,70,37,10,27,8,0.173913043478261,246,6.91056910569106
"605",2016,"Baylor",3,1,33.3,524,1072,549,339,0,498,2,549,290,839,312,514,986,365,621,354,134,220,187,0.356870229007634,3311,9.42313500453035
"606",2016,"DePaul",6,2,33.3,396,692,289,183,0,452,0,412,262,674,250,360,509,206,303,715,249,466,154,0.388888888888889,2386,10.4777870913663
"607",2016,"Eastern Washington",6,2,33.3,49,115,58,40,0,76,1,38,36,74,35,68,108,39,69,72,28,44,15,0.306122448979592,347,10.0864553314121
"608",2016,"Florida Atlantic",3,1,33.3,28,38,19,13,0,35,0,19,17,36,9,33,35,10,25,60,17,43,8,0.285714285714286,151,5.96026490066225
"609",2016,"Florida International",3,1,33.3,32,91,34,23,0,54,0,34,24,58,21,49,80,20,60,76,23,53,6,0.1875,253,8.300395256917
"610",2016,"Gardner-Webb",3,1,33.3,34,47,34,21,0,27,0,3,5,8,16,37,64,24,40,39,10,29,5,0.147058823529412,163,9.8159509202454
"611",2016,"Missouri",6,2,33.3,339,829,381,263,0,597,7,332,196,528,217,547,445,155,290,643,206,437,88,0.259587020648968,2480,8.75
"612",2016,"New Mexico",3,1,33.3,63,128,39,28,0,73,0,42,28,70,28,54,145,48,97,87,22,65,21,0.333333333333333,363,7.71349862258953
"613",2016,"Ohio State",21,7,33.3,376,887,466,326,0,530,1,454,237,691,272,445,778,316,462,777,289,488,131,0.348404255319149,2893,9.4020048392672
"614",2016,"Rutgers",24,8,33.3,308,798,330,204,1,556,1,325,208,533,227,436,846,331,515,384,119,265,102,0.331168831168831,2393,9.486000835771
"615",2016,"SIU Edwardsville",6,2,33.3,50,85,63,42,0,72,1,38,42,80,29,61,109,39,70,50,13,37,11,0.22,305,9.50819672131147
"616",2016,"Saint Joseph's",3,1,33.3,40,56,48,31,0,55,0,40,27,67,14,42,72,23,49,42,9,33,9,0.225,226,6.19469026548673
"617",2016,"Sam Houston",3,1,33.3,111,209,134,88,0,144,0,83,73,156,48,165,190,49,141,145,44,101,27,0.243243243243243,687,6.98689956331878
"618",2016,"San Diego",3,1,33.3,81,130,78,53,0,101,0,75,50,125,48,93,140,46,94,90,23,67,27,0.333333333333333,465,10.3225806451613
"619",2016,"South Carolina",9,3,33.3,429,908,570,357,0,529,3,435,224,659,302,491,644,222,422,560,182,378,132,0.307692307692308,2832,10.6638418079096
"620",2016,"Texas Tech",12,4,33.3,410,733,321,199,0,528,5,256,174,430,230,470,862,284,578,509,156,353,114,0.278048780487805,2388,9.63149078726968
"621",2016,"UC Davis",3,1,33.3,48,135,78,51,0,79,0,53,60,113,25,76,76,34,42,85,22,63,11,0.229166666666667,390,6.41025641025641
"622",2016,"UCF",3,1,33.3,78,145,57,34,0,113,0,62,63,125,48,132,144,47,97,128,34,94,22,0.282051282051282,510,9.41176470588235
"623",2016,"UT Arlington",3,1,33.3,25,70,27,15,0,52,0,17,26,43,16,67,55,15,40,46,10,36,5,0.2,210,7.61904761904762
"624",2016,"UTSA",3,1,33.3,34,84,21,14,0,65,1,19,35,54,18,54,66,14,52,69,22,47,7,0.205882352941176,234,7.69230769230769
"625",2017,"Auburn",39,13,33.3,391,533,351,230,0,549,0,278,222,500,330,387,660,204,456,583,169,414,99,0.253196930946292,2047,16.1211529066927
"626",2017,"BYU",6,2,33.3,72,196,100,61,0,161,0,81,49,130,73,125,183,55,128,143,40,103,13,0.180555555555556,591,12.3519458544839
"627",2017,"Creighton",3,1,33.3,47,143,48,32,0,72,0,55,43,98,26,73,82,27,55,110,42,68,11,0.234042553191489,403,6.45161290322581
"628",2017,"Florida Gulf Coast",3,1,33.3,57,118,65,45,0,94,0,48,46,94,32,63,62,24,38,137,41,96,14,0.245614035087719,357,8.96358543417367
"629",2017,"Idaho",6,2,33.3,59,202,69,47,0,106,0,62,52,114,45,89,106,35,71,261,87,174,16,0.271186440677966,544,8.27205882352941
"630",2017,"Kentucky",24,8,33.3,339,743,412,283,0,437,2,318,141,459,200,365,780,264,516,500,157,343,74,0.218289085545723,2294,8.71839581517001
"631",2017,"Longwood",3,1,33.3,35,92,27,18,0,86,0,23,36,59,21,98,71,18,53,82,23,59,9,0.257142857142857,293,7.16723549488055
"632",2017,"Loyola Maryland",3,1,33.3,32,81,27,19,0,67,0,32,35,67,22,57,76,32,44,84,33,51,11,0.34375,277,7.94223826714801
"633",2017,"Marquette",3,1,33.3,81,195,98,62,0,104,0,103,61,164,49,82,129,60,69,154,55,99,23,0.283950617283951,595,8.23529411764706
"634",2017,"New Mexico State",3,1,33.3,34,74,51,30,0,53,1,31,24,55,33,47,63,21,42,44,17,27,7,0.205882352941176,236,13.9830508474576
"635",2017,"North Texas",3,1,33.3,23,87,50,27,0,94,0,38,35,73,30,74,85,34,51,56,20,36,9,0.391304347826087,287,10.4529616724739
"636",2017,"Ole Miss",9,3,33.3,387,745,424,259,0,677,6,383,263,646,289,512,655,207,448,572,174,398,108,0.27906976744186,2508,11.5231259968102
"637",2017,"Oregon",18,6,33.3,396,849,351,237,0,551,3,401,264,665,232,461,768,263,505,507,201,306,124,0.313131313131313,2660,8.7218045112782
"638",2017,"San José State",3,1,33.3,62,129,55,34,0,108,1,42,32,74,46,89,152,44,108,144,40,104,11,0.17741935483871,419,10.9785202863962
"639",2017,"South Dakota",6,2,33.3,31,93,37,29,0,72,0,39,21,60,21,57,58,22,36,97,36,61,13,0.419354838709677,287,7.31707317073171
"640",2017,"St. John's",3,1,33.3,88,220,113,68,0,157,2,80,80,160,59,144,189,62,127,119,36,83,16,0.181818181818182,655,9.00763358778626
"641",2017,"Stanford",12,4,33.3,430,873,398,252,0,445,0,472,364,836,225,426,491,171,320,538,190,348,130,0.302325581395349,2647,8.50018889308651
"642",2017,"Tulane",6,2,33.3,116,257,93,61,0,187,0,91,98,189,67,195,221,85,136,200,68,132,28,0.241379310344828,832,8.05288461538462
"643",2017,"UCF",9,3,33.3,93,163,81,44,0,129,2,85,61,146,67,115,190,68,122,78,19,59,24,0.258064516129032,563,11.9005328596803
"644",2018,"Arizona State",12,4,33.3,411,799,360,235,0,438,3,343,285,628,232,366,763,318,445,437,145,292,112,0.272506082725061,2473,9.38131823695916
"645",2018,"Boston University",3,1,33.3,21,54,30,16,0,28,0,27,20,47,19,39,22,5,17,36,12,24,7,0.333333333333333,166,11.4457831325301
"646",2018,"Cal State Northridge",3,1,33.3,76,169,84,55,0,69,0,56,36,92,26,103,129,49,80,100,26,74,22,0.289473684210526,497,5.23138832997988
"647",2018,"Central Michigan",3,1,33.3,50,124,52,36,0,64,0,46,30,76,15,64,76,29,47,78,33,45,16,0.32,359,4.17827298050139
"648",2018,"Furman",6,2,33.3,24,77,28,18,0,36,0,31,13,44,10,33,69,17,52,54,14,40,7,0.291666666666667,200,5
"649",2018,"George Washington",6,2,33.3,82,189,90,65,0,152,0,72,45,117,75,90,223,64,159,178,60,118,25,0.304878048780488,580,12.9310344827586
"650",2018,"Georgetown",3,1,33.3,81,144,63,42,0,81,1,52,68,120,44,66,183,60,123,83,24,59,14,0.17283950617284,438,10.0456621004566
"651",2018,"Howard",3,1,33.3,39,69,42,24,0,55,1,19,33,52,20,68,75,20,55,40,15,25,8,0.205128205128205,237,8.43881856540084
"652",2018,"Idaho State",6,2,33.3,45,143,52,37,0,81,0,65,45,110,35,83,85,35,50,99,39,60,10,0.222222222222222,428,8.17757009345794
"653",2018,"Louisville",9,3,33.3,376,797,349,242,0,498,3,390,188,578,260,401,666,258,408,459,177,282,104,0.276595744680851,2465,10.5476673427992
"654",2018,"Marshall",3,1,33.3,31,69,18,13,0,51,0,31,19,50,17,50,69,17,52,54,18,36,9,0.290322580645161,221,7.69230769230769
"655",2018,"Michigan State",27,9,33.3,432,803,376,255,0,535,1,357,260,617,261,445,684,262,422,515,168,347,133,0.30787037037037,2560,10.1953125
"656",2018,"Middle Tennessee",9,3,33.3,89,217,128,85,0,189,0,71,60,131,62,174,120,24,96,189,54,135,24,0.269662921348315,667,9.29535232383808
"657",2018,"Missouri State",3,1,33.3,125,198,92,62,0,149,0,54,50,104,59,123,276,99,177,191,60,131,37,0.296,678,8.70206489675516
"658",2018,"North Florida",6,2,33.3,61,114,60,42,0,102,1,52,47,99,41,110,159,42,117,92,24,68,12,0.19672131147541,423,9.69267139479905
"659",2018,"Oklahoma",9,3,33.3,341,785,463,296,0,478,1,425,333,758,239,417,409,142,267,519,175,344,96,0.281524926686217,2401,9.95418575593503
"660",2018,"SIU Edwardsville",3,1,33.3,39,103,52,35,0,75,0,34,33,67,26,50,95,28,67,59,19,40,12,0.307692307692308,289,8.99653979238754
"661",2018,"South Alabama",12,4,33.3,77,184,59,32,0,107,1,69,58,127,57,112,128,43,85,165,62,103,22,0.285714285714286,558,10.2150537634409
"662",2018,"South Carolina",6,2,33.3,297,641,381,248,0,300,1,266,116,382,163,266,554,233,321,281,93,188,96,0.323232323232323,1895,8.60158311345646
"663",2018,"Southern Miss",6,2,33.3,38,80,21,12,0,84,0,36,22,58,27,69,119,39,80,53,19,34,14,0.368421052631579,286,9.44055944055944
"664",2018,"Southern Utah",3,1,33.3,29,76,40,22,0,50,0,26,26,52,27,53,71,23,48,51,11,40,10,0.344827586206897,226,11.9469026548673
"665",2018,"Toledo",9,3,33.3,35,108,47,32,0,72,0,50,33,83,21,60,64,25,39,81,22,59,12,0.342857142857143,312,6.73076923076923
"666",2018,"UMass",3,1,33.3,18,33,12,7,0,16,0,10,9,19,1,12,29,11,18,20,4,16,7,0.388888888888889,92,1.08695652173913
"667",2018,"UNC Greensboro",3,1,33.3,47,92,49,33,0,49,0,34,47,81,23,65,90,28,62,60,18,42,13,0.276595744680851,299,7.69230769230769
"668",2018,"UNLV",3,1,33.3,69,156,70,46,0,105,0,73,69,142,48,115,98,24,74,109,31,78,18,0.260869565217391,484,9.91735537190083
"669",2018,"Wichita State",3,1,33.3,55,98,34,27,0,80,0,42,38,80,35,67,99,32,67,69,20,49,24,0.436363636363636,327,10.7033639143731
"670",2018,"Yale",3,1,33.3,65,152,93,54,0,94,1,83,73,156,51,95,73,28,45,116,37,79,20,0.307692307692308,488,10.4508196721311
"671",2019,"Army",3,1,33.3,34,47,25,11,0,33,0,16,34,50,11,24,29,6,23,40,14,26,9,0.264705882352941,149,7.38255033557047
"672",2019,"Cincinnati",3,1,33.3,122,267,113,71,0,182,0,128,113,241,74,133,232,76,156,170,53,117,42,0.344262295081967,803,9.21544209215442
"673",2019,"East Carolina",3,1,33.3,39,85,25,15,0,47,1,42,33,75,40,54,94,29,65,49,7,42,11,0.282051282051282,264,15.1515151515152
"674",2019,"Eastern Washington",6,2,33.3,57,146,55,38,0,76,0,29,35,64,36,110,152,58,94,119,42,77,12,0.210526315789474,452,7.9646017699115
"675",2019,"Elon",3,1,33.3,49,77,59,35,0,63,1,51,42,93,23,83,61,21,40,66,19,47,10,0.204081632653061,312,7.37179487179487
"676",2019,"Fordham",3,1,33.3,69,150,45,33,0,96,0,60,36,96,35,84,125,38,87,175,66,109,21,0.304347826086957,480,7.29166666666667
"677",2019,"Fresno State",3,1,33.3,46,98,34,29,0,98,0,65,30,95,42,74,82,32,50,113,31,82,19,0.41304347826087,353,11.8980169971671
"678",2019,"George Mason",3,1,33.3,53,86,39,28,0,57,0,32,27,59,17,59,62,16,46,69,16,53,12,0.226415094339623,269,6.31970260223048
"679",2019,"Georgetown",3,1,33.3,65,166,66,48,0,79,0,63,72,135,44,59,119,29,90,106,42,64,16,0.246153846153846,442,9.95475113122172
"680",2019,"High Point",3,1,33.3,48,80,50,32,0,89,0,47,29,76,32,73,85,24,61,77,20,57,17,0.354166666666667,302,10.5960264900662
"681",2019,"Kansas City",3,1,33.3,83,113,61,41,0,85,0,49,61,110,36,80,69,19,50,127,41,86,22,0.265060240963855,399,9.02255639097744
"682",2019,"Lipscomb",3,1,33.3,26,68,34,20,0,51,0,17,33,50,25,63,42,12,30,70,19,51,4,0.153846153846154,216,11.5740740740741
"683",2019,"Memphis",3,1,33.3,59,87,39,26,0,60,0,37,50,87,25,53,86,19,67,75,19,56,13,0.220338983050847,281,8.89679715302491
"684",2019,"Michigan State",15,5,33.3,377,767,410,265,0,551,0,421,343,764,251,428,523,185,338,562,203,359,115,0.305039787798409,2466,10.1784266017843
"685",2019,"Missouri",12,4,33.3,288,822,371,253,0,542,2,328,186,514,181,504,347,119,228,704,254,450,77,0.267361111111111,2413,7.50103605470369
"686",2019,"NC State",9,3,33.3,327,874,354,226,0,345,6,373,256,629,132,392,385,143,242,611,209,402,99,0.302752293577982,2404,5.49084858569052
"687",2019,"Niagara",3,1,33.3,61,75,48,26,0,72,2,27,34,61,37,82,98,21,77,85,16,69,11,0.180327868852459,290,12.7586206896552
"688",2019,"Prairie View A&M",6,2,33.3,115,199,81,60,0,188,0,61,100,161,77,151,202,51,151,148,31,117,23,0.2,630,12.2222222222222
"689",2019,"Rutgers",9,3,33.3,362,641,311,210,1,560,10,389,303,692,298,456,402,124,278,517,151,366,131,0.361878453038674,2212,13.4719710669078
"690",2019,"Stephen F. Austin",3,1,33.3,44,80,27,16,0,76,0,41,36,77,38,81,52,15,37,94,34,60,11,0.25,300,12.6666666666667
"691",2019,"Toledo",3,1,33.3,44,81,32,21,0,64,0,41,38,79,22,52,79,27,52,67,20,47,13,0.295454545454545,272,8.08823529411765
"692",2019,"UC Santa Barbara",3,1,33.3,49,63,32,18,0,46,0,16,33,49,17,54,50,11,39,69,17,52,14,0.285714285714286,215,7.90697674418605
"693",2019,"UNC Wilmington",3,1,33.3,33,57,23,15,0,51,2,32,17,49,21,36,71,19,52,59,17,42,11,0.333333333333333,195,10.7692307692308
"694",2019,"UT Arlington",3,1,33.3,43,56,23,17,0,53,1,26,22,48,31,41,69,23,46,64,13,51,9,0.209302325581395,209,14.8325358851675
"695",2019,"Washington",18,6,33.3,385,637,253,163,0,437,3,259,196,455,229,462,586,191,395,706,222,484,124,0.322077922077922,2222,10.3060306030603
"696",2020,"Akron",15,5,33.3,338,785,335,216,0,514,7,379,380,759,200,433,575,190,385,342,104,238,115,0.340236686390533,2313,8.64677907479464
"697",2020,"BYU",15,5,33.3,361,845,266,161,0,438,2,298,222,520,201,401,782,233,549,379,123,256,109,0.301939058171745,2329,8.63031343924431
"698",2020,"Belmont",15,5,33.3,426,941,367,245,0,462,1,329,241,570,158,517,653,203,450,469,137,332,155,0.363849765258216,2636,5.99393019726859
"699",2020,"Bucknell",9,3,33.3,118,359,112,76,0,225,0,139,124,263,86,181,294,109,185,202,76,126,45,0.38135593220339,1004,8.56573705179283
"700",2020,"Cal State Bakersfield",27,9,33.3,394,654,300,189,0,522,1,332,332,664,262,424,636,191,445,370,99,271,110,0.279187817258883,2155,12.1577726218097
"701",2020,"Chattanooga",15,5,33.3,261,669,269,183,0,384,1,235,248,483,141,453,538,156,382,362,103,259,79,0.302681992337165,1939,7.2717895822589
"702",2020,"Colgate",18,6,33.3,292,641,255,173,0,450,0,341,242,583,246,357,734,280,454,295,99,196,103,0.352739726027397,2081,11.8212397885632
"703",2020,"Coppin State",9,3,33.3,303,630,307,183,0,433,9,244,280,524,166,547,564,126,438,302,79,223,74,0.244224422442244,1993,8.32915203211239
"704",2020,"Fairfield",21,7,33.3,309,668,250,169,0,390,1,255,222,477,179,378,841,283,558,265,81,184,100,0.323624595469256,2049,8.73596876525134
"705",2020,"Hampton",21,7,33.3,317,630,374,245,0,481,0,313,271,584,299,415,670,189,481,323,102,221,92,0.290220820189274,2059,14.52161243322
"706",2020,"Illinois",12,4,33.3,345,707,358,213,0,495,2,249,180,429,261,436,1009,287,722,377,127,250,90,0.260869565217391,2230,11.7040358744395
"707",2020,"Iona",18,6,33.3,229,519,176,113,0,390,1,194,190,384,162,410,602,192,410,190,62,128,69,0.301310043668122,1646,9.84204131227217
"708",2020,"James Madison",15,5,33.3,496,820,370,246,0,463,1,313,217,530,233,413,792,241,551,457,153,304,172,0.346774193548387,2524,9.23137876386688
"709",2020,"Kentucky",6,2,33.3,336,519,295,190,0,386,1,201,142,343,212,275,642,234,408,381,138,243,114,0.339285714285714,1775,11.943661971831
"710",2020,"Marian",3,1,33.3,10,26,8,6,0,14,0,8,4,12,7,9,16,5,11,32,8,24,0,0,67,10.4477611940298
"711",2020,"McNeese",6,2,33.3,460,737,370,232,0,530,1,293,283,576,227,590,870,269,601,324,107,217,166,0.360869565217391,2540,8.93700787401575
"712",2020,"Memphis",18,6,33.3,493,755,446,269,0,474,2,425,372,797,236,555,612,184,428,310,105,205,173,0.350912778904665,2632,8.96656534954407
"713",2020,"Oakland",9,3,33.3,326,704,304,209,0,534,2,343,265,608,215,425,777,253,524,338,92,246,117,0.358895705521472,2222,9.67596759675968
"714",2020,"Ole Miss",15,5,33.3,296,665,290,169,0,509,3,260,189,449,215,504,827,258,569,351,105,246,83,0.280405405405405,2152,9.9907063197026
"715",2020,"Oregon State",9,3,33.3,409,868,329,204,0,360,3,355,242,597,138,387,614,246,368,414,144,270,118,0.288508557457213,2483,5.55779299234797
"716",2020,"Pepperdine",33,11,33.3,476,750,370,229,0,473,2,292,287,579,242,338,1032,327,705,341,110,231,155,0.32563025210084,2386,10.1424979044426
"717",2020,"Purdue",12,4,33.3,425,828,389,251,0,468,1,380,293,673,214,522,818,271,547,319,110,209,154,0.362352941176471,2644,8.09379727685325
"718",2020,"SE Louisiana",15,5,33.3,314,688,296,197,0,542,2,252,234,486,222,435,762,272,490,341,109,232,104,0.331210191082803,2142,10.3641456582633
"719",2020,"Santa Clara",27,9,33.3,327,733,277,187,0,446,2,348,283,631,170,363,667,211,456,349,116,233,109,0.333333333333333,2166,7.84856879039704
"720",2020,"South Dakota State",6,2,33.3,451,823,409,269,0,453,1,479,378,857,232,437,529,192,337,418,135,283,170,0.376940133037694,2623,8.84483415935951
"721",2020,"Southeast Missouri State",15,5,33.3,540,882,433,284,0,592,1,421,321,742,297,462,996,370,626,329,101,228,167,0.309259259259259,2895,10.259067357513
"722",2020,"Stephen F. Austin",6,2,33.3,381,706,364,215,0,429,2,418,331,749,287,435,440,154,286,379,116,263,140,0.36745406824147,2287,12.5491910800175
"723",2020,"Stony Brook",24,8,33.3,419,685,320,203,0,394,0,332,329,661,217,368,648,197,451,347,105,242,120,0.286396181384248,2196,9.8816029143898
"724",2020,"Tennessee",15,5,33.3,412,815,331,202,0,425,1,387,249,636,145,421,740,254,486,264,86,178,153,0.371359223300971,2457,5.9015059015059
"725",2020,"Texas A&M-Corpus Christi",9,3,33.3,349,767,416,268,4,448,0,339,204,543,278,523,770,255,515,188,55,133,125,0.358166189111748,2403,11.5688722430295
"726",2020,"UMBC",18,6,33.3,366,762,340,222,0,422,0,304,327,631,174,486,702,239,463,193,65,128,127,0.346994535519126,2320,7.5
"727",2020,"UTSA",9,3,33.3,396,646,354,203,0,464,1,253,211,464,199,437,863,258,605,243,71,172,143,0.361111111111111,2143,9.28604759682688
"728",2020,"Winthrop",27,9,33.3,361,815,346,208,0,484,1,237,180,417,201,541,1004,318,686,212,66,146,117,0.32409972299169,2410,8.3402489626556
"729",2020,"Wisconsin",12,4,33.3,435,815,374,232,0,421,3,367,286,653,173,433,823,270,553,306,92,214,176,0.404597701149425,2514,6.88146380270485
"730",2020,"Wright State",18,6,33.3,555,833,381,235,0,529,9,366,255,621,215,422,1044,335,709,330,102,228,171,0.308108108108108,2711,7.93065289561047
"731",2020,"UC Santa Barbara",37,12,32.4,305,667,243,159,0,364,2,232,187,419,138,354,609,192,417,338,100,238,102,0.334426229508197,1906,7.24029380902413
"732",2019,"Nebraska",31,10,32.3,336,764,378,248,0,518,3,336,259,595,214,435,545,185,360,606,218,388,99,0.294642857142857,2361,9.06395595086828
"733",2020,"Long Island University",28,9,32.1,410,670,262,169,0,504,0,271,375,646,268,473,757,240,517,288,95,193,104,0.253658536585366,2222,12.0612061206121
"734",2020,"UAB",28,9,32.1,297,888,395,269,0,490,1,300,139,439,149,423,857,306,551,449,183,266,105,0.353535353535354,2493,5.97673485760128
"735",2017,"Alabama",25,8,32,426,922,549,335,0,520,2,262,162,424,249,537,927,339,588,572,172,400,109,0.255868544600939,2788,8.93113342898135
"736",2020,"Idaho",25,8,32,388,862,352,216,0,436,1,284,228,512,169,340,833,287,546,494,139,355,151,0.389175257731959,2376,7.11279461279461
"737",2020,"Southern Illinois",22,7,31.8,350,651,403,231,0,535,1,384,309,693,269,407,641,205,436,309,108,201,115,0.328571428571429,2198,12.238398544131
"738",2016,"Kansas",19,6,31.6,329,696,298,188,0,590,2,273,269,542,228,556,589,165,424,578,180,398,83,0.252279635258359,2273,10.0307963044435
"739",2020,"Saint Joseph's",19,6,31.6,369,660,253,155,0,443,0,260,240,500,180,431,716,225,491,299,79,220,101,0.273712737127371,2076,8.67052023121387
"740",2020,"Washington",19,6,31.6,387,664,279,186,0,430,1,273,176,449,253,433,832,265,567,357,108,249,117,0.302325581395349,2198,11.5104640582348
"741",2019,"Kentucky",35,11,31.4,388,644,359,247,0,539,0,239,137,376,329,397,871,296,575,576,207,369,84,0.216494845360825,2255,14.589800443459
"742",2017,"USC",16,5,31.2,334,628,344,226,0,537,2,401,366,767,271,457,447,135,312,429,153,276,109,0.326347305389222,2196,12.3406193078324
"743",2019,"Virginia",16,5,31.2,359,609,281,196,0,337,2,234,248,482,163,404,539,170,369,474,130,344,108,0.3008356545961,1983,8.21986888552698
"744",2020,"Morgan State",16,5,31.2,387,535,307,201,0,466,3,309,282,591,282,366,686,211,475,296,76,220,121,0.31266149870801,1957,14.4098109351048
"745",2020,"Northeastern",16,5,31.2,360,616,385,236,0,507,4,337,307,644,239,537,534,175,359,327,95,232,97,0.269444444444444,2212,10.8047016274864
"746",2020,"UNC Asheville",16,5,31.2,441,705,381,228,0,398,1,253,255,508,138,407,697,235,462,250,67,183,135,0.306122448979592,2192,6.2956204379562
"747",2017,"Kansas",29,9,31,402,715,372,229,0,634,4,275,342,617,285,466,619,168,451,703,212,491,77,0.191542288557214,2329,12.2370115929584
"748",2016,"California",39,12,30.8,393,800,389,237,0,428,4,390,253,643,225,554,707,257,450,464,149,315,132,0.33587786259542,2635,8.53889943074004
"749",2016,"Western Kentucky",13,4,30.8,89,167,94,66,0,119,0,58,50,108,43,91,202,75,127,106,34,72,23,0.258426966292135,531,8.09792843691149
"750",2017,"Indiana",13,4,30.8,415,869,439,300,0,583,1,556,428,984,270,438,461,159,302,639,216,423,143,0.344578313253012,2763,9.77198697068404
"751",2017,"SMU",13,4,30.8,155,353,182,109,0,237,0,130,133,263,81,262,291,96,195,160,46,114,40,0.258064516129032,1083,7.4792243767313
"752",2018,"Florida",26,8,30.8,395,847,262,168,0,345,1,265,183,448,123,466,487,173,314,728,224,504,109,0.275949367088608,2421,5.08054522924411
"753",2018,"Virginia",13,4,30.8,316,705,296,195,0,413,3,262,234,496,191,412,523,181,342,433,146,287,78,0.246835443037975,2103,9.08226343319068
"754",2019,"Gonzaga",13,4,30.8,314,639,326,227,0,379,0,323,260,583,233,333,629,269,360,282,114,168,98,0.312101910828025,2067,11.2723754233188
"755",2019,"Tennessee",13,4,30.8,412,666,351,232,0,464,1,340,200,540,201,398,670,233,437,411,135,276,127,0.308252427184466,2283,8.8042049934297
"756",2020,"Kent State",26,8,30.8,373,740,434,289,0,498,1,380,351,731,214,396,688,216,472,365,113,252,123,0.329758713136729,2322,9.21619293712317
"757",2020,"LSU",26,8,30.8,438,724,460,254,0,519,4,362,212,574,244,436,970,330,640,169,43,126,142,0.324200913242009,2419,10.0868127325341
"758",2020,"Louisiana",13,4,30.8,374,700,410,279,0,485,4,304,244,548,243,401,854,272,582,248,87,161,138,0.368983957219251,2241,10.8433734939759
"759",2020,"North Florida",13,4,30.8,329,874,347,233,0,436,0,282,301,583,183,449,761,248,513,375,130,245,100,0.303951367781155,2382,7.68261964735516
"760",2020,"Saint Mary's",26,8,30.8,324,848,236,164,0,411,1,297,290,587,139,486,619,237,382,487,182,305,109,0.33641975308642,2428,5.72487644151565
"761",2020,"UCLA",26,8,30.8,551,721,364,245,1,501,3,335,284,619,263,347,885,288,597,398,114,284,174,0.31578947368421,2439,10.7831078310783
"762",2016,"Stanford",23,7,30.4,458,944,423,264,0,501,1,398,364,762,227,475,579,215,364,639,234,405,130,0.283842794759825,2810,8.07829181494662
"763",2020,"Cal State Fullerton",23,7,30.4,306,816,324,216,0,438,0,348,212,560,176,395,929,320,609,266,79,187,97,0.316993464052288,2344,7.50853242320819
"764",2020,"Saint Louis",23,7,30.4,462,820,383,246,0,494,0,296,313,609,165,463,794,257,537,328,109,219,149,0.322510822510823,2505,6.58682634730539
"765",2020,"Nevada",33,10,30.3,387,659,281,196,0,456,2,291,232,523,216,402,920,336,584,325,93,232,120,0.310077519379845,2245,9.62138084632517
"766",2017,"Long Beach State",10,3,30,90,124,78,47,0,148,0,55,64,119,63,89,123,32,91,185,60,125,24,0.266666666666667,468,13.4615384615385
"767",2017,"Villanova",10,3,30,66,198,51,41,0,122,0,61,46,107,34,80,121,35,86,237,64,173,18,0.272727272727273,515,6.60194174757282
"768",2017,"West Virginia",10,3,30,394,882,399,265,0,561,3,391,186,577,264,515,705,237,468,602,214,388,131,0.33248730964467,2721,9.70231532524807
"769",2018,"Ohio State",10,3,30,384,809,373,257,0,408,2,372,209,581,261,310,633,244,389,677,239,438,123,0.3203125,2455,10.6313645621181
"770",2018,"Southeast Missouri State",10,3,30,33,71,32,18,0,65,0,20,16,36,18,60,73,25,48,45,11,34,13,0.393939393939394,227,7.9295154185022
"771",2019,"Alabama",20,6,30,364,803,390,248,0,484,2,228,186,414,210,548,722,273,449,577,177,400,96,0.263736263736264,2501,8.39664134346261
"772",2019,"Kansas",20,6,30,367,683,378,244,0,611,3,336,267,603,253,439,548,154,394,644,205,439,101,0.275204359673025,2261,11.1897390535161
"773",2019,"Minnesota",10,3,30,407,780,465,308,0,453,4,347,317,664,213,453,573,199,374,423,147,276,113,0.277641277641278,2446,8.70809484873262
"774",2020,"Cal Poly",20,6,30,354,771,284,187,0,461,1,279,237,516,166,470,779,270,509,220,62,158,122,0.344632768361582,2275,7.2967032967033
"775",2020,"Eastern Kentucky",20,6,30,405,771,339,204,0,497,2,246,192,438,218,507,831,226,605,404,118,286,95,0.234567901234568,2348,9.28449744463373
"776",2020,"Incarnate Word",20,6,30,347,654,358,223,0,428,0,204,248,452,222,429,723,250,473,297,85,212,116,0.334293948126801,2054,10.8081791626095
"777",2020,"La Salle",30,9,30,429,793,344,223,0,528,2,220,254,474,193,528,725,232,493,501,151,350,122,0.284382284382284,2422,7.96862097440132
"778",2020,"Louisiana Tech",20,6,30,411,675,411,272,0,499,0,345,304,649,244,441,731,225,506,307,105,202,147,0.357664233576642,2304,10.5902777777778
"779",2020,"Pacific",30,9,30,442,785,409,271,0,592,0,379,327,706,273,486,759,254,505,347,107,240,145,0.328054298642534,2548,10.7142857142857
"780",2020,"Rutgers",20,6,30,479,748,378,241,1,534,2,388,269,657,283,427,805,258,547,299,97,202,159,0.331941544885177,2493,11.3517849979944
"781",2018,"Penn State",27,8,29.6,365,720,424,283,0,466,1,299,276,575,257,384,659,230,429,550,177,373,105,0.287671232876712,2266,11.3415710503089
"782",2019,"LSU",17,5,29.4,386,652,414,239,0,457,4,300,135,435,251,473,801,254,547,291,86,205,106,0.274611398963731,2254,11.1357586512866
"783",2020,"Nebraska",17,5,29.4,393,826,367,249,0,460,1,324,288,612,197,413,725,271,454,389,135,254,147,0.374045801526718,2459,8.01138674257828
"784",2020,"Notre Dame",17,5,29.4,349,710,359,227,0,433,0,332,250,582,229,485,765,258,507,280,66,214,106,0.303724928366762,2303,9.94355188884064
"785",2020,"Wake Forest",17,5,29.4,433,767,365,243,0,474,1,334,267,601,179,463,847,270,577,238,80,158,153,0.353348729792148,2433,7.35717221537197
"786",2020,"Wyoming",17,5,29.4,258,776,228,167,0,353,0,306,202,508,154,356,686,236,450,361,130,231,86,0.333333333333333,2118,7.2710103871577
"787",2017,"Wake Forest",24,7,29.2,457,813,394,246,0,535,4,322,270,592,228,559,809,271,538,455,136,319,124,0.271334792122538,2641,8.63309352517986
"788",2020,"Charleston",24,7,29.2,448,670,424,250,0,581,0,276,295,571,261,484,862,272,590,374,120,254,126,0.28125,2372,11.0033726812816
"789",2017,"Michigan State",31,9,29,356,878,342,233,0,616,2,340,238,578,196,481,631,235,396,625,223,402,117,0.328651685393258,2597,7.54716981132075
"790",2016,"Creighton",7,2,28.6,112,297,108,76,0,179,0,106,106,212,66,151,229,78,151,233,77,156,32,0.285714285714286,847,7.79220779220779
"791",2016,"Eastern Michigan",7,2,28.6,88,161,79,54,0,109,0,67,63,130,71,86,179,58,121,152,52,100,27,0.306818181818182,530,13.3962264150943
"792",2016,"Navy",7,2,28.6,27,48,12,7,0,36,0,11,20,31,15,31,38,13,25,40,13,27,7,0.259259259259259,145,10.3448275862069
"793",2016,"Ohio",7,2,28.6,53,115,72,40,0,94,0,50,33,83,20,63,66,17,49,135,36,99,16,0.30188679245283,350,5.71428571428571
"794",2016,"Oklahoma",7,2,28.6,373,842,436,286,0,564,4,411,316,727,267,520,525,165,360,603,193,410,113,0.302949061662198,2616,10.2064220183486
"795",2016,"Penn State",21,6,28.6,317,661,345,234,0,542,1,344,287,631,225,388,675,228,447,392,134,258,100,0.315457413249211,2147,10.4797391709362
"796",2016,"UTEP",7,2,28.6,86,151,90,50,0,136,1,52,37,89,63,83,193,70,123,98,28,70,19,0.22093023255814,489,12.8834355828221
"797",2017,"Boston College",14,4,28.6,299,720,286,181,0,526,0,383,332,715,189,555,397,127,270,453,141,312,73,0.244147157190635,2282,8.28220858895705
"798",2017,"Illinois",14,4,28.6,294,736,250,179,0,545,1,179,123,302,199,409,910,334,576,613,192,421,90,0.306122448979592,2203,9.03313663186564
"799",2017,"Nevada",7,2,28.6,30,42,22,15,0,28,0,10,11,21,22,37,58,15,43,50,12,38,5,0.166666666666667,151,14.5695364238411
"800",2017,"Vanderbilt",21,6,28.6,352,789,443,301,0,627,1,267,234,501,167,529,583,185,398,541,209,332,82,0.232954545454545,2436,6.85550082101806
"801",2018,"Butler",7,2,28.6,78,144,62,44,0,91,0,73,79,152,39,88,90,33,57,114,41,73,22,0.282051282051282,469,8.31556503198294
"802",2018,"NC State",7,2,28.6,408,807,446,275,0,410,4,307,286,593,184,395,474,165,309,528,157,371,113,0.276960784313726,2349,7.83312047679864
"803",2018,"Saint Mary's",7,2,28.6,84,203,113,71,0,137,0,114,64,178,32,156,109,43,66,101,34,67,24,0.285714285714286,661,4.8411497730711
"804",2018,"Tulane",7,2,28.6,80,193,70,47,0,113,0,65,66,131,57,104,132,51,81,138,46,92,21,0.2625,556,10.2517985611511
"805",2019,"California",28,8,28.6,409,804,371,236,0,446,1,368,279,647,133,391,543,209,334,616,221,395,159,0.388753056234719,2507,5.30514559234144
"806",2019,"Iowa",7,2,28.6,255,754,298,206,0,348,0,508,275,783,156,336,320,141,179,422,154,268,96,0.376470588235294,2225,7.01123595505618
"807",2019,"Vanderbilt",14,4,28.6,281,652,363,229,0,483,3,343,228,571,150,423,610,193,417,324,114,210,83,0.295373665480427,2102,7.1360608943863
"808",2020,"Abilene Christian",14,4,28.6,371,728,398,272,0,498,2,446,292,738,250,471,403,156,247,446,171,275,150,0.404312668463612,2427,10.3007828594973
"809",2020,"Bethune-Cookman",7,2,28.6,346,742,399,241,0,418,1,325,280,605,229,419,665,220,445,301,96,205,109,0.315028901734104,2248,10.1868327402135
"810",2020,"Boston University",14,4,28.6,283,679,301,185,0,404,0,289,292,581,153,425,447,154,293,334,115,219,95,0.335689045936396,2024,7.55928853754941
"811",2020,"Eastern Michigan",21,6,28.6,442,822,446,262,0,602,6,368,400,768,253,440,786,253,533,343,103,240,138,0.312217194570136,2537,9.97240835632637
"812",2020,"Evansville",7,2,28.6,263,722,311,185,0,532,1,296,253,549,219,552,612,180,432,464,132,332,87,0.330798479087452,2218,9.87376014427412
"813",2020,"Florida",7,2,28.6,397,734,318,183,0,400,1,347,269,616,169,445,646,201,445,340,98,242,128,0.322418136020151,2307,7.32553099263112
"814",2020,"Georgetown",21,6,28.6,387,741,265,172,0,461,4,214,234,448,173,397,942,295,647,355,103,252,109,0.281653746770026,2195,7.88154897494305
"815",2020,"Idaho State",14,4,28.6,301,678,234,146,0,521,3,278,210,488,205,406,758,277,481,264,96,168,103,0.3421926910299,2093,9.79455327281414
"816",2020,"Kansas State",28,8,28.6,400,883,387,245,0,470,0,387,232,619,202,477,877,262,615,332,90,242,138,0.345,2591,7.79621767657275
"817",2020,"Milwaukee",7,2,28.6,322,836,319,216,1,510,1,313,283,596,209,545,671,233,438,425,124,301,78,0.24223602484472,2444,8.55155482815057
"818",2020,"North Alabama",14,4,28.6,311,765,352,239,0,478,1,439,290,729,232,450,426,148,278,475,173,302,98,0.315112540192926,2377,9.76020193521245
"819",2020,"Portland",28,8,28.6,415,723,348,236,0,516,0,479,365,844,298,526,558,193,365,338,111,227,145,0.349397590361446,2545,11.7092337917485
"820",2020,"Stetson",14,4,28.6,376,802,354,207,0,524,0,397,364,761,197,532,551,178,373,302,90,212,136,0.361702127659574,2454,8.02770986145069
"821",2020,"UC Davis",21,6,28.6,327,782,312,198,0,429,0,291,233,524,181,373,632,225,407,441,157,284,126,0.385321100917431,2236,8.09481216457961
"822",2020,"UT Martin",21,6,28.6,394,831,461,308,0,583,3,311,206,517,306,509,991,404,587,342,100,242,133,0.33756345177665,2649,11.5515288788222
"823",2020,"Colorado State",39,11,28.2,242,755,231,153,0,397,1,217,142,359,212,309,874,274,600,473,156,317,76,0.31404958677686,2009,10.5525136884022
"824",2016,"Louisville",25,7,28,494,743,407,273,0,554,4,388,244,632,313,472,794,290,504,551,182,369,147,0.297570850202429,2669,11.7272386661671
"825",2019,"Purdue",25,7,28,426,791,396,265,0,503,4,312,253,565,215,480,701,245,456,577,189,388,117,0.274647887323944,2536,8.47791798107255
"826",2017,"Oklahoma",18,5,27.8,320,757,375,253,0,464,3,373,303,676,231,414,497,165,332,510,174,336,96,0.3,2282,10.1226993865031
"827",2019,"Clemson",18,5,27.8,418,755,435,271,0,516,4,398,361,759,331,574,722,241,481,312,112,200,111,0.26555023923445,2619,12.6384116074838
"828",2019,"Georgia",18,5,27.8,356,713,307,193,0,465,1,342,182,524,224,444,698,246,452,386,123,263,93,0.26123595505618,2301,9.73489787049109
"829",2020,"Old Dominion",18,5,27.8,421,806,424,242,0,515,1,380,262,642,234,401,684,200,484,391,122,269,127,0.30166270783848,2429,9.63359407163442
"830",2020,"Rhode Island",18,5,27.8,420,830,362,211,0,419,1,356,385,741,163,464,567,194,373,319,101,218,128,0.304761904761905,2451,6.65034679722562
"831",2020,"Texas A&M",18,5,27.8,377,752,336,218,1,371,1,387,243,630,197,357,775,277,498,237,79,158,128,0.339522546419098,2326,8.46947549441101
"832",2020,"UNC Wilmington",18,5,27.8,366,671,387,238,0,489,0,318,227,545,228,464,680,201,479,261,78,183,110,0.300546448087432,2192,10.4014598540146
"833",2020,"Wichita State",18,5,27.8,474,737,448,286,0,603,4,382,340,722,296,577,724,212,512,321,93,228,150,0.316455696202532,2579,11.4773167894533
"834",2016,"Arizona",11,3,27.3,329,632,292,177,0,484,0,264,193,457,186,482,776,239,537,328,105,223,86,0.261398176291793,2113,8.80265026029342
"835",2016,"Iowa State",22,6,27.3,331,796,369,255,0,382,2,240,139,379,174,364,733,237,496,656,206,450,92,0.277945619335347,2260,7.69911504424779
"836",2016,"Washington",22,6,27.3,316,950,405,293,1,444,6,291,192,483,238,410,788,292,496,717,239,478,114,0.360759493670886,2615,9.10133843212237
"837",2017,"Colorado",22,6,27.3,448,730,341,216,0,598,0,386,380,766,343,413,658,214,444,625,205,420,133,0.296875,2479,13.8362242839855
"838",2017,"Texas",11,3,27.3,426,749,325,205,0,504,3,371,181,552,207,403,906,323,583,299,104,195,137,0.321596244131455,2456,8.42833876221498
"839",2018,"Troy",11,3,27.3,101,88,63,44,0,99,0,33,50,83,41,53,145,45,100,108,27,81,27,0.267326732673267,360,11.3888888888889
"840",2019,"Saint Mary's",11,3,27.3,82,241,79,46,0,111,3,119,123,242,46,129,102,42,60,159,44,115,29,0.353658536585366,671,6.85543964232489
"841",2020,"Arkansas-Pine Bluff",11,3,27.3,419,640,356,200,0,554,3,264,243,507,269,536,867,250,617,217,56,161,113,0.269689737470167,2251,11.9502443358507
"842",2020,"Austin Peay",22,6,27.3,428,599,345,209,0,592,3,306,343,649,268,442,614,190,424,500,159,341,137,0.320093457943925,2197,12.1984524351388
"843",2020,"Bryant",11,3,27.3,401,745,358,230,0,457,3,326,381,707,221,560,613,179,434,299,86,213,108,0.269326683291771,2380,9.28571428571429
"844",2020,"Cleveland State",11,3,27.3,296,733,335,219,0,418,2,358,296,654,267,367,749,226,523,272,92,180,78,0.263513513513513,2168,12.3154981549815
"845",2020,"Hartford",11,3,27.3,404,650,309,188,0,503,0,218,274,492,147,495,654,180,474,315,86,229,101,0.25,2103,6.99001426533524
"846",2020,"Hofstra",11,3,27.3,351,611,263,153,0,453,0,284,265,549,157,534,647,207,440,169,49,120,99,0.282051282051282,2097,7.48688602765856
"847",2020,"Holy Cross",11,3,27.3,387,790,332,213,1,409,0,360,384,744,176,425,505,162,343,363,144,219,133,0.343669250645995,2356,7.47028862478778
"848",2020,"Sacramento State",22,6,27.3,488,642,355,215,0,499,0,326,350,676,256,385,690,216,474,527,147,380,146,0.299180327868852,2281,11.2231477422183
"849",2020,"Texas Tech",22,6,27.3,393,764,337,226,0,388,1,360,194,554,216,431,799,278,521,357,107,250,128,0.325699745547074,2425,8.90721649484536
"850",2020,"Vermont",22,6,27.3,269,700,236,161,0,387,0,311,269,580,141,379,600,186,414,379,122,257,79,0.29368029739777,2026,6.95952615992103
"851",2016,"Washington State",26,7,26.9,361,689,286,178,0,554,0,327,294,621,293,478,645,226,419,544,169,375,85,0.235457063711911,2312,12.6730103806228
"852",2020,"Southern Utah",26,7,26.9,489,739,455,292,0,507,0,389,383,772,291,470,806,266,540,344,120,224,170,0.347648261758691,2573,11.3097551496308
"853",2018,"Kansas",15,4,26.7,357,771,415,251,0,481,2,301,232,533,194,410,519,157,362,519,151,368,78,0.218487394957983,2257,8.59548072662827
"854",2018,"Kentucky",15,4,26.7,362,696,357,238,0,479,4,246,129,375,211,359,771,262,509,456,169,287,72,0.198895027624309,2180,9.67889908256881
"855",2018,"Wisconsin",15,4,26.7,330,746,337,208,0,441,1,275,226,501,182,415,612,212,400,439,130,309,97,0.293939393939394,2175,8.36781609195402
"856",2019,"Georgia Tech",15,4,26.7,480,674,333,211,1,520,4,306,246,552,279,483,704,221,483,481,143,338,169,0.352083333333333,2400,11.625
"857",2019,"Texas Tech",30,8,26.7,485,851,441,261,0,480,1,397,262,659,242,544,636,215,421,708,212,496,153,0.315463917525773,2806,8.62437633642195
"858",2020,"Indiana",15,4,26.7,340,776,376,251,0,462,1,346,239,585,179,371,720,274,446,266,83,183,126,0.370588235294118,2278,7.85776997366111
"859",2020,"Michigan",15,4,26.7,509,799,461,287,0,499,3,562,450,1012,216,487,538,172,366,269,86,183,202,0.396856581532416,2731,7.90919077261077
"860",2020,"Montana State",15,4,26.7,461,830,431,291,1,507,2,429,312,741,292,427,821,299,522,307,101,206,162,0.351409978308026,2647,11.0313562523612
"861",2020,"Northern Arizona",30,8,26.7,374,922,387,263,0,530,1,381,344,725,216,482,850,299,551,356,125,231,118,0.315508021390374,2671,8.08685885436166
"862",2020,"Northern Colorado",15,4,26.7,462,835,372,241,1,550,2,363,361,724,219,527,786,223,563,264,79,185,158,0.341991341991342,2578,8.49495733126455
"863",2020,"Seton Hall",15,4,26.7,386,717,346,224,0,471,1,376,290,666,264,426,724,254,470,407,131,276,117,0.303108808290155,2382,11.0831234256927
"864",2020,"Towson",15,4,26.7,429,677,352,212,1,449,6,338,295,633,228,366,783,237,546,252,78,174,146,0.34032634032634,2196,10.3825136612022
"865",2016,"Syracuse",19,5,26.3,638,857,503,313,0,657,1,426,365,791,461,511,652,205,447,1098,324,774,168,0.263322884012539,3077,14.9821254468638
"866",2020,"Charlotte",19,5,26.3,426,738,339,197,0,464,1,299,206,505,183,427,882,299,583,247,74,173,130,0.305164319248826,2328,7.86082474226804
"867",2020,"Loyola Marymount",19,5,26.3,436,820,471,268,0,554,3,390,339,729,247,544,681,199,482,379,118,261,142,0.325688073394495,2607,9.47449175297277
"868",2020,"Oklahoma State",19,5,26.3,370,716,300,186,1,399,1,324,250,574,231,327,845,264,581,245,65,180,124,0.335135135135135,2139,10.7994389901823
"869",2019,"UCLA",42,11,26.2,583,789,426,286,3,551,4,435,322,757,243,427,808,273,535,504,154,350,186,0.319039451114923,2768,8.77890173410405
"870",2017,"Georgia",23,6,26.1,321,702,353,224,0,517,2,254,125,379,201,457,718,235,483,360,98,262,71,0.221183800623053,2160,9.30555555555556
"871",2020,"Central Michigan",23,6,26.1,306,821,268,188,0,469,0,262,200,462,173,432,838,359,479,426,153,273,105,0.343137254901961,2392,7.23244147157191
"872",2020,"North Texas",23,6,26.1,526,799,417,240,0,503,2,397,270,667,268,465,848,262,586,407,110,297,166,0.315589353612167,2660,10.0751879699248
"873",2020,"Ohio",23,6,26.1,412,716,433,264,0,492,4,432,426,858,320,370,548,189,359,463,155,308,135,0.327669902912621,2379,13.4510298444725
"874",2020,"Niagara",27,7,25.9,435,682,399,243,0,479,0,353,393,746,285,529,784,244,540,350,105,245,118,0.271264367816092,2437,11.6947066064834
"875",2020,"San Diego State",31,8,25.8,275,828,346,234,0,415,1,296,249,545,144,407,752,269,483,308,108,200,93,0.338181818181818,2279,6.31856077226854
"876",2020,"Arizona State",35,9,25.7,471,713,344,221,0,473,1,356,303,659,248,421,751,262,489,374,105,269,133,0.282377919320594,2414,10.2734051367026
"877",2015,"Mississippi State",4,1,25,492,734,521,335,0,607,3,268,180,448,284,502,874,287,587,520,174,346,143,0.290650406504065,2551,11.1328890631125
"878",2015,"Rutgers",4,1,25,433,873,385,244,0,603,2,430,278,708,335,507,1143,404,739,238,75,163,131,0.302540415704388,2811,11.917467093561
"879",2016,"Arizona State",20,5,25,430,726,368,243,0,540,1,292,223,515,291,470,804,294,510,505,167,338,100,0.232558139534884,2462,11.8196588139724
"880",2016,"Canisius",4,1,25,30,30,15,11,0,26,0,24,20,44,12,24,31,6,25,52,17,35,5,0.166666666666667,137,8.75912408759124
"881",2016,"Indiana State",4,1,25,30,51,12,6,0,28,1,9,17,26,14,35,41,10,31,52,16,36,7,0.233333333333333,152,9.21052631578947
"882",2016,"Little Rock",4,1,25,100,151,63,42,0,158,2,84,58,142,53,116,206,70,136,108,26,82,27,0.27,560,9.46428571428571
"883",2016,"Memphis",8,2,25,127,242,126,87,0,176,2,114,107,221,101,199,237,96,141,166,52,114,35,0.275590551181102,860,11.7441860465116
"884",2016,"North Carolina",28,7,25,356,714,358,237,0,465,2,154,152,306,203,446,832,333,499,557,156,401,98,0.275280898876405,2223,9.13180386864597
"885",2016,"North Dakota",4,1,25,75,173,92,61,0,128,1,49,50,99,48,119,182,69,113,86,26,60,15,0.2,529,9.07372400756144
"886",2016,"South Dakota State",4,1,25,129,254,138,84,0,155,0,106,122,228,67,135,148,58,90,211,79,132,30,0.232558139534884,795,8.42767295597484
"887",2016,"Southeast Missouri State",4,1,25,24,52,23,15,0,43,0,14,20,34,15,39,58,19,39,37,7,30,7,0.291666666666667,164,9.14634146341463
"888",2016,"Southern",4,1,25,113,201,108,62,0,194,1,42,56,98,65,155,337,101,236,120,29,91,24,0.212389380530973,668,9.73053892215569
"889",2016,"TCU",4,1,25,371,809,434,294,0,630,3,395,349,744,289,525,630,214,416,614,240,374,111,0.299191374663073,2652,10.8974358974359
"890",2016,"Wright State",4,1,25,119,217,117,70,0,118,0,89,99,188,56,106,199,72,127,140,40,100,33,0.277310924369748,678,8.25958702064897
"891",2017,"Furman",8,2,25,23,85,35,25,0,52,0,23,18,41,16,57,55,18,37,63,19,44,9,0.391304347826087,235,6.80851063829787
"892",2017,"Georgia State",4,1,25,46,71,32,19,0,58,0,13,27,40,22,56,98,26,72,41,12,29,12,0.260869565217391,228,9.64912280701754
"893",2017,"Grambling",4,1,25,79,130,80,49,0,93,0,63,52,115,61,88,153,40,113,106,35,71,22,0.278481012658228,455,13.4065934065934
"894",2017,"North Dakota",8,2,25,59,113,64,40,0,89,1,37,34,71,32,81,116,40,76,68,20,48,21,0.35593220338983,367,8.71934604904632
"895",2017,"Notre Dame",8,2,25,330,752,336,222,0,416,1,450,243,693,253,360,599,219,380,385,159,226,106,0.321212121212121,2351,10.761378136963
"896",2017,"SIU Edwardsville",4,1,25,68,90,78,47,0,86,0,32,44,76,27,59,119,40,79,49,16,33,16,0.235294117647059,326,8.28220858895705
"897",2018,"Duquesne",4,1,25,53,175,66,45,0,109,1,49,44,93,34,81,134,48,86,107,43,64,12,0.226415094339623,461,7.37527114967462
"898",2018,"Georgia",16,4,25,378,789,315,196,0,476,4,309,174,483,248,417,743,254,489,430,133,297,96,0.253968253968254,2344,10.580204778157
"899",2018,"Louisiana",4,1,25,77,163,99,62,0,133,3,62,52,114,49,131,161,51,110,106,28,78,17,0.220779220779221,535,9.1588785046729
"900",2018,"Milwaukee",4,1,25,52,163,64,43,0,88,0,66,54,120,43,97,78,26,52,122,37,85,7,0.134615384615385,459,9.3681917211329
"901",2018,"Missouri",8,2,25,253,733,299,208,0,377,0,273,126,399,128,347,375,121,254,511,193,318,80,0.316205533596838,1996,6.4128256513026
"902",2018,"St. John's",4,1,25,107,200,106,69,0,150,0,81,83,164,71,106,207,65,142,157,55,102,29,0.271028037383178,637,11.1459968602826
"903",2018,"Stetson",4,1,25,40,118,53,32,0,70,0,48,55,103,32,87,80,24,56,84,27,57,8,0.2,360,8.88888888888889
"904",2018,"UC Davis",4,1,25,62,202,61,43,0,119,0,79,72,151,60,103,138,50,88,181,70,111,14,0.225806451612903,576,10.4166666666667
"905",2018,"UCF",4,1,25,66,139,72,48,0,111,5,39,37,76,49,79,182,70,112,37,11,26,13,0.196969696969697,418,11.7224880382775
"906",2018,"USC",20,5,25,324,747,417,286,0,440,4,376,297,673,308,346,384,122,262,610,188,422,83,0.256172839506173,2213,13.9177586985992
"907",2018,"UT Arlington",4,1,25,50,112,54,31,0,98,0,53,38,91,29,103,95,25,70,86,17,69,11,0.22,366,7.92349726775956
"908",2018,"Villanova",4,1,25,63,240,71,53,0,119,0,106,68,174,39,77,97,39,58,241,82,159,19,0.301587301587302,634,6.15141955835962
"909",2018,"Wake Forest",24,6,25,464,768,370,235,0,515,2,356,286,642,227,473,646,217,429,492,139,353,126,0.271551724137931,2506,9.05826017557861
"910",2018,"Washington State",28,7,25,382,686,297,181,0,501,4,298,259,557,249,402,702,242,460,544,177,367,94,0.246073298429319,2262,11.0079575596817
"911",2019,"Butler",4,1,25,101,181,77,52,0,155,1,94,73,167,73,131,132,51,81,165,48,117,25,0.247524752475248,625,11.68
"912",2019,"Campbell",4,1,25,74,172,97,58,0,125,0,68,85,153,46,99,96,31,65,137,51,86,16,0.216216216216216,515,8.93203883495146
"913",2019,"Florida",16,4,25,348,716,308,189,0,486,3,299,257,556,180,475,435,138,297,763,230,533,105,0.301724137931034,2284,7.88091068301226
"914",2019,"Indiana",36,9,25,334,790,372,256,0,518,3,353,272,625,181,445,638,223,415,428,153,275,98,0.293413173652695,2390,7.57322175732217
"915",2019,"Kennesaw State",8,2,25,65,81,51,36,0,65,1,27,34,61,40,81,114,35,79,50,13,37,22,0.338461538461538,312,12.8205128205128
"916",2019,"North Alabama",8,2,25,30,92,48,29,0,75,0,47,29,76,37,80,56,15,41,81,26,55,7,0.233333333333333,304,12.1710526315789
"917",2019,"Providence",4,1,25,81,234,78,49,0,168,2,112,89,201,62,175,124,35,89,164,58,106,28,0.345679012345679,709,8.74471086036671
"918",2019,"SMU",8,2,25,58,108,64,38,0,75,0,49,55,104,35,67,96,25,71,49,10,39,16,0.275862068965517,336,10.4166666666667
"919",2019,"San Diego State",8,2,25,52,113,42,25,0,67,0,53,43,96,26,58,89,26,63,63,23,40,13,0.25,334,7.78443113772455
"920",2019,"Texas A&M-Corpus Christi",4,1,25,78,119,65,42,0,82,0,63,64,127,59,59,138,48,90,68,13,55,31,0.397435897435897,394,14.9746192893401
"921",2019,"Xavier",4,1,25,60,132,64,33,0,94,0,59,65,124,38,85,54,21,33,165,46,119,20,0.333333333333333,418,9.09090909090909
"922",2020,"American University",16,4,25,252,619,259,181,0,382,0,266,255,521,194,391,544,178,366,318,94,224,91,0.361111111111111,1869,10.3798822899946
"923",2020,"Campbell",20,5,25,357,713,324,200,0,430,1,258,230,488,197,407,588,189,399,414,127,287,100,0.280112044817927,2131,9.24448615673393
"924",2020,"Chicago State",4,1,25,364,596,321,213,0,496,1,229,260,489,184,543,822,229,593,247,80,167,104,0.285714285714286,2099,8.7660790852787
"925",2020,"Creighton",16,4,25,285,648,272,195,0,441,1,231,192,423,160,312,689,246,443,444,148,296,81,0.28421052631579,1946,8.22199383350462
"926",2020,"East Carolina",20,5,25,435,510,308,171,0,541,4,286,280,566,376,434,867,243,624,249,63,186,135,0.310344827586207,2042,18.4133202742409
"927",2020,"Florida International",20,5,25,263,813,324,188,0,494,1,233,279,512,167,516,738,240,498,294,85,209,67,0.254752851711027,2226,7.50224618149146
"928",2020,"Gonzaga",12,3,25,396,792,331,221,0,475,1,373,303,676,284,449,758,280,478,326,132,194,148,0.373737373737374,2490,11.4056224899598
"929",2020,"Harvard",16,4,25,322,637,231,130,0,331,0,232,236,468,162,391,444,133,311,348,104,244,92,0.285714285714286,1879,8.6216072378925
"930",2020,"Indiana State",8,2,25,394,665,406,238,1,608,1,361,331,692,236,465,619,168,451,293,84,209,145,0.368020304568528,2241,10.5310129406515
"931",2020,"Liberty",16,4,25,458,766,388,242,0,586,0,442,323,765,206,497,643,225,418,356,98,258,181,0.395196506550218,2600,7.92307692307692
"932",2020,"Mississippi State",8,2,25,416,671,405,258,0,505,0,461,253,714,269,359,775,295,480,263,88,175,172,0.413461538461538,2399,11.2130054189246
"933",2020,"Navy",16,4,25,334,616,196,115,0,437,0,234,227,461,269,418,751,218,533,392,115,277,93,0.278443113772455,1974,13.6271529888551
"934",2020,"New Mexico",40,10,25,437,820,366,247,0,523,8,463,379,842,333,453,755,226,529,631,194,437,158,0.361556064073227,2686,12.397617274758
"935",2020,"Northwestern State",12,3,25,438,581,403,249,0,644,1,208,290,498,276,525,780,242,538,319,85,234,135,0.308219178082192,2172,12.707182320442
"936",2020,"UTEP",16,4,25,448,765,467,289,0,593,1,364,271,635,257,526,888,301,587,315,104,211,150,0.334821428571429,2623,9.79794128860084
"937",2020,"Western Michigan",20,5,25,388,774,359,232,0,463,0,323,269,592,229,387,764,269,495,389,110,279,153,0.394329896907216,2347,9.75713677034512
"938",2020,"Youngstown State",24,6,25,272,670,281,205,1,441,1,276,191,467,153,397,650,201,449,440,142,298,91,0.334558823529412,2029,7.54066042385411
"939",2020,"Longwood",33,8,24.2,355,709,312,216,0,559,3,345,314,659,249,477,755,260,495,288,88,200,98,0.276056338028169,2306,10.7979184735473
"940",2019,"Virginia Tech",29,7,24.1,319,835,300,222,0,427,16,292,251,543,153,413,427,160,267,724,278,446,126,0.394984326018809,2368,6.46114864864865
"941",2020,"Denver",29,7,24.1,432,637,360,250,0,469,4,322,367,689,219,393,602,215,387,322,102,220,162,0.375,2178,10.0550964187328
"942",2020,"Delaware",25,6,24,446,685,360,223,1,539,2,363,328,691,246,491,739,202,537,255,76,179,132,0.295964125560538,2351,10.4636324968099
"943",2020,"Butler",21,5,23.8,463,779,474,304,0,542,3,368,314,682,341,518,668,181,487,382,121,261,149,0.321814254859611,2554,13.3516053249804
"944",2020,"California",21,5,23.8,459,748,401,272,0,502,6,372,374,746,208,472,727,238,489,329,96,233,163,0.355119825708061,2482,8.38033843674456
"945",2020,"Robert Morris",21,5,23.8,413,741,374,234,0,507,1,384,368,752,312,453,605,184,421,362,111,251,111,0.268765133171913,2375,13.1368421052632
"946",2017,"California",17,4,23.5,315,771,353,216,0,443,3,379,215,594,195,457,630,246,384,459,144,315,104,0.33015873015873,2398,8.13177648040033
"947",2017,"South Florida",17,4,23.5,249,586,236,155,0,239,2,268,185,453,104,257,354,142,212,394,120,274,80,0.321285140562249,1680,6.19047619047619
"948",2020,"Arizona",17,4,23.5,299,756,317,228,0,468,3,349,185,534,301,391,735,253,482,381,127,254,110,0.367892976588629,2255,13.3481152993348
"949",2020,"Arkansas",17,4,23.5,285,787,419,288,0,411,5,389,231,620,243,309,705,239,466,491,189,302,92,0.32280701754386,2297,10.5790161079669
"950",2020,"Fordham",17,4,23.5,293,746,215,159,0,463,1,271,247,518,197,348,729,241,488,470,156,314,90,0.307167235494881,2116,9.31001890359168
"951",2020,"Loyola Maryland",17,4,23.5,294,641,273,171,0,451,0,307,341,648,254,424,516,155,361,335,95,240,94,0.319727891156463,1983,12.8088754412506
"952",2020,"New Mexico State",34,8,23.5,389,788,281,183,0,498,5,306,275,581,232,450,907,315,592,279,90,189,121,0.311053984575835,2405,9.64656964656965
"953",2016,"Alabama",13,3,23.1,352,754,420,271,0,516,1,234,106,340,287,490,842,296,546,531,144,387,91,0.258522727272727,2367,12.1250528094635
"954",2016,"West Virginia",13,3,23.1,452,953,463,293,0,624,1,403,206,609,270,567,742,270,472,660,212,448,135,0.298672566371681,2985,9.04522613065327
"955",2017,"Oklahoma State",13,3,23.1,414,883,455,292,0,546,0,357,275,632,199,491,792,273,519,457,141,316,143,0.345410628019324,2663,7.47277506571536
"956",2018,"Louisiana Tech",13,3,23.1,70,104,62,42,0,102,0,46,54,100,44,109,96,32,64,91,23,68,20,0.285714285714286,398,11.0552763819095
"957",2018,"Marquette",13,3,23.1,155,303,160,104,0,225,0,189,124,313,115,151,230,82,148,276,89,187,48,0.309677419354839,1012,11.3636363636364
"958",2019,"Iowa State",13,3,23.1,350,933,366,264,0,490,4,394,148,542,221,420,616,217,399,833,282,551,123,0.351428571428571,2681,8.2431928384931
"959",2020,"Alcorn State",13,3,23.1,497,605,371,220,0,600,0,340,327,667,390,588,891,230,661,254,77,177,157,0.3158953722334,2421,16.1090458488228
"960",2020,"Siena",13,3,23.1,330,733,325,194,0,533,2,316,353,669,263,546,706,212,494,304,87,217,99,0.3,2287,11.4997813729777
"961",2020,"Xavier",26,6,23.1,430,692,353,213,0,509,3,296,296,592,213,463,717,180,537,350,120,230,126,0.293023255813953,2266,9.39982347749338
"962",2020,"Buffalo",22,5,22.7,518,782,352,228,0,531,3,375,299,674,250,468,779,247,532,425,125,300,177,0.341698841698842,2592,9.64506172839506
"963",2020,"Cincinnati",22,5,22.7,374,663,335,223,0,440,1,430,317,747,222,375,736,253,483,198,64,134,136,0.363636363636364,2245,9.88864142538976
"964",2020,"Georgia Tech",22,5,22.7,439,726,331,205,0,432,0,323,246,569,211,399,817,260,557,310,96,214,139,0.316628701594533,2325,9.0752688172043
"965",2020,"Manhattan",22,5,22.7,385,698,248,157,1,429,0,307,291,598,251,405,767,237,530,360,114,246,103,0.267532467532468,2200,11.4090909090909
"966",2016,"Albany",9,2,22.2,68,184,109,69,0,138,1,79,47,126,78,109,195,75,120,59,20,39,22,0.323529411764706,562,13.8790035587189
"967",2016,"Auburn",18,4,22.2,383,624,339,197,0,548,2,331,213,544,332,523,664,221,443,448,123,325,123,0.321148825065274,2291,14.4914884329987
"968",2016,"Colorado State",9,2,22.2,78,234,80,56,0,132,0,82,52,134,59,106,217,78,139,135,48,87,18,0.230769230769231,650,9.07692307692308
"969",2017,"Drake",9,2,22.2,136,323,178,114,0,233,1,149,80,229,122,187,237,101,136,264,99,165,40,0.294117647058824,1047,11.6523400191022
"970",2017,"Eastern Washington",9,2,22.2,57,137,46,29,0,79,0,51,35,86,34,73,113,33,80,112,36,76,20,0.350877192982456,399,8.52130325814536
"971",2017,"Iowa State",18,4,22.2,372,810,354,262,0,497,0,285,104,389,190,365,785,249,536,701,240,461,101,0.271505376344086,2404,7.90349417637271
"972",2017,"Ohio State",9,2,22.2,455,903,481,315,0,522,3,423,276,699,243,408,707,278,429,662,231,431,135,0.296703296703297,2817,8.62619808306709
"973",2018,"Georgia Tech",18,4,22.2,501,730,455,276,0,582,4,384,330,714,330,469,741,259,482,386,120,266,154,0.307385229540918,2578,12.8006206361521
"974",2018,"Purdue",18,4,22.2,354,772,335,233,0,382,2,319,173,492,221,463,672,225,447,441,160,281,99,0.279661016949153,2391,9.24299456294438
"975",2018,"Weber State",9,2,22.2,44,123,45,29,0,80,0,48,44,92,18,57,81,30,51,147,61,86,17,0.386363636363636,371,4.85175202156334
"976",2019,"Ole Miss",9,2,22.2,314,762,299,197,0,585,1,207,110,317,181,511,842,276,566,524,164,360,97,0.308917197452229,2298,7.87641427328111
"977",2020,"Fairleigh Dickinson",18,4,22.2,322,707,210,139,0,469,0,257,242,499,145,441,637,206,431,362,118,244,104,0.322981366459627,2100,6.9047619047619
"978",2020,"George Washington",18,4,22.2,299,692,290,174,0,411,0,274,252,526,176,454,687,233,454,302,97,205,83,0.277591973244147,2116,8.31758034026465
"979",2020,"Omaha",18,4,22.2,313,721,266,171,0,486,0,312,277,589,179,492,602,195,407,367,107,260,97,0.309904153354633,2215,8.08126410835214
"980",2020,"Rice",9,2,22.2,332,760,363,253,0,398,1,387,216,603,178,475,529,178,351,286,80,206,103,0.310240963855422,2295,7.75599128540305
"981",2020,"Texas Southern",9,2,22.2,383,618,381,218,0,528,2,396,316,712,313,470,543,168,375,306,94,212,105,0.274151436031332,2203,14.2078983204721
"982",2020,"Ohio State",23,5,21.7,384,843,350,222,0,510,4,439,276,715,275,475,774,256,518,410,127,283,122,0.317708333333333,2603,10.5647330003842
"983",2020,"Samford",23,5,21.7,344,701,300,199,0,450,1,342,250,592,195,413,723,238,485,371,122,249,116,0.337209302325581,2244,8.68983957219251
"984",2016,"Miami",14,3,21.4,458,850,396,238,0,585,1,419,263,682,321,514,738,253,485,644,217,427,140,0.305676855895196,2796,11.480686695279
"985",2016,"Oklahoma State",14,3,21.4,431,855,412,243,0,522,1,356,252,608,250,477,841,311,530,401,112,289,147,0.341067285382831,2639,9.4732853353543
"986",2016,"Pittsburgh",14,3,21.4,369,707,352,215,0,502,2,335,278,613,234,547,589,171,418,491,155,336,95,0.257452574525745,2371,9.8692534795445
"987",2017,"Kansas State",14,3,21.4,386,811,480,308,0,469,1,382,309,691,263,474,582,196,386,551,184,367,115,0.297927461139896,2556,10.2895148669797
"988",2017,"Michigan",14,3,21.4,449,952,439,293,0,559,0,597,409,1006,292,525,546,177,369,733,280,453,157,0.349665924276169,3087,9.45902170391966
"989",2018,"California",14,3,21.4,360,748,342,215,0,408,1,337,190,527,168,389,620,231,389,416,140,276,109,0.302777777777778,2294,7.32345248474281
"990",2018,"Duke",14,3,21.4,311,718,322,204,0,375,0,337,194,531,277,405,495,175,320,422,169,253,99,0.318327974276527,2204,12.568058076225
"991",2020,"Merrimack",14,3,21.4,298,862,305,200,0,340,1,331,332,663,227,435,589,176,413,475,174,301,98,0.328859060402685,2342,9.69257045260461
"992",2016,"Vanderbilt",19,4,21.1,322,662,341,225,0,561,2,330,163,493,213,548,548,186,362,432,157,275,84,0.260869565217391,2291,9.29725010912265
"993",2020,"Central Connecticut",19,4,21.1,334,653,317,211,0,499,1,266,296,562,203,504,676,216,460,309,84,225,91,0.272455089820359,2130,9.53051643192488
"994",2020,"Georgia State",19,4,21.1,343,609,301,184,0,409,2,226,196,422,184,412,746,233,513,275,66,209,107,0.311953352769679,1958,9.3973442288049
"995",2020,"UT Rio Grande Valley",19,4,21.1,403,732,374,232,0,481,4,361,320,681,253,451,725,229,496,377,117,260,122,0.30272952853598,2380,10.6302521008403
"996",2017,"Iowa",24,5,20.8,368,966,476,325,0,532,2,589,133,722,231,558,671,168,503,629,196,433,123,0.334239130434783,2976,7.76209677419355
"997",2020,"UNLV",29,6,20.7,465,704,339,220,0,518,5,317,332,649,241,478,759,234,525,278,73,205,131,0.281720430107527,2353,10.2422439439014
"998",2015,"Purdue",5,1,20,349,744,393,255,0,474,2,278,168,446,207,445,843,272,571,355,88,267,89,0.255014326647564,2248,9.20818505338078
"999",2016,"Ball State",5,1,20,55,137,60,41,0,98,0,47,30,77,24,78,129,44,85,88,27,61,13,0.236363636363636,399,6.01503759398496
"1000",2016,"East Carolina",5,1,20,103,187,70,52,0,137,1,78,68,146,60,157,199,61,138,137,33,104,27,0.262135922330097,637,9.41915227629513
"1001",2016,"Fordham",5,1,20,47,140,42,26,0,101,0,48,49,97,24,102,106,38,68,125,42,83,12,0.25531914893617,426,5.63380281690141
"1002",2016,"Lamar",10,2,20,77,102,100,71,0,107,0,58,72,130,59,80,119,24,95,88,24,64,16,0.207792207792208,394,14.9746192893401
"1003",2016,"Middle Tennessee",5,1,20,66,143,96,60,0,113,0,67,41,108,54,100,98,25,73,112,37,75,18,0.272727272727273,458,11.7903930131004
"1004",2016,"Ole Miss",15,3,20,525,602,387,223,0,640,7,303,342,645,316,446,649,188,461,676,187,489,125,0.238095238095238,2340,13.5042735042735
"1005",2016,"Prairie View A&M",5,1,20,52,76,30,17,0,66,2,29,29,58,32,81,109,37,72,59,12,47,12,0.230769230769231,290,11.0344827586207
"1006",2017,"Cal State Bakersfield",5,1,20,43,75,16,10,0,68,0,28,22,50,23,69,73,22,51,112,37,75,10,0.232558139534884,280,8.21428571428571
"1007",2017,"Northern Iowa",10,2,20,119,192,83,54,0,122,0,30,31,61,47,110,208,74,134,225,72,153,32,0.26890756302521,613,7.66721044045677
"1008",2017,"Rice",5,1,20,91,212,111,71,0,143,0,103,46,149,47,127,132,44,88,163,49,114,30,0.32967032967033,650,7.23076923076923
"1009",2017,"San Diego",5,1,20,52,101,61,41,0,87,1,63,57,120,36,67,65,21,44,63,13,50,13,0.25,328,10.9756097560976
"1010",2017,"UNC Asheville",5,1,20,67,123,65,40,0,80,0,48,61,109,23,65,78,25,53,69,22,47,10,0.149253731343284,366,6.28415300546448
"1011",2018,"DePaul",10,2,20,97,201,75,51,0,143,0,121,81,202,67,89,69,21,48,259,93,166,35,0.360824742268041,646,10.3715170278638
"1012",2018,"Maryland",10,2,20,420,719,402,265,0,384,1,338,238,576,267,355,635,242,393,398,156,242,125,0.297619047619048,2334,11.439588688946
"1013",2018,"Notre Dame",5,1,20,297,608,312,211,0,238,0,345,202,547,163,298,427,164,263,258,90,168,107,0.36026936026936,1871,8.71191876002138
"1014",2018,"Pittsburgh",10,2,20,279,715,259,160,0,469,0,245,211,456,264,456,606,223,383,542,173,369,64,0.229390681003584,2163,12.2052704576976
"1015",2018,"SMU",5,1,20,114,188,78,56,0,135,0,43,52,95,39,99,201,55,146,80,28,52,28,0.245614035087719,542,7.19557195571956
"1016",2018,"Texas State",5,1,20,67,117,61,44,0,86,1,61,48,109,43,57,99,32,67,153,47,106,17,0.253731343283582,397,10.831234256927
"1017",2019,"Arizona",20,4,20,380,905,403,261,0,604,1,456,281,737,290,453,617,206,411,691,228,463,124,0.326315789473684,2731,10.6188209447089
"1018",2019,"Drexel",5,1,20,38,92,44,31,0,62,0,44,28,72,22,49,66,25,41,73,20,53,13,0.342105263157895,278,7.9136690647482
"1019",2019,"Furman",5,1,20,80,167,65,50,0,107,0,62,67,129,32,114,128,40,88,134,40,94,24,0.3,524,6.10687022900763
"1020",2019,"Idaho State",5,1,20,54,109,50,32,0,107,0,46,37,83,32,104,99,31,68,96,26,70,14,0.259259259259259,385,8.31168831168831
"1021",2019,"Marquette",10,2,20,411,862,399,267,0,432,1,474,337,811,286,383,461,172,289,671,255,416,133,0.32360097323601,2657,10.7640195709447
"1022",2019,"Northeastern",5,1,20,62,95,61,40,1,62,1,47,40,87,24,60,60,19,41,91,34,57,24,0.387096774193548,335,7.16417910447761
"1023",2019,"South Carolina",20,4,20,362,674,416,280,0,434,3,322,208,530,218,365,632,233,399,465,149,316,95,0.262430939226519,2220,9.81981981981982
"1024",2019,"Wyoming",5,1,20,40,180,87,62,0,86,0,65,43,108,32,68,161,59,102,89,32,57,12,0.3,467,6.85224839400428
"1025",2020,"Bradley",5,1,20,322,851,401,265,0,461,1,321,206,527,193,444,724,251,473,409,143,266,96,0.298136645962733,2430,7.94238683127572
"1026",2020,"Dartmouth",5,1,20,271,518,156,98,0,346,0,176,180,356,165,378,622,220,402,274,88,186,80,0.29520295202952,1687,9.78067575577949
"1027",2020,"Florida State",15,3,20,399,754,358,228,0,446,0,376,176,552,172,367,784,270,514,348,118,230,151,0.37844611528822,2377,7.23601177955406
"1028",2020,"Howard",5,1,20,459,722,440,271,0,536,5,308,322,630,237,565,700,211,489,309,105,204,140,0.305010893246187,2478,9.56416464891041
"1029",2020,"Little Rock",5,1,20,297,611,311,197,0,465,3,235,164,399,177,374,840,265,575,161,45,116,98,0.32996632996633,1911,9.26216640502355
"1030",2020,"Long Beach State",20,4,20,395,621,331,201,0,499,2,276,221,497,323,431,899,262,637,357,99,258,118,0.29873417721519,2170,14.8847926267281
"1031",2020,"Pennsylvania",5,1,20,250,489,191,118,0,266,0,230,183,413,166,228,410,138,272,328,111,217,106,0.424,1494,11.1111111111111
"1032",2020,"South Carolina Upstate",10,2,20,376,752,295,193,0,421,1,209,278,487,164,521,839,271,568,262,55,207,104,0.276595744680851,2244,7.30837789661319
"1033",2020,"Weber State",5,1,20,307,707,378,244,0,500,2,305,287,592,177,613,639,183,456,250,81,169,103,0.335504885993485,2285,7.74617067833698
"1034",2020,"William & Mary",5,1,20,196,445,226,167,0,331,0,256,190,446,146,288,295,110,185,291,95,196,61,0.311224489795918,1451,10.0620261888353
"1035",2016,"NC State",21,4,19,397,778,446,293,0,515,3,355,277,632,220,448,424,112,312,698,213,485,93,0.234256926952141,2410,9.12863070539419
"1036",2020,"Houston",21,4,19,497,666,396,224,0,482,3,389,341,730,247,524,675,193,482,371,97,274,168,0.338028169014085,2463,10.0284206252538
"1037",2020,"Kansas City",21,4,19,364,736,269,172,0,388,2,300,271,571,214,392,686,226,460,393,120,273,99,0.271978021978022,2194,9.7538742023701
"1038",2016,"Michigan",16,3,18.8,435,797,345,232,0,541,0,511,380,891,248,510,613,255,358,577,225,352,156,0.358620689655172,2807,8.83505521909512
"1039",2018,"Iowa State",32,6,18.8,337,820,332,228,0,473,2,212,69,281,183,370,682,199,483,730,239,491,90,0.267062314540059,2245,8.15144766146993
"1040",2018,"Oregon State",16,3,18.8,342,891,244,157,0,329,4,384,203,587,120,383,421,156,265,568,230,338,114,0.333333333333333,2445,4.9079754601227
"1041",2020,"Drake",16,3,18.8,359,824,423,302,0,493,1,471,240,711,267,518,612,232,380,433,140,293,116,0.323119777158774,2650,10.0754716981132
"1042",2020,"San Francisco",16,3,18.8,435,693,314,205,1,400,3,349,398,747,172,434,569,180,389,297,95,202,136,0.31264367816092,2245,7.66146993318486
"1043",2020,"Temple",27,5,18.5,470,825,358,238,0,532,1,362,298,660,136,452,724,223,501,467,151,316,144,0.306382978723404,2585,5.26112185686654
"1044",2017,"Green Bay",11,2,18.2,110,210,94,61,0,153,2,116,79,195,84,131,129,45,84,206,74,132,34,0.309090909090909,714,11.7647058823529
"1045",2017,"Marshall",11,2,18.2,58,104,59,38,0,72,0,34,25,59,30,60,95,27,68,101,25,76,14,0.241379310344828,320,9.375
"1046",2017,"Utah",11,2,18.2,397,875,393,250,0,518,5,415,355,770,257,515,551,167,384,556,149,407,110,0.277078085642317,2603,9.87322320399539
"1047",2018,"Wright State",11,2,18.2,87,160,76,53,0,118,0,57,34,91,56,90,193,51,142,136,51,85,20,0.229885057471264,506,11.0671936758893
"1048",2019,"Green Bay",11,2,18.2,73,227,84,49,0,141,0,73,58,131,55,97,149,47,102,138,48,90,16,0.219178082191781,580,9.48275862068965
"1049",2019,"Stanford",11,2,18.2,363,817,309,203,0,414,0,415,265,680,200,375,345,114,231,709,252,457,136,0.37465564738292,2427,8.24062628759786
"1050",2020,"Delaware State",11,2,18.2,234,431,269,172,0,333,3,180,191,371,143,294,491,140,351,214,59,155,61,0.260683760683761,1410,10.1418439716312
"1051",2020,"St. Francis Brooklyn",11,2,18.2,280,717,386,263,0,386,1,341,380,721,208,470,595,191,404,351,110,241,78,0.278571428571429,2200,9.45454545454546
"1052",2020,"St. John's",33,6,18.2,315,730,355,251,0,466,6,402,336,738,229,378,678,227,451,375,144,231,96,0.304761904761905,2281,10.0394563787812
"1053",2020,"UNC Greensboro",11,2,18.2,261,587,256,183,0,321,1,257,220,477,152,354,576,188,388,198,64,134,75,0.28735632183908,1779,8.54412591343451
"1054",2020,"Virginia Tech",22,4,18.2,372,861,346,223,0,509,2,382,244,626,168,465,723,232,491,440,158,282,111,0.298387096774194,2557,6.57019945248338
"1055",2020,"Yale",11,2,18.2,253,689,333,207,0,370,0,365,276,641,202,364,588,187,401,238,81,157,89,0.351778656126482,2015,10.0248138957816
"1056",2017,"NC State",17,3,17.6,352,773,417,268,0,505,3,366,261,627,222,391,389,115,274,671,229,442,99,0.28125,2320,9.56896551724138
"1057",2020,"Eastern Washington",17,3,17.6,308,646,215,126,0,409,1,220,254,474,191,410,725,238,487,396,129,267,93,0.301948051948052,1994,9.57873620862588
"1058",2020,"Nicholls",17,3,17.6,380,647,432,290,0,480,0,380,325,705,307,522,566,189,377,227,52,175,131,0.344736842105263,2262,13.5720601237843
"1059",2019,"Penn State",23,4,17.4,341,727,414,279,0,543,3,339,331,670,232,413,599,209,390,560,167,393,89,0.26099706744868,2292,10.1221640488656
"1060",2019,"Texas A&M",23,4,17.4,387,861,492,320,0,458,5,377,252,629,184,447,738,259,479,328,101,227,104,0.268733850129199,2553,7.20720720720721
"1061",2020,"Marshall",23,4,17.4,336,773,360,227,0,486,1,298,284,582,230,410,622,186,436,385,116,269,82,0.244047619047619,2197,10.4688211197087
"1062",2017,"Washington State",29,5,17.2,495,820,434,241,0,623,3,371,360,731,336,523,795,267,528,624,188,436,133,0.268686868686869,2763,12.1606948968512
"1063",2016,"Buffalo",6,1,16.7,98,165,72,49,0,109,1,69,70,139,40,84,128,39,89,122,44,78,31,0.316326530612245,519,7.70712909441233
"1064",2016,"Clemson",6,1,16.7,349,619,341,200,0,580,3,298,368,666,228,507,556,167,389,381,95,286,82,0.234957020057307,2120,10.7547169811321
"1065",2016,"Dayton",6,1,16.7,81,154,82,57,0,133,0,54,36,90,48,105,128,41,87,145,49,96,16,0.197530864197531,505,9.5049504950495
"1066",2016,"Duquesne",6,1,16.7,96,204,85,63,0,118,0,77,54,131,46,107,190,53,137,174,61,113,28,0.291666666666667,624,7.37179487179487
"1067",2016,"Notre Dame",6,1,16.7,365,911,475,313,0,534,2,547,316,863,296,485,614,231,383,471,189,282,117,0.320547945205479,2845,10.4042179261863
"1068",2016,"South Dakota",12,2,16.7,159,348,140,93,0,208,1,94,75,169,92,162,297,106,191,274,113,161,38,0.238993710691824,1015,9.064039408867
"1069",2016,"Tulane",6,1,16.7,156,340,155,103,0,264,0,138,111,249,96,245,333,106,227,246,77,169,40,0.256410256410256,1100,8.72727272727273
"1070",2016,"UNC Asheville",6,1,16.7,67,107,56,35,0,65,1,19,25,44,25,59,107,25,82,96,25,71,16,0.238805970149254,315,7.93650793650794
"1071",2017,"Tulsa",6,1,16.7,70,155,51,34,0,120,1,56,58,114,34,92,133,47,86,128,39,89,22,0.314285714285714,469,7.24946695095949
"1072",2018,"Chattanooga",6,1,16.7,56,126,42,25,0,70,0,50,37,87,36,72,114,35,79,93,27,66,13,0.232142857142857,374,9.62566844919786
"1073",2018,"Navy",6,1,16.7,41,95,43,27,0,58,0,39,37,76,45,42,88,30,58,82,21,61,15,0.365853658536585,285,15.7894736842105
"1074",2018,"Providence",6,1,16.7,20,106,37,23,0,61,0,34,34,68,18,58,66,27,39,74,27,47,7,0.35,284,6.33802816901408
"1075",2019,"Kansas State",6,1,16.7,318,740,399,264,0,437,2,295,211,506,247,455,628,230,398,566,176,390,97,0.30503144654088,2313,10.6787721573714
"1076",2019,"New Mexico State",6,1,16.7,48,75,42,29,0,51,0,38,33,71,43,31,91,35,56,57,22,35,18,0.375,261,16.4750957854406
"1077",2019,"Sam Houston",6,1,16.7,49,60,40,21,0,79,0,37,28,65,26,69,55,17,38,51,16,35,7,0.142857142857143,260,10
"1078",2019,"South Florida",12,2,16.7,151,276,128,85,0,184,0,110,118,228,59,178,206,66,140,192,77,115,45,0.298013245033113,883,6.68176670441676
"1079",2019,"St. John's",6,1,16.7,83,189,76,51,0,133,0,105,81,186,45,105,136,44,92,141,47,94,26,0.313253012048193,595,7.56302521008403
"1080",2019,"Villanova",6,1,16.7,45,163,32,21,0,114,0,70,46,116,25,78,99,35,64,191,67,124,14,0.311111111111111,467,5.35331905781585
"1081",2020,"Eastern Illinois",18,3,16.7,328,808,370,249,0,544,0,355,319,674,331,480,729,247,482,391,125,266,99,0.301829268292683,2439,13.5711357113571
"1082",2020,"Sacred Heart",6,1,16.7,284,662,323,214,0,415,3,264,325,589,165,422,569,167,402,337,102,235,80,0.28169014084507,1974,8.35866261398176
"1083",2020,"Sam Houston",12,2,16.7,416,703,439,277,0,643,3,362,292,654,329,527,709,245,464,339,119,220,159,0.382211538461538,2467,13.3360356708553
"1084",2016,"Tennessee",25,4,16,540,944,444,291,0,606,2,407,258,665,300,578,996,342,654,516,131,385,153,0.283333333333333,3065,9.78792822185971
"1085",2020,"Florida Atlantic",25,4,16,390,774,433,283,0,633,2,300,245,545,236,591,732,239,493,464,134,330,119,0.305128205128205,2527,9.33913731697665
"1086",2018,"UCLA",13,2,15.4,467,730,353,232,0,468,1,372,283,655,271,333,656,229,427,465,159,306,123,0.26338329764454,2380,11.3865546218487
"1087",2019,"Houston",13,2,15.4,132,174,105,62,0,167,1,87,57,144,80,148,154,45,109,206,54,152,42,0.318181818181818,667,11.9940029985007
"1088",2020,"Tennessee Tech",13,2,15.4,401,744,391,254,0,432,0,294,302,596,178,421,653,240,413,431,152,279,129,0.321695760598504,2354,7.56159728122345
"1089",2020,"Western Carolina",13,2,15.4,168,421,92,56,0,303,0,182,146,328,97,315,410,139,271,217,64,153,52,0.30952380952381,1310,7.40458015267176
"1090",2020,"New Orleans",20,3,15,391,682,420,259,0,539,2,301,306,607,279,515,749,242,507,283,77,206,130,0.332480818414322,2299,12.1357111787734
"1091",2016,"Illinois",14,2,14.3,309,714,275,178,0,486,0,252,114,366,198,374,783,258,525,651,207,444,92,0.297734627831715,2188,9.04936014625229
"1092",2017,"George Washington",7,1,14.3,84,119,41,26,0,62,1,42,29,71,30,70,127,26,101,77,24,53,29,0.345238095238095,374,8.02139037433155
"1093",2017,"Texas State",7,1,14.3,28,68,17,9,0,54,0,22,10,32,18,58,89,22,67,51,17,34,3,0.107142857142857,222,8.10810810810811
"1094",2017,"Washington",7,1,14.3,330,977,453,315,0,424,4,405,225,630,206,341,485,199,286,814,312,502,116,0.351515151515152,2667,7.72403449568804
"1095",2019,"South Dakota State",7,1,14.3,70,202,92,67,0,108,0,87,77,164,48,74,87,34,53,162,63,99,29,0.414285714285714,552,8.69565217391304
"1096",2019,"Southern Miss",7,1,14.3,53,93,60,38,0,89,0,30,26,56,44,82,122,44,78,45,10,35,14,0.264150943396226,327,13.4556574923547
"1097",2020,"Detroit Mercy",7,1,14.3,266,652,326,189,0,497,2,271,229,500,145,498,654,200,454,339,91,248,79,0.296992481203008,2055,7.05596107055961
"1098",2020,"Furman",7,1,14.3,190,352,204,124,0,256,0,206,147,353,76,264,274,75,199,183,64,119,64,0.336842105263158,1198,6.34390651085142
"1099",2020,"Gardner-Webb",21,3,14.3,374,679,371,253,0,536,2,261,230,491,296,449,827,221,606,408,130,278,80,0.213903743315508,2206,13.4179510426111
"1100",2020,"North Carolina A&T",7,1,14.3,244,415,209,122,0,303,2,170,162,332,120,332,302,87,215,230,68,162,75,0.307377049180328,1367,8.77834674469642
"1101",2020,"Quinnipiac",14,2,14.3,446,730,423,266,0,465,0,362,373,735,219,407,669,197,472,325,101,224,140,0.31390134529148,2354,9.30331350892098
"1102",2017,"LSU",29,4,13.8,399,607,476,295,0,545,0,301,175,476,372,435,1097,389,708,144,36,108,108,0.270676691729323,2289,16.2516382699869
"1103",2020,"IUPUI",22,3,13.6,404,784,338,221,1,406,0,372,235,607,230,416,676,256,420,417,152,265,144,0.356435643564356,2466,9.32684509326845
"1104",2020,"Jacksonville State",22,3,13.6,357,744,313,195,0,440,3,278,263,541,164,357,702,202,500,391,103,288,108,0.302521008403361,2108,7.77988614800759
"1105",2019,"Washington State",15,2,13.3,270,640,226,148,0,373,5,336,274,610,178,353,463,171,292,537,192,345,97,0.359259259259259,2025,8.79012345679012
"1106",2020,"Portland State",15,2,13.3,337,789,340,247,0,421,0,261,173,434,235,414,937,324,613,359,130,229,138,0.409495548961424,2349,10.0042571306939
"1107",2020,"Texas",15,2,13.3,418,775,364,237,0,484,1,390,264,654,231,449,758,217,541,318,104,214,141,0.337320574162679,2451,9.42472460220318
"1108",2016,"UT Martin",8,1,12.5,53,177,63,48,0,130,0,74,25,99,57,110,139,50,89,215,79,136,19,0.358490566037736,568,10.0352112676056
"1109",2017,"Syracuse",8,1,12.5,531,700,431,298,0,499,10,437,306,743,344,416,463,128,335,893,265,628,149,0.28060263653484,2594,13.2613723978412
"1110",2017,"Wright State",8,1,12.5,78,118,71,44,0,74,0,48,46,94,35,54,139,43,96,99,29,70,17,0.217948717948718,385,9.09090909090909
"1111",2018,"Harvard",8,1,12.5,34,75,21,14,0,62,0,17,28,45,21,48,49,15,34,70,21,49,9,0.264705882352941,216,9.72222222222222
"1112",2018,"North Texas",8,1,12.5,57,144,70,48,0,128,1,65,47,112,47,91,117,42,75,91,30,61,13,0.228070175438596,450,10.4444444444444
"1113",2018,"Saint Louis",8,1,12.5,101,260,99,67,0,194,0,102,87,189,42,124,217,70,147,214,68,146,20,0.198019801980198,751,5.59254327563249
"1114",2018,"Seattle U",8,1,12.5,47,124,47,33,0,59,0,57,33,90,27,70,67,20,47,73,29,44,13,0.276595744680851,356,7.58426966292135
"1115",2019,"TCU",16,2,12.5,445,832,521,314,0,551,3,458,329,787,314,506,495,149,346,655,197,458,135,0.303370786516854,2711,11.5824419033567
"1116",2020,"UT Arlington",8,1,12.5,330,765,353,210,0,526,4,386,272,658,250,449,677,229,448,288,77,211,108,0.327272727272727,2327,10.7434464976364
"1117",2020,"Western Kentucky",16,2,12.5,452,599,410,255,0,420,2,397,252,649,270,359,683,214,469,298,87,211,152,0.336283185840708,2211,12.2116689280868
"1118",2020,"Auburn",25,3,12,430,656,376,242,0,487,3,302,206,508,319,521,855,298,557,419,122,297,148,0.344186046511628,2414,13.2145816072908
"1119",2016,"Virginia",9,1,11.1,406,716,340,238,0,557,0,321,318,639,265,495,736,266,470,499,170,329,122,0.300492610837438,2453,10.8030982470444
"1120",2017,"Canisius",9,1,11.1,29,80,18,13,0,46,0,35,42,77,15,50,30,12,18,72,26,46,3,0.103448275862069,234,6.41025641025641
"1121",2018,"Nevada",9,1,11.1,105,202,125,91,0,135,1,86,63,149,56,119,277,93,184,97,42,55,37,0.352380952380952,687,8.15138282387191
"1122",2020,"Missouri State",9,1,11.1,415,806,457,320,0,521,1,238,141,379,266,431,1186,472,714,285,109,176,153,0.368674698795181,2574,10.3341103341103
"1123",2020,"Norfolk State",27,3,11.1,382,700,429,256,0,463,7,415,391,806,339,463,641,213,428,276,76,200,121,0.316753926701571,2355,14.3949044585987
"1124",2020,"Radford",9,1,11.1,315,764,386,237,0,429,1,291,259,550,143,435,630,189,441,287,82,205,86,0.273015873015873,2168,6.59594095940959
"1125",2017,"Louisville",19,2,10.5,450,822,368,236,0,522,5,379,194,573,248,425,783,285,498,558,185,373,145,0.322222222222222,2634,9.41533788914199
"1126",2020,"Vanderbilt",19,2,10.5,440,786,365,224,0,555,2,417,307,724,277,564,895,302,593,176,52,124,153,0.347727272727273,2664,10.3978978978979
"1127",2018,"Auburn",10,1,10,367,496,308,196,0,460,0,297,202,499,348,393,573,182,391,359,97,262,93,0.253405994550409,1897,18.3447548761202
"1128",2020,"Charleston Southern",20,2,10,299,744,295,189,0,465,2,248,197,445,214,486,807,237,570,312,83,229,95,0.317725752508361,2172,9.85267034990792
"1129",2020,"Louisville",10,1,10,352,684,259,181,1,382,2,319,185,504,191,353,702,276,426,343,119,224,126,0.357954545454545,2175,8.7816091954023
"1130",2020,"St. Bonaventure",20,2,10,252,717,229,159,0,470,1,282,235,517,166,392,721,228,493,379,121,258,89,0.353174603174603,2045,8.11735941320293
"1131",2017,"Middle Tennessee",11,1,9.1,95,218,104,73,0,208,1,92,69,161,59,156,185,53,132,198,62,136,19,0.2,704,8.38068181818182
"1132",2020,"UCF",13,1,7.7,393,603,342,231,0,397,7,284,246,530,250,409,685,243,442,243,81,162,139,0.353689567430025,2091,11.9560019129603
"1133",2016,"George Washington",14,1,7.1,197,325,134,87,0,160,0,135,106,241,58,182,303,96,207,140,38,102,62,0.314720812182741,1007,5.759682224429
"1134",2016,"Wake Forest",14,1,7.1,427,772,468,277,0,589,2,372,329,701,237,607,525,151,374,475,139,336,99,0.231850117096019,2567,9.23256719906506
"1135",2017,"Purdue",14,1,7.1,374,784,375,241,0,427,2,410,198,608,242,418,724,219,505,440,146,294,117,0.31283422459893,2430,9.95884773662551
"1136",2020,"Georgia Southern",14,1,7.1,462,727,359,239,0,556,0,337,312,649,215,527,725,226,499,367,99,268,150,0.324675324675325,2479,8.67285195643404
"1137",2016,"Georgia Tech",15,1,6.7,478,742,426,290,0,601,1,374,259,633,306,472,713,223,490,575,182,393,133,0.278242677824268,2568,11.9158878504673
"1138",2016,"Michigan State",15,1,6.7,463,915,434,305,0,639,4,460,344,804,269,544,610,227,383,566,175,391,137,0.295896328293737,2877,9.35001737921446
"1139",2018,"Arizona",17,1,5.9,299,658,293,206,0,423,2,237,244,481,192,371,566,169,397,559,172,387,70,0.234113712374582,1975,9.72151898734177
"1140",2020,"Albany",18,1,5.6,318,681,253,156,0,447,0,227,231,458,149,482,667,215,452,299,95,204,97,0.30503144654088,2071,7.19459198454853
"1141",2020,"SMU",20,1,5,522,729,326,200,0,465,2,296,291,587,263,510,924,293,631,225,54,171,153,0.293103448275862,2480,10.6048387096774
"1142",2020,"Drexel",23,1,4.3,371,563,276,186,0,381,0,269,216,485,269,344,768,260,508,277,85,192,122,0.328840970350404,1963,13.7035150280183
"1143",2015,"Arizona State",1,0,0,459,811,467,297,0,532,3,406,334,740,287,502,755,290,465,463,167,296,135,0.294117647058824,2715,10.5709023941068
"1144",2015,"Colorado",2,0,0,366,831,374,253,0,588,4,291,240,531,136,494,786,290,496,383,146,237,123,0.336065573770492,2502,5.43565147881695
"1145",2015,"DePaul",3,0,0,167,291,162,95,0,205,1,180,142,322,130,161,193,78,115,352,114,238,49,0.293413173652695,1028,12.6459143968872
"1146",2015,"Ohio State",1,0,0,394,988,494,328,0,520,3,470,322,792,260,465,712,260,452,757,258,499,126,0.319796954314721,2935,8.85860306643952
"1147",2015,"Oklahoma",2,0,0,416,848,502,317,0,695,2,394,281,675,250,553,668,249,419,660,230,430,133,0.319711538461538,2802,8.92219842969308
"1148",2015,"Oregon",1,0,0,280,707,278,161,0,387,1,290,226,516,142,386,525,185,340,478,169,309,80,0.285714285714286,2074,6.8466730954677
"1149",2015,"USC",3,0,0,360,570,333,195,0,402,1,333,323,656,197,339,546,184,362,294,81,213,101,0.280555555555556,1940,10.1546391752577
"1150",2016,"Alcorn State",3,0,0,81,136,45,30,0,100,1,46,52,98,35,122,166,41,125,47,11,36,18,0.222222222222222,441,7.93650793650794
"1151",2016,"Arkansas State",7,0,0,81,152,71,44,0,96,0,75,37,112,46,79,180,77,103,114,25,89,27,0.333333333333333,502,9.16334661354582
"1152",2016,"BYU",6,0,0,83,207,116,76,0,166,1,75,56,131,65,130,165,61,104,146,52,94,24,0.289156626506024,638,10.1880877742947
"1153",2016,"Bradley",2,0,0,43,103,60,37,0,71,0,34,24,58,31,72,105,23,82,43,11,32,12,0.27906976744186,302,10.2649006622517
"1154",2016,"Cal Poly",1,0,0,41,85,37,29,0,70,0,36,34,70,34,55,105,38,67,61,10,51,8,0.195121951219512,273,12.4542124542125
"1155",2016,"Central Arkansas",2,0,0,70,91,47,31,0,73,0,32,36,68,16,61,117,36,81,61,21,40,17,0.242857142857143,318,5.0314465408805
"1156",2016,"Charleston",4,0,0,19,81,40,25,0,55,0,21,22,43,10,50,72,23,49,42,14,28,8,0.421052631578947,217,4.60829493087558
"1157",2016,"Coppin State",1,0,0,117,202,115,69,0,163,3,103,98,201,84,183,249,76,173,65,24,41,27,0.230769230769231,737,11.3975576662144
"1158",2016,"Dartmouth",2,0,0,23,47,25,15,0,35,0,10,14,24,19,38,55,22,33,30,8,22,8,0.347826086956522,156,12.1794871794872
"1159",2016,"Drake",8,0,0,66,181,67,43,0,110,0,100,40,140,55,94,88,24,64,158,59,99,18,0.272727272727273,542,10.1476014760148
"1160",2016,"Elon",5,0,0,62,98,69,40,0,99,0,48,47,95,41,71,113,34,79,85,27,58,23,0.370967741935484,356,11.5168539325843
"1161",2016,"Fresno State",3,0,0,92,190,96,61,1,140,3,103,83,186,55,110,143,42,101,131,35,96,30,0.326086956521739,593,9.27487352445194
"1162",2016,"Gonzaga",5,0,0,111,184,118,77,0,129,0,73,77,150,48,117,129,38,91,127,34,93,27,0.243243243243243,587,8.17717206132879
"1163",2016,"Grambling",1,0,0,80,133,69,42,0,129,1,46,21,67,68,121,233,70,163,103,22,81,19,0.2375,488,13.9344262295082
"1164",2016,"Grand Canyon",2,0,0,26,65,28,19,0,59,0,23,31,54,21,46,74,20,54,38,10,28,7,0.269230769230769,198,10.6060606060606
"1165",2016,"Hampton",2,0,0,98,179,80,47,0,177,1,78,90,168,60,111,207,57,150,135,32,103,25,0.255102040816327,576,10.4166666666667
"1166",2016,"Houston Christian",2,0,0,18,41,27,15,0,35,1,21,17,38,4,32,14,5,9,19,8,11,4,0.222222222222222,132,3.03030303030303
"1167",2016,"Illinois State",4,0,0,21,51,16,9,0,27,0,20,16,36,20,57,40,11,29,32,8,24,6,0.285714285714286,170,11.7647058823529
"1168",2016,"Iona",2,0,0,49,80,23,17,0,58,1,30,46,76,31,53,64,14,50,88,29,59,6,0.122448979591837,261,11.8773946360153
"1169",2016,"Louisiana Tech",5,0,0,63,93,68,43,0,80,0,33,46,79,26,80,109,33,76,56,22,34,14,0.222222222222222,339,7.66961651917404
"1170",2016,"Marist",1,0,0,29,92,53,39,0,61,0,37,28,65,16,75,48,8,40,63,25,38,5,0.172413793103448,279,5.73476702508961
"1171",2016,"Missouri State",1,0,0,119,236,126,83,0,144,0,77,71,148,75,122,233,68,165,188,63,125,28,0.235294117647059,712,10.5337078651685
"1172",2016,"Montana",1,0,0,21,51,31,22,0,35,0,22,11,33,10,15,53,18,35,35,9,26,5,0.238095238095238,143,6.99300699300699
"1173",2016,"Morgan State",1,0,0,64,104,46,26,0,75,0,33,61,94,20,60,96,21,75,70,19,51,12,0.1875,312,6.41025641025641
"1174",2016,"Murray State",2,0,0,10,34,11,10,0,28,0,11,5,16,9,29,23,5,18,78,30,48,3,0.3,122,7.37704918032787
"1175",2016,"Oakland",3,0,0,16,50,32,16,0,32,0,25,20,45,18,24,38,13,25,37,9,28,7,0.4375,145,12.4137931034483
"1176",2016,"Oregon State",11,0,0,394,981,323,215,0,437,3,347,255,602,165,483,611,224,387,593,210,383,120,0.304568527918782,2714,6.07958732498158
"1177",2016,"Presbyterian",1,0,0,35,82,46,32,0,85,0,28,35,63,33,76,36,9,27,76,23,53,9,0.257142857142857,257,12.84046692607
"1178",2016,"Rice",3,0,0,43,105,62,37,0,104,0,40,35,75,28,96,79,25,54,103,23,80,7,0.162790697674419,346,8.09248554913295
"1179",2016,"Robert Morris",1,0,0,69,128,62,38,0,107,0,44,31,75,47,108,142,39,103,105,41,64,15,0.217391304347826,443,10.6094808126411
"1180",2016,"Sacred Heart",2,0,0,56,134,56,36,0,83,0,56,56,112,28,83,69,23,46,105,35,70,16,0.285714285714286,400,7
"1181",2016,"Samford",5,0,0,41,148,45,28,0,112,1,40,38,78,33,110,58,16,42,143,51,92,12,0.292682926829268,415,7.95180722891566
"1182",2016,"San Diego State",1,0,0,34,86,44,27,0,56,0,34,24,58,33,52,91,28,63,63,18,45,10,0.294117647058824,266,12.406015037594
"1183",2016,"Santa Clara",1,0,0,66,85,70,46,0,84,0,45,54,99,39,67,79,25,54,58,12,46,12,0.181818181818182,315,12.3809523809524
"1184",2016,"Savannah State",2,0,0,61,130,59,29,0,116,0,34,59,93,37,158,104,22,82,86,26,60,14,0.229508196721311,445,8.31460674157303
"1185",2016,"Siena",2,0,0,16,31,19,14,0,33,0,13,14,27,10,28,20,6,14,16,6,10,6,0.375,105,9.52380952380952
"1186",2016,"South Carolina State",2,0,0,61,79,56,36,0,76,0,37,43,80,27,50,89,25,64,67,18,49,15,0.245901639344262,282,9.57446808510638
"1187",2016,"Southern Miss",4,0,0,63,119,56,35,0,96,0,37,47,84,35,104,130,37,93,62,19,43,13,0.206349206349206,396,8.83838383838384
"1188",2016,"Stony Brook",4,0,0,51,135,75,47,0,68,0,56,45,101,21,88,74,29,45,66,12,54,13,0.254901960784314,388,5.41237113402062
"1189",2016,"UAB",3,0,0,43,102,50,31,0,64,0,31,29,60,26,67,81,28,53,79,25,54,16,0.372093023255814,309,8.41423948220065
"1190",2016,"UC Riverside",1,0,0,48,117,55,36,0,93,0,52,37,89,56,87,182,65,117,98,30,68,12,0.25,411,13.625304136253
"1191",2016,"UL Monroe",2,0,0,18,36,27,15,0,43,0,11,14,25,15,53,30,9,21,33,12,21,3,0.166666666666667,144,10.4166666666667
"1192",2016,"UNC Wilmington",2,0,0,34,42,24,17,0,37,0,15,11,26,12,34,68,14,54,39,11,28,11,0.323529411764706,155,7.74193548387097
"1193",2016,"UT Rio Grande Valley",10,0,0,140,187,91,59,0,142,0,63,91,154,74,130,172,52,120,207,47,160,31,0.221428571428571,643,11.5085536547434
"1194",2016,"Utah State",3,0,0,33,87,35,25,0,51,0,23,33,56,20,46,66,20,46,43,13,30,5,0.151515151515152,230,8.69565217391304
"1195",2016,"Villanova",2,0,0,13,75,26,19,0,48,0,26,17,43,15,18,49,23,26,76,17,59,1,0.0769230769230769,181,8.28729281767956
"1196",2016,"Western Michigan",2,0,0,39,123,47,26,0,69,0,47,45,92,23,59,64,22,42,84,28,56,14,0.358974358974359,333,6.90690690690691
"1197",2016,"Wichita State",2,0,0,26,58,23,14,0,59,1,17,8,25,33,63,65,14,51,56,18,38,6,0.230769230769231,204,16.1764705882353
"1198",2016,"William & Mary",4,0,0,39,50,19,12,0,44,0,19,16,35,15,32,44,11,33,45,15,30,7,0.17948717948718,169,8.87573964497041
"1199",2016,"Youngstown State",3,0,0,47,155,47,30,0,87,1,61,46,107,36,75,85,31,54,163,42,121,13,0.276595744680851,425,8.47058823529412
"1200",2017,"Air Force",1,0,0,44,66,52,32,0,66,1,16,23,39,21,60,75,15,60,46,16,30,7,0.159090909090909,231,9.09090909090909
"1201",2017,"Albany",1,0,0,74,108,42,25,0,83,1,49,32,81,51,95,129,38,91,84,25,59,12,0.162162162162162,398,12.8140703517588
"1202",2017,"Arkansas-Pine Bluff",1,0,0,36,70,30,16,0,59,0,16,32,48,21,43,88,26,62,45,13,32,5,0.138888888888889,212,9.90566037735849
"1203",2017,"Bryant",1,0,0,46,118,63,41,0,53,0,36,46,82,25,74,61,15,46,55,23,32,9,0.195652173913043,325,7.69230769230769
"1204",2017,"Bucknell",4,0,0,43,140,54,39,0,59,0,48,30,78,22,74,82,35,47,94,32,62,15,0.348837209302326,387,5.68475452196382
"1205",2017,"Cal State Northridge",2,0,0,71,136,67,41,0,79,0,38,47,85,25,78,120,38,82,100,25,75,18,0.253521126760563,399,6.265664160401
"1206",2017,"Central Michigan",3,0,0,51,97,31,22,0,63,0,40,23,63,25,62,91,21,70,86,22,64,15,0.294117647058824,298,8.38926174496644
"1207",2017,"Charleston",4,0,0,56,113,39,21,0,75,0,30,33,63,24,82,107,25,82,77,24,53,13,0.232142857142857,342,7.01754385964912
"1208",2017,"Charleston Southern",4,0,0,73,92,56,33,0,93,0,29,28,57,51,67,138,39,99,119,24,95,16,0.219178082191781,340,15
"1209",2017,"Cincinnati",3,0,0,61,120,57,37,0,94,2,38,40,78,32,81,122,29,93,100,22,78,12,0.19672131147541,357,8.96358543417367
"1210",2017,"Dayton",2,0,0,103,210,107,67,0,148,0,95,81,176,47,125,138,44,94,155,68,87,29,0.281553398058252,673,6.98365527488856
"1211",2017,"East Tennessee State",3,0,0,32,61,33,21,0,58,1,30,26,56,19,35,55,15,40,71,23,48,6,0.1875,200,9.5
"1212",2017,"Gardner-Webb",1,0,0,36,74,35,22,0,44,0,34,47,81,20,35,45,8,37,57,19,38,6,0.166666666666667,216,9.25925925925926
"1213",2017,"Harvard",3,0,0,55,134,30,18,0,85,0,48,41,89,41,73,118,46,72,108,37,71,12,0.218181818181818,399,10.2756892230576
"1214",2017,"Iona",3,0,0,57,99,58,37,0,68,2,42,44,86,29,60,78,21,57,65,19,46,20,0.350877192982456,311,9.32475884244373
"1215",2017,"Jacksonville State",1,0,0,36,69,26,14,0,52,1,17,24,41,16,48,81,21,60,67,26,41,10,0.277777777777778,222,7.20720720720721
"1216",2017,"Kansas City",1,0,0,36,50,22,16,0,37,1,29,30,59,15,29,50,18,32,24,7,17,11,0.305555555555556,175,8.57142857142857
"1217",2017,"Kennesaw State",3,0,0,72,88,50,29,0,78,0,31,43,74,35,86,133,32,101,91,28,63,13,0.180555555555556,344,10.1744186046512
"1218",2017,"Kent State",3,0,0,76,115,61,41,0,89,1,31,23,54,30,90,167,45,122,102,21,81,17,0.223684210526316,391,7.67263427109974
"1219",2017,"Liberty",1,0,0,29,43,26,15,0,34,0,18,22,40,9,54,18,4,14,35,5,30,5,0.172413793103448,158,5.69620253164557
"1220",2017,"Loyola Marymount",2,0,0,37,84,44,26,0,72,0,27,26,53,22,59,54,13,41,73,18,55,10,0.27027027027027,247,8.90688259109312
"1221",2017,"Maryland",1,0,0,403,725,391,258,0,371,1,459,165,624,277,353,599,222,377,411,155,256,157,0.389578163771712,2433,11.3851212494862
"1222",2017,"McNeese",2,0,0,43,84,35,23,0,69,0,39,27,66,30,59,51,13,38,71,25,46,13,0.302325581395349,273,10.989010989011
"1223",2017,"Miami (OH)",4,0,0,8,26,12,8,0,15,0,5,9,14,6,13,19,8,11,25,9,16,2,0.25,72,8.33333333333333
"1224",2017,"Northern Colorado",1,0,0,16,41,11,8,0,30,0,18,14,32,20,30,45,16,29,39,13,26,4,0.25,136,14.7058823529412
"1225",2017,"Northern Illinois",2,0,0,67,151,59,45,0,74,0,56,58,114,35,52,139,56,83,110,35,75,21,0.313432835820896,436,8.02752293577982
"1226",2017,"Ohio",3,0,0,45,88,65,43,0,64,0,50,62,112,33,39,13,3,10,116,31,85,12,0.266666666666667,269,12.2676579925651
"1227",2017,"Portland State",2,0,0,42,119,86,56,0,67,1,50,41,91,43,83,111,35,76,59,17,42,5,0.119047619047619,366,11.7486338797814
"1228",2017,"Presbyterian",1,0,0,26,75,27,13,0,56,0,40,47,87,23,54,18,4,14,87,25,62,5,0.192307692307692,229,10.0436681222707
"1229",2017,"Princeton",1,0,0,83,135,51,33,0,87,0,33,51,84,27,92,115,32,83,93,24,69,21,0.253012048192771,407,6.63390663390663
"1230",2017,"Radford",1,0,0,71,205,88,53,0,113,0,76,74,150,38,111,127,32,95,88,23,65,18,0.253521126760563,533,7.12945590994371
"1231",2017,"Richmond",2,0,0,24,43,17,11,0,34,0,10,11,21,6,26,49,21,28,31,14,17,6,0.25,142,4.22535211267606
"1232",2017,"Sacramento State",2,0,0,58,77,44,27,0,60,0,46,40,86,20,45,53,20,33,113,32,81,16,0.275862068965517,289,6.9204152249135
"1233",2017,"Saint Mary's",4,0,0,112,205,110,74,0,147,1,102,108,210,56,167,129,47,82,121,40,81,35,0.3125,706,7.93201133144476
"1234",2017,"Samford",2,0,0,29,134,60,44,0,113,1,48,47,95,25,91,81,25,56,112,41,71,6,0.206896551724138,386,6.47668393782383
"1235",2017,"Santa Clara",2,0,0,46,120,48,30,0,107,0,49,53,102,41,84,79,25,54,107,35,72,15,0.326086956521739,370,11.0810810810811
"1236",2017,"Seattle U",2,0,0,51,78,42,29,0,63,1,38,57,95,34,37,68,21,47,72,20,52,19,0.372549019607843,254,13.3858267716535
"1237",2017,"St. Bonaventure",1,0,0,12,16,17,12,0,16,0,16,15,31,6,11,14,5,9,10,4,6,4,0.333333333333333,68,8.82352941176471
"1238",2017,"Stetson",2,0,0,44,139,55,45,0,95,0,66,58,124,42,75,115,35,80,96,39,57,13,0.295454545454545,414,10.1449275362319
"1239",2017,"UAB",5,0,0,13,49,28,18,0,26,0,15,17,32,24,41,25,10,15,45,11,34,5,0.384615384615385,147,16.3265306122449
"1240",2017,"UNLV",4,0,0,57,107,59,38,0,72,1,47,41,88,47,68,104,23,81,89,29,60,12,0.210526315789474,344,13.6627906976744
"1241",2017,"UT Rio Grande Valley",1,0,0,107,184,109,71,0,166,2,61,62,123,73,125,199,55,144,197,53,144,32,0.299065420560748,611,11.9476268412439
"1242",2018,"Ball State",4,0,0,70,132,84,50,0,86,0,73,57,130,50,70,91,21,70,93,29,64,12,0.171428571428571,415,12.0481927710843
"1243",2018,"Baylor",1,0,0,400,892,393,258,0,381,1,291,112,403,182,332,918,428,490,330,126,204,154,0.385,2572,7.07620528771384
"1244",2018,"Binghamton",2,0,0,19,42,13,10,0,24,0,22,31,53,29,16,47,23,24,32,9,23,5,0.263157894736842,134,21.6417910447761
"1245",2018,"Boise State",6,0,0,61,132,51,34,0,74,0,62,25,87,24,84,98,35,63,102,32,70,25,0.40983606557377,416,5.76923076923077
"1246",2018,"Bucknell",1,0,0,44,115,45,28,0,44,0,42,25,67,26,90,59,19,40,80,18,62,12,0.272727272727273,337,7.71513353115727
"1247",2018,"Buffalo",1,0,0,89,143,86,60,0,129,2,79,91,170,87,77,111,40,71,119,40,79,31,0.348314606741573,493,17.6470588235294
"1248",2018,"Cal State Bakersfield",2,0,0,49,90,46,30,0,65,0,37,48,85,32,41,76,21,55,66,18,48,8,0.163265306122449,265,12.0754716981132
"1249",2018,"Campbell",2,0,0,21,46,22,13,0,34,0,8,30,38,10,28,17,2,15,38,17,21,4,0.19047619047619,124,8.06451612903226
"1250",2018,"Canisius",2,0,0,8,17,9,6,0,12,0,15,8,23,15,13,18,6,12,15,2,13,2,0.25,61,24.5901639344262
"1251",2018,"Central Connecticut",1,0,0,38,99,47,29,0,82,0,13,28,41,15,87,57,21,36,120,40,80,4,0.105263157894737,306,4.90196078431373
"1252",2018,"Cincinnati",1,0,0,35,94,46,33,0,41,0,50,43,93,28,55,71,20,51,68,21,47,12,0.342857142857143,288,9.72222222222222
"1253",2018,"Coppin State",1,0,0,39,76,43,33,0,72,0,17,16,33,20,81,108,25,83,64,19,45,9,0.230769230769231,265,7.54716981132075
"1254",2018,"Creighton",1,0,0,64,150,43,33,0,88,0,51,45,96,18,66,107,38,69,140,60,80,20,0.3125,437,4.11899313501144
"1255",2018,"Detroit Mercy",1,0,0,43,132,75,49,0,123,0,37,28,65,27,115,119,28,91,141,34,107,11,0.255813953488372,402,6.71641791044776
"1256",2018,"Florida A&M",7,0,0,88,141,80,47,0,105,0,45,47,92,51,101,161,44,117,134,42,92,22,0.25,483,10.5590062111801
"1257",2018,"Florida Gulf Coast",1,0,0,46,135,59,36,0,73,0,67,56,123,41,68,5,0,5,176,72,104,13,0.282608695652174,401,10.2244389027431
"1258",2018,"Florida International",2,0,0,33,69,44,33,0,54,0,23,26,49,18,49,70,18,52,48,18,30,5,0.151515151515152,218,8.25688073394496
"1259",2018,"Fresno State",1,0,0,31,56,29,18,0,48,1,29,28,57,14,36,63,17,46,57,19,38,7,0.225806451612903,195,7.17948717948718
"1260",2018,"Gardner-Webb",2,0,0,30,68,21,12,0,42,0,21,29,50,17,36,73,22,51,49,15,34,7,0.233333333333333,195,8.71794871794872
"1261",2018,"Georgia Southern",2,0,0,30,48,14,6,0,42,0,25,18,43,17,40,51,11,40,49,12,37,9,0.3,168,10.1190476190476
"1262",2018,"Grambling",1,0,0,40,90,39,24,0,82,0,52,22,74,46,60,101,31,70,79,15,64,9,0.225,297,15.4882154882155
"1263",2018,"Grand Canyon",2,0,0,23,101,27,22,0,58,0,26,21,47,11,57,76,35,41,86,30,56,8,0.347826086956522,279,3.9426523297491
"1264",2018,"Hofstra",1,0,0,25,49,31,17,0,27,0,39,29,68,15,29,26,6,20,33,9,24,6,0.24,164,9.14634146341463
"1265",2018,"Indiana State",5,0,0,46,102,60,37,0,61,0,23,23,46,34,60,90,29,61,96,27,69,11,0.239130434782609,303,11.2211221122112
"1266",2018,"Jackson State",3,0,0,22,27,6,2,0,19,0,17,29,46,10,15,29,11,18,10,2,8,2,0.0909090909090909,95,10.5263157894737
"1267",2018,"Lehigh",1,0,0,19,56,26,19,0,33,0,10,6,16,5,42,59,24,35,36,11,25,6,0.31578947368421,165,3.03030303030303
"1268",2018,"Little Rock",3,0,0,89,181,85,57,0,145,0,55,52,107,56,133,233,89,144,87,22,65,28,0.314606741573034,590,9.49152542372881
"1269",2018,"Marist",1,0,0,42,122,41,30,0,60,0,41,35,76,22,88,88,33,55,95,31,64,11,0.261904761904762,365,6.02739726027397
"1270",2018,"Miami (OH)",6,0,0,53,93,35,26,0,59,0,51,41,92,29,47,81,24,57,80,19,61,13,0.245283018867925,297,9.76430976430976
"1271",2018,"Mississippi State",1,0,0,332,568,327,224,0,318,1,207,114,321,213,253,654,312,342,435,174,261,120,0.36144578313253,1923,11.0764430577223
"1272",2018,"New Hampshire",4,0,0,13,27,9,6,0,15,0,12,17,29,3,11,27,5,22,14,4,10,3,0.230769230769231,74,4.05405405405405
"1273",2018,"Nicholls",1,0,0,46,125,66,38,0,96,0,40,22,62,42,87,115,30,85,107,28,79,9,0.195652173913043,375,11.2
"1274",2018,"Norfolk State",2,0,0,18,29,13,7,0,14,0,7,15,22,11,18,17,6,11,19,3,16,3,0.166666666666667,82,13.4146341463415
"1275",2018,"Northern Colorado",2,0,0,42,123,70,51,0,88,0,62,45,107,32,59,65,26,39,110,45,65,17,0.404761904761905,373,8.57908847184987
"1276",2018,"Northern Illinois",1,0,0,30,47,21,15,0,32,0,25,14,39,11,28,46,11,35,58,20,38,9,0.3,164,6.70731707317073
"1277",2018,"Oakland",1,0,0,74,157,81,50,0,152,0,58,54,112,69,122,141,37,104,171,55,116,20,0.27027027027027,519,13.2947976878613
"1278",2018,"Ohio",3,0,0,42,81,61,34,0,82,0,60,73,133,48,48,20,1,19,96,40,56,13,0.30952380952381,282,17.0212765957447
"1279",2018,"Old Dominion",1,0,0,39,83,26,15,0,91,0,24,32,56,21,51,60,19,41,96,30,66,7,0.17948717948718,253,8.300395256917
"1280",2018,"Oral Roberts",1,0,0,48,134,51,31,0,82,0,48,48,96,25,69,102,34,68,85,31,54,13,0.270833333333333,374,6.68449197860963
"1281",2018,"Quinnipiac",2,0,0,75,171,77,52,0,134,2,64,57,121,60,80,139,48,91,185,53,132,22,0.293333333333333,509,11.7878192534381
"1282",2018,"Radford",1,0,0,67,157,72,44,0,108,0,57,71,128,50,110,140,40,100,123,27,96,10,0.149253731343284,470,10.6382978723404
"1283",2018,"Richmond",5,0,0,48,96,44,32,0,73,1,48,33,81,40,52,85,25,60,89,28,61,11,0.229166666666667,310,12.9032258064516
"1284",2018,"Robert Morris",1,0,0,41,70,46,27,0,78,0,47,37,84,43,70,48,17,31,70,23,47,12,0.292682926829268,280,15.3571428571429
"1285",2018,"Samford",2,0,0,52,130,49,28,0,104,0,63,43,106,29,88,116,31,85,115,39,76,14,0.269230769230769,411,7.05596107055961
"1286",2018,"San Diego State",4,0,0,19,55,30,22,0,38,0,20,6,26,5,21,57,20,37,40,16,24,8,0.421052631578947,160,3.125
"1287",2018,"South Dakota State",2,0,0,62,117,59,45,0,59,0,47,69,116,33,49,42,16,26,100,34,66,18,0.290322580645161,342,9.64912280701754
"1288",2018,"Southern Illinois",3,0,0,43,72,49,31,0,68,1,36,28,64,37,60,106,33,73,54,18,36,14,0.325581395348837,278,13.3093525179856
"1289",2018,"St. Bonaventure",1,0,0,14,47,22,15,0,36,0,25,14,39,15,25,26,11,15,49,17,32,6,0.428571428571429,147,10.2040816326531
"1290",2018,"St. Francis Brooklyn",1,0,0,11,26,11,7,0,15,0,10,14,24,3,18,13,5,8,15,4,11,4,0.363636363636364,77,3.8961038961039
"1291",2018,"Temple",4,0,0,115,187,109,72,0,139,1,84,84,168,41,120,163,33,130,159,52,107,31,0.269565217391304,614,6.67752442996743
"1292",2018,"UC Irvine",1,0,0,47,67,60,38,0,76,0,36,35,71,31,50,61,9,52,60,17,43,10,0.212765957446809,239,12.9707112970711
"1293",2018,"UC Riverside",3,0,0,112,249,97,64,0,172,1,60,52,112,51,154,316,106,210,132,36,96,27,0.241071428571429,738,6.91056910569106
"1294",2018,"UNC Asheville",1,0,0,32,95,39,24,0,62,0,28,30,58,12,58,78,29,49,50,16,34,10,0.3125,270,4.44444444444444
"1295",2018,"Valparaiso",2,0,0,60,122,46,30,0,99,1,47,43,90,23,75,103,21,82,103,26,77,18,0.3,362,6.353591160221
"1296",2018,"Western Illinois",5,0,0,53,130,70,48,0,72,1,74,51,125,56,67,54,9,45,140,41,99,17,0.320754716981132,392,14.2857142857143
"1297",2018,"Western Michigan",1,0,0,61,162,71,44,0,99,0,64,48,112,32,106,113,42,71,110,33,77,13,0.213114754098361,479,6.68058455114822
"1298",2018,"Wyoming",2,0,0,40,121,55,42,0,75,0,46,22,68,25,68,89,29,60,90,28,62,14,0.35,347,7.20461095100865
"1299",2018,"Xavier",3,0,0,31,96,44,26,0,50,0,33,42,75,20,52,45,17,28,93,26,67,15,0.483870967741935,261,7.66283524904215
"1300",2018,"Youngstown State",2,0,0,38,127,44,25,0,80,0,36,31,67,13,80,72,24,48,131,42,89,8,0.210526315789474,360,3.61111111111111
"1301",2019,"Abilene Christian",2,0,0,56,127,51,37,0,92,0,69,44,113,32,96,37,7,30,131,49,82,9,0.160714285714286,413,7.74818401937046
"1302",2019,"Baylor",1,0,0,345,771,365,225,0,381,1,391,180,571,174,318,725,294,431,185,72,113,117,0.339130434782609,2286,7.61154855643045
"1303",2019,"Belmont",3,0,0,71,161,56,33,0,86,0,65,48,113,31,73,74,21,53,168,54,114,22,0.309859154929577,457,6.78336980306346
"1304",2019,"Bethune-Cookman",1,0,0,53,118,64,34,0,59,1,39,54,93,27,51,65,23,42,72,18,54,14,0.264150943396226,318,8.49056603773585
"1305",2019,"Binghamton",3,0,0,36,68,18,12,0,52,0,22,19,41,13,62,57,19,38,77,15,62,8,0.222222222222222,227,5.72687224669604
"1306",2019,"Boise State",3,0,0,69,131,60,44,0,91,1,57,47,104,45,75,118,35,83,142,56,86,21,0.304347826086957,434,10.36866359447
"1307",2019,"Bradley",1,0,0,30,65,30,19,0,70,0,37,22,59,24,44,75,16,59,59,15,44,8,0.266666666666667,216,11.1111111111111
"1308",2019,"Central Arkansas",1,0,0,53,103,60,38,0,88,0,41,43,84,40,90,132,34,98,59,17,42,13,0.245283018867925,346,11.5606936416185
"1309",2019,"Charleston Southern",1,0,0,59,125,41,27,0,94,1,36,36,72,37,76,152,60,92,71,25,46,18,0.305084745762712,389,9.51156812339332
"1310",2019,"Chattanooga",1,0,0,42,97,70,44,0,65,0,39,44,83,15,53,70,21,49,71,19,52,12,0.285714285714286,286,5.24475524475525
"1311",2019,"Coppin State",1,0,0,98,156,81,51,0,115,1,49,85,134,55,140,120,29,91,143,23,120,24,0.244897959183673,507,10.8481262327416
"1312",2019,"Davidson",5,0,0,66,130,67,42,0,80,0,57,54,111,31,75,80,26,54,115,38,77,18,0.272727272727273,405,7.65432098765432
"1313",2019,"Dayton",3,0,0,67,181,89,59,1,141,0,65,70,135,44,93,142,38,104,124,48,76,17,0.253731343283582,510,8.62745098039216
"1314",2019,"DePaul",8,0,0,302,506,219,160,1,371,2,273,208,481,193,302,237,90,147,689,235,454,102,0.337748344370861,1762,10.9534619750284
"1315",2019,"Denver",1,0,0,67,127,58,39,0,90,0,67,65,132,36,82,66,18,48,123,40,83,24,0.358208955223881,420,8.57142857142857
"1316",2019,"Drake",1,0,0,177,447,227,159,0,259,1,237,139,376,142,275,178,68,110,385,142,243,50,0.282485875706215,1416,10.0282485875706
"1317",2019,"Duquesne",1,0,0,71,166,75,48,0,109,0,70,69,139,51,101,114,40,74,148,43,105,17,0.23943661971831,510,10
"1318",2019,"Fairfield",2,0,0,25,57,15,10,0,35,0,18,13,31,9,37,37,13,24,36,15,21,8,0.32,170,5.29411764705882
"1319",2019,"Georgia State",2,0,0,25,70,30,17,0,50,0,27,29,56,24,66,45,15,30,62,17,45,5,0.2,226,10.6194690265487
"1320",2019,"Grambling",2,0,0,92,108,95,61,0,117,1,60,76,136,51,102,132,27,105,84,21,63,19,0.206521739130435,433,11.7782909930716
"1321",2019,"Hartford",2,0,0,59,89,40,25,0,71,0,52,55,107,66,68,70,24,46,127,40,87,14,0.23728813559322,343,19.2419825072886
"1322",2019,"Hofstra",2,0,0,44,63,33,25,0,60,1,27,28,55,26,50,61,20,41,56,15,41,13,0.295454545454545,227,11.4537444933921
"1323",2019,"Houston Christian",1,0,0,22,56,23,15,0,40,0,14,34,48,11,26,56,20,36,29,10,19,4,0.181818181818182,153,7.18954248366013
"1324",2019,"Illinois State",1,0,0,40,70,49,32,0,61,1,32,47,79,25,42,50,13,37,53,13,40,13,0.325,225,11.1111111111111
"1325",2019,"Indiana State",2,0,0,31,56,35,25,0,54,0,36,19,55,24,53,53,16,37,74,24,50,10,0.32258064516129,229,10.4803493449782
"1326",2019,"Jackson State",6,0,0,69,150,70,44,0,105,2,52,56,108,38,111,130,39,91,55,12,43,11,0.159420289855072,447,8.50111856823266
"1327",2019,"James Madison",4,0,0,76,131,62,39,0,72,1,42,46,88,37,66,110,32,78,102,26,76,20,0.263157894736842,391,9.46291560102302
"1328",2019,"Kent State",1,0,0,66,143,79,53,0,101,1,45,48,93,47,89,107,32,75,144,45,99,15,0.227272727272727,438,10.7305936073059
"1329",2019,"Longwood",2,0,0,16,48,19,12,0,32,0,19,23,42,10,36,31,5,26,19,6,13,3,0.1875,132,7.57575757575758
"1330",2019,"Louisiana Tech",2,0,0,60,132,63,40,0,93,0,54,68,122,35,77,102,36,66,86,17,69,11,0.183333333333333,389,8.9974293059126
"1331",2019,"Loyola Marymount",2,0,0,103,161,87,52,0,138,0,84,89,173,63,121,116,29,87,109,32,77,29,0.281553398058252,550,11.4545454545455
"1332",2019,"Marshall",3,0,0,47,138,43,26,0,86,0,41,39,80,32,76,85,24,61,145,43,102,13,0.276595744680851,378,8.46560846560847
"1333",2019,"Miami (OH)",1,0,0,42,85,24,15,0,64,0,47,34,81,23,56,73,27,46,85,29,56,12,0.285714285714286,293,7.84982935153584
"1334",2019,"Monmouth",1,0,0,44,75,39,26,0,59,0,34,44,78,26,54,37,5,32,59,12,47,17,0.386363636363636,229,11.353711790393
"1335",2019,"Morehead State",3,0,0,88,137,68,40,0,118,0,62,55,117,54,86,152,41,111,125,39,86,27,0.306818181818182,468,11.5384615384615
"1336",2019,"Morgan State",1,0,0,26,55,27,16,0,56,1,25,27,52,20,50,76,17,59,28,8,20,6,0.230769230769231,187,10.6951871657754
"1337",2019,"NJIT",2,0,0,18,42,24,14,0,30,0,13,9,22,8,43,25,5,20,50,14,36,4,0.222222222222222,141,5.67375886524823
"1338",2019,"Nevada",3,0,0,86,135,74,48,0,91,0,54,53,107,43,114,143,51,92,96,27,69,23,0.267441860465116,484,8.88429752066116
"1339",2019,"Nicholls",1,0,0,50,112,59,41,0,87,0,28,40,68,38,106,104,33,71,95,27,68,15,0.3,369,10.2981029810298
"1340",2019,"North Florida",2,0,0,40,109,49,33,0,82,0,39,29,68,36,63,126,46,80,97,20,77,9,0.225,330,10.9090909090909
"1341",2019,"North Texas",4,0,0,69,123,56,31,0,85,0,39,43,82,23,73,127,35,92,67,19,48,13,0.188405797101449,372,6.18279569892473
"1342",2019,"Northern Illinois",1,0,0,54,107,46,27,0,63,0,33,30,63,19,54,113,34,79,86,29,57,18,0.333333333333333,324,5.8641975308642
"1343",2019,"Ohio",2,0,0,84,167,94,59,0,102,0,104,119,223,74,81,33,12,21,161,56,105,28,0.333333333333333,527,14.0417457305503
"1344",2019,"Pacific",2,0,0,71,126,67,51,0,104,0,59,61,120,47,87,133,44,89,110,35,75,15,0.211267605633803,438,10.7305936073059
"1345",2019,"Portland",5,0,0,40,79,54,36,0,83,1,46,31,77,26,77,52,17,35,99,30,69,7,0.175,301,8.63787375415282
"1346",2019,"Princeton",2,0,0,43,120,44,33,0,87,0,51,51,102,44,76,78,23,55,130,44,86,13,0.302325581395349,374,11.7647058823529
"1347",2019,"Quinnipiac",3,0,0,85,102,72,46,0,93,0,42,50,92,49,46,105,30,75,123,35,88,17,0.2,355,13.8028169014085
"1348",2019,"Robert Morris",1,0,0,21,58,40,21,0,56,0,36,28,64,23,46,23,10,13,60,25,35,5,0.238095238095238,207,11.1111111111111
"1349",2019,"Seattle U",4,0,0,30,61,30,22,0,42,0,30,22,52,15,48,58,24,34,47,10,37,9,0.3,212,7.07547169811321
"1350",2019,"South Dakota",4,0,0,95,228,107,77,0,184,0,124,82,206,65,114,135,55,80,196,65,131,22,0.231578947368421,700,9.28571428571429
"1351",2019,"St. Francis (PA)",3,0,0,47,84,46,28,0,84,1,34,36,70,40,84,41,17,24,147,48,99,12,0.25531914893617,323,12.3839009287926
"1352",2019,"St. Francis Brooklyn",1,0,0,16,23,21,15,0,17,0,17,17,34,6,18,11,2,9,13,4,9,5,0.3125,84,7.14285714285714
"1353",2019,"Stetson",2,0,0,32,118,39,23,0,107,1,56,34,90,43,107,102,33,69,101,29,72,10,0.3125,383,11.2271540469974
"1354",2019,"Temple",3,0,0,78,139,61,40,0,102,0,52,41,93,37,88,122,41,81,160,51,109,26,0.333333333333333,466,7.93991416309013
"1355",2019,"Tennessee Tech",1,0,0,65,134,47,33,0,67,0,51,50,101,21,68,96,26,70,80,28,52,15,0.230769230769231,380,5.52631578947368
"1356",2019,"Tulane",1,0,0,39,119,39,25,0,93,0,29,22,51,32,77,147,57,90,82,27,55,15,0.384615384615385,360,8.88888888888889
"1357",2019,"UC Irvine",2,0,0,72,81,41,27,0,62,1,31,37,68,30,36,112,31,81,84,22,62,26,0.361111111111111,282,10.6382978723404
"1358",2019,"UC Riverside",1,0,0,66,126,50,29,0,80,1,58,38,96,38,92,145,54,91,91,25,66,17,0.257575757575758,434,8.75576036866359
"1359",2019,"UCF",1,0,0,37,87,46,26,0,71,0,48,30,78,36,53,95,44,51,46,14,32,16,0.432432432432432,297,12.1212121212121
"1360",2019,"UMass",2,0,0,40,83,43,28,0,54,0,50,35,85,20,33,59,20,39,55,19,36,7,0.175,259,7.72200772200772
"1361",2019,"UT Rio Grande Valley",4,0,0,63,137,75,48,0,107,2,38,50,88,35,103,89,26,63,159,54,105,21,0.333333333333333,432,8.10185185185185
"1362",2019,"Utah State",4,0,0,71,141,50,32,0,133,0,60,53,113,45,92,163,58,105,120,37,83,18,0.253521126760563,471,9.55414012738854
"1363",2019,"Wake Forest",4,0,0,389,761,322,205,1,442,2,303,264,567,179,549,573,182,391,440,124,316,112,0.287917737789203,2377,7.53050063104754
"1364",2019,"Youngstown State",2,0,0,37,112,37,27,0,45,0,30,31,61,17,62,52,19,33,99,34,65,11,0.297297297297297,307,5.53745928338762
"1365",2020,"Florida A&M",1,0,0,135,231,108,59,0,181,4,95,86,181,75,233,210,63,147,132,30,102,42,0.311111111111111,823,9.11300121506683
"1366",2020,"High Point",7,0,0,279,711,341,205,0,495,1,275,254,529,151,355,508,193,315,501,154,347,93,0.333333333333333,2039,7.40559097596861
"1367",2020,"Marist",7,0,0,323,777,278,181,0,369,0,364,208,572,190,397,764,314,450,340,131,209,117,0.362229102167183,2366,8.03043110735418
"1368",2020,"Quincy",2,0,0,17,29,17,13,0,20,0,12,4,16,4,23,24,8,16,14,3,11,3,0.176470588235294,96,4.16666666666667
"1369",2020,"Southern",8,0,0,263,337,231,133,0,336,0,120,170,290,136,289,453,147,306,193,57,136,65,0.247148288973384,1265,10.7509881422925
"1370",2020,"Wisconsin Parkside",3,0,0,12,17,9,5,0,23,0,9,18,27,12,13,8,4,4,36,15,21,4,0.333333333333333,72,16.6666666666667
"1371",2021,"Albany",3,3,100,194,413,163,99,0,265,0,156,167,323,115,317,569,179,390,0,0,0,62,0.319587628865979,1299,8.85296381832179
"1372",2021,"Texas Southern",1,1,100,163,252,151,88,0,195,0,147,145,292,103,204,380,109,271,0,0,0,48,0.294478527607362,911,11.3062568605928
"1373",2021,"UC Davis",1,1,100,127,461,142,100,0,192,0,160,105,265,86,203,528,175,353,0,0,0,35,0.275590551181102,1163,7.39466895958727
"1374",2021,"Westmont",2,2,100,33,42,35,20,0,52,0,21,23,44,24,25,88,24,64,0,0,0,5,0.151515151515152,154,15.5844155844156
"1375",2022,"Bellarmine",2,2,100,321,663,278,182,0,505,2,227,262,489,189,514,1143,390,753,0,0,0,90,0.280373831775701,2170,8.70967741935484
"1376",2022,"Jarvis Christian",1,1,100,40,76,57,35,0,69,0,14,18,32,12,62,126,37,89,0,0,0,8,0.2,237,5.06329113924051
"1377",2022,"Molloy",1,1,100,11,31,16,8,0,19,0,8,9,17,6,24,23,8,15,0,0,0,4,0.363636363636364,84,7.14285714285714
"1378",2023,"Mercyhurst",1,1,100,9,28,3,2,0,18,0,10,14,24,4,13,38,18,20,0,0,0,4,0.444444444444444,79,5.06329113924051
"1379",2023,"South Carolina State",2,2,100,308,643,330,190,0,411,4,210,190,400,189,575,1011,255,756,0,0,0,62,0.201298701298701,2055,9.1970802919708
"1380",2024,"UNC Wilmington",5,5,100,402,703,360,239,0,436,3,277,317,594,217,571,1135,303,832,0,0,0,122,0.303482587064677,2348,9.24190800681431
"1381",2021,"Southern",7,6,85.7,289,399,321,188,0,368,1,165,187,352,195,280,729,255,474,0,0,0,100,0.346020761245675,1452,13.4297520661157
"1382",2023,"Vanderbilt",13,11,84.6,367,627,403,276,0,550,0,367,343,710,255,452,1006,337,669,0,0,0,111,0.302452316076294,2258,11.2931798051373
"1383",2021,"Nicholls",9,7,77.8,295,566,362,236,0,427,2,297,281,578,236,478,734,238,496,0,0,0,88,0.298305084745763,1965,12.0101781170483
"1384",2023,"TCU",9,7,77.8,307,733,453,272,0,529,4,314,277,591,262,517,1120,323,797,0,0,0,84,0.273615635179153,2312,11.3321799307958
"1385",2021,"Fairfield",4,3,75,163,381,127,80,1,217,0,117,104,221,118,218,644,232,412,0,0,0,55,0.337423312883436,1142,10.3327495621716
"1386",2021,"Fairleigh Dickinson",8,6,75,228,562,205,124,0,337,2,253,254,507,137,318,642,235,407,0,0,0,76,0.333333333333333,1643,8.338405356056
"1387",2021,"Florida",8,6,75,355,608,314,195,0,382,1,299,232,531,146,318,958,326,632,0,0,0,117,0.329577464788732,1982,7.36629667003027
"1388",2021,"Washington",4,3,75,246,360,170,109,0,288,0,167,134,301,172,320,692,204,488,0,0,0,71,0.288617886178862,1344,12.797619047619
"1389",2024,"Texas Tech",4,3,75,402,743,410,285,0,552,6,366,289,655,247,543,1186,371,815,0,0,0,114,0.283582089552239,2550,9.68627450980392
"1390",2024,"Arizona State",7,5,71.4,326,629,353,225,0,500,3,304,346,650,201,347,1023,316,707,0,0,0,111,0.340490797546012,2013,9.98509687034277
"1391",2022,"Wisconsin",10,7,70,291,617,257,165,0,446,0,289,249,538,195,441,1031,336,695,0,0,0,89,0.305841924398625,2039,9.56351152525748
"1392",2024,"Fairleigh Dickinson",13,9,69.2,410,752,283,186,0,483,0,253,270,523,180,472,1205,397,808,0,0,0,113,0.275609756097561,2351,7.65631646108039
"1393",2024,"Harvard",13,9,69.2,362,683,293,201,0,506,0,356,276,632,198,388,1034,360,674,0,0,0,121,0.334254143646409,2237,8.85113991953509
"1394",2021,"Bucknell",3,2,66.7,80,319,111,84,0,138,0,132,124,256,60,97,333,125,208,0,0,0,29,0.3625,793,7.56620428751576
"1395",2021,"Eastern Kentucky",9,6,66.7,247,557,258,180,0,385,3,174,146,320,156,398,848,291,557,0,0,0,56,0.226720647773279,1727,9.03300521134916
"1396",2021,"Elon",3,2,66.7,147,301,158,101,0,217,0,128,130,258,99,206,465,156,309,0,0,0,43,0.292517006802721,979,10.1123595505618
"1397",2021,"Fordham",9,6,66.7,207,437,152,98,0,240,0,124,127,251,88,235,628,230,398,0,0,0,63,0.304347826086957,1265,6.95652173913043
"1398",2021,"Niagara",3,2,66.7,145,256,125,83,0,202,1,141,148,289,112,232,358,113,245,0,0,0,44,0.303448275862069,917,12.2137404580153
"1399",2021,"Providence",3,2,66.7,143,473,163,101,0,282,0,195,187,382,110,304,640,214,426,0,0,0,44,0.307692307692308,1365,8.05860805860806
"1400",2021,"UConn",12,8,66.7,324,833,314,212,0,360,1,507,211,718,263,389,1020,386,634,0,0,0,120,0.37037037037037,2549,10.3177716751667
"1401",2021,"Virginia",3,2,66.7,28,63,34,20,0,43,1,24,28,52,15,55,99,38,61,0,0,0,9,0.321428571428571,216,6.94444444444444
"1402",2022,"Cleveland State",6,4,66.7,382,743,468,296,0,402,3,350,344,694,261,434,893,298,595,0,0,0,114,0.298429319371728,2311,11.2938122025097
"1403",2022,"Florida A&M",6,4,66.7,363,559,290,179,0,416,0,144,167,311,145,484,981,291,690,0,0,0,110,0.303030303030303,1923,7.54030161206448
"1404",2022,"Grambling",6,4,66.7,271,441,259,161,0,410,0,241,249,490,165,352,744,210,534,0,0,0,73,0.269372693726937,1577,10.4629042485732
"1405",2022,"Northern Arizona",12,8,66.7,363,816,375,248,0,556,3,445,396,841,248,467,1070,402,668,0,0,0,122,0.336088154269972,2595,9.55684007707129
"1406",2023,"Nicholls",3,2,66.7,310,693,319,198,0,434,0,261,276,537,190,481,1041,322,719,0,0,0,118,0.380645161290323,2145,8.85780885780886
"1407",2024,"Colorado",6,4,66.7,400,816,373,244,1,533,1,491,361,852,316,428,1075,385,690,0,0,0,137,0.3425,2621,12.0564669973293
"1408",2024,"Gettysburg",3,2,66.7,21,35,12,8,0,21,0,15,14,29,14,25,53,15,38,0,0,0,7,0.333333333333333,112,12.5
"1409",2024,"Michigan State",9,6,66.7,307,729,356,241,0,453,8,464,250,714,269,348,1089,407,682,0,0,0,127,0.413680781758958,2348,11.4565587734242
"1410",2024,"South Dakota",9,6,66.7,422,960,451,319,1,558,0,431,377,808,217,529,1187,409,778,0,0,0,148,0.350710900473934,2854,7.60336370007008
"1411",2024,"Western Colorado",3,2,66.7,10,33,6,6,0,15,0,7,9,16,11,14,39,10,29,0,0,0,4,0.4,75,14.6666666666667
"1412",2024,"Milwaukee",23,15,65.2,353,787,318,231,0,526,2,353,300,653,199,516,1072,389,683,0,0,0,117,0.331444759206799,2486,8.0048270313757
"1413",2023,"Tennessee Tech",14,9,64.3,413,749,379,263,0,564,1,363,309,672,248,435,1170,422,748,0,0,0,150,0.36319612590799,2478,10.0080710250202
"1414",2024,"Utah State",14,9,64.3,362,744,392,255,0,496,2,321,370,691,199,536,917,263,654,0,0,0,136,0.375690607734807,2320,8.57758620689655
"1415",2022,"Hawai'i",11,7,63.6,331,766,430,281,0,498,3,337,311,648,224,457,954,302,652,0,0,0,102,0.308157099697885,2298,9.74760661444735
"1416",2024,"Yale",11,7,63.6,395,599,305,193,0,491,0,321,304,625,203,402,981,303,678,0,0,0,118,0.29873417721519,2106,9.63912630579297
"1417",2023,"Prairie View A&M",16,10,62.5,418,670,451,270,0,579,3,262,261,523,255,485,1101,314,787,0,0,0,144,0.344497607655502,2255,11.3082039911308
"1418",2024,"Pacific",8,5,62.5,422,904,398,279,0,614,2,511,398,909,259,586,1135,409,726,0,0,0,161,0.381516587677725,2943,8.80054366292898
"1419",2021,"Bowling Green",13,8,61.5,296,677,351,239,0,490,2,388,346,734,277,365,891,309,582,0,0,0,83,0.280405405405405,2130,13.0046948356808
"1420",2021,"Charleston Southern",13,8,61.5,213,589,244,160,0,342,2,189,149,338,120,373,829,269,560,0,0,0,85,0.39906103286385,1694,7.08382526564345
"1421",2023,"UConn",13,8,61.5,434,1130,428,294,0,517,4,600,321,921,256,607,1221,455,766,0,0,0,137,0.315668202764977,3347,7.64864057364804
"1422",2024,"Oral Roberts",18,11,61.1,445,762,426,289,0,516,1,414,351,765,319,388,1368,500,868,0,0,0,165,0.370786516853933,2615,12.1988527724665
"1423",2021,"Missouri State",5,3,60,344,646,275,185,0,368,0,276,193,469,222,301,957,309,648,0,0,0,109,0.316860465116279,1943,11.4256304683479
"1424",2021,"Seton Hall",20,12,60,250,534,261,180,0,316,3,271,226,497,183,279,855,312,543,0,0,0,78,0.312,1716,10.6643356643357
"1425",2023,"Delaware State",5,3,60,311,565,276,160,0,282,0,176,237,413,170,430,817,240,577,0,0,0,99,0.318327974276527,1789,9.50251537171604
"1426",2023,"Oregon",25,15,60,538,1016,408,274,0,475,1,456,380,836,231,423,1390,497,893,0,0,0,196,0.364312267657993,3030,7.62376237623762
"1427",2023,"Western Carolina",10,6,60,428,686,369,223,0,567,2,215,250,465,141,518,1122,373,749,0,0,0,131,0.30607476635514,2310,6.1038961038961
"1428",2023,"Winthrop",10,6,60,340,681,334,206,0,464,6,239,213,452,273,568,1069,336,733,0,0,0,109,0.320588235294118,2251,12.1279431363838
"1429",2024,"Cleveland State",5,3,60,408,906,577,372,0,524,3,512,404,916,319,490,1014,386,628,0,0,0,121,0.29656862745098,2835,11.2522045855379
"1430",2024,"Loyola Chicago",20,12,60,348,648,346,233,0,492,2,357,350,707,229,479,941,310,631,0,0,0,98,0.281609195402299,2222,10.3060306030603
"1431",2024,"Marshall",10,6,60,590,717,487,293,0,647,5,461,350,811,412,497,1403,496,907,0,0,0,202,0.342372881355932,2873,14.3404107205012
"1432",2022,"Texas Tech",27,16,59.3,349,668,341,229,0,451,4,266,189,455,162,422,1012,383,629,0,0,0,121,0.346704871060172,2183,7.42098030233623
"1433",2023,"Arkansas-Pine Bluff",17,10,58.8,505,793,554,319,1,629,3,349,303,652,235,563,978,309,669,0,0,0,184,0.364356435643564,2651,8.86457940399849
"1434",2021,"Little Rock",12,7,58.3,324,599,289,189,0,385,3,231,209,440,170,385,913,309,604,0,0,0,119,0.367283950617284,1916,8.87265135699374
"1435",2022,"Columbia",12,7,58.3,453,934,426,248,1,543,1,429,364,793,237,556,1130,361,769,0,0,0,129,0.28476821192053,2826,8.3864118895966
"1436",2024,"Ole Miss",12,7,58.3,602,867,527,338,0,574,3,400,306,706,258,516,1270,422,848,0,0,0,197,0.327242524916944,2943,8.76656472986748
"1437",2021,"Montana",19,11,57.9,316,672,285,204,1,370,0,247,235,482,153,368,875,281,594,0,0,0,97,0.306962025316456,1949,7.85017957927142
"1438",2022,"IUPUI",19,11,57.9,370,835,295,203,0,367,0,301,176,477,165,454,1168,447,721,0,0,0,124,0.335135135135135,2491,6.62384584504215
"1439",2024,"Binghamton",19,11,57.9,278,698,253,168,0,482,0,282,226,508,189,410,1092,393,699,0,0,0,87,0.31294964028777,2131,8.86907555138433
"1440",2021,"Abilene Christian",7,4,57.1,293,647,279,196,0,403,1,302,235,537,186,467,782,263,519,0,0,0,86,0.293515358361775,2030,9.16256157635468
"1441",2021,"Eastern Washington",7,4,57.1,253,499,215,153,0,354,0,191,178,369,182,384,788,265,523,0,0,0,77,0.304347826086957,1637,11.1178985949908
"1442",2021,"Illinois State",14,8,57.1,169,436,216,145,0,256,1,199,188,387,123,244,519,198,321,0,0,0,59,0.349112426035503,1303,9.43975441289332
"1443",2021,"Northwestern",7,4,57.1,360,559,376,230,0,393,0,301,259,560,287,285,991,321,670,0,0,0,110,0.305555555555556,1924,14.9168399168399
"1444",2021,"Winthrop",7,4,57.1,285,587,237,149,0,363,3,177,151,328,136,414,921,261,660,0,0,0,88,0.308771929824561,1788,7.60626398210291
"1445",2021,"Wisconsin",7,4,57.1,301,588,290,187,0,387,4,288,265,553,120,396,775,246,529,0,0,0,113,0.375415282392027,1903,6.30583289542827
"1446",2022,"Bowling Green",7,4,57.1,310,768,381,247,0,505,2,421,381,802,275,465,956,368,588,0,0,0,104,0.335483870967742,2430,11.3168724279835
"1447",2022,"Eastern Washington",7,4,57.1,372,791,323,207,0,494,0,301,356,657,265,420,1188,353,835,0,0,0,113,0.303763440860215,2302,11.511728931364
"1448",2022,"Green Bay",7,4,57.1,325,706,240,174,0,406,0,265,284,549,190,371,1000,340,660,0,0,0,102,0.313846153846154,2067,9.19206579583938
"1449",2022,"Marquette",14,8,57.1,471,923,362,235,0,459,0,420,312,732,237,506,1279,458,821,0,0,0,153,0.32484076433121,2874,8.24634655532359
"1450",2023,"Bowling Green",7,4,57.1,491,931,482,318,0,653,3,632,560,1192,429,485,1271,432,839,0,0,0,150,0.305498981670061,3079,13.9330951607665
"1451",2024,"Dayton",14,8,57.1,504,771,326,216,0,547,4,381,289,670,187,562,1213,374,839,0,0,0,178,0.353174603174603,2683,6.96980991427507
"1452",2024,"Le Moyne",7,4,57.1,447,762,349,233,0,436,1,263,289,552,288,472,1267,411,856,0,0,0,124,0.277404921700224,2438,11.8129614438064
"1453",2024,"Portland State",7,4,57.1,341,635,271,176,0,460,2,238,197,435,217,486,1216,395,821,0,0,0,99,0.290322580645161,2149,10.0977198697068
"1454",2024,"Queens University",21,12,57.1,399,637,370,228,1,627,5,275,260,535,250,479,1182,369,813,0,0,0,127,0.318295739348371,2259,11.0668437361664
"1455",2024,"Wagner",14,8,57.1,360,630,340,213,0,528,1,237,266,503,271,573,1009,321,688,0,0,0,107,0.297222222222222,2200,12.3181818181818
"1456",2021,"Bellarmine",16,9,56.2,305,505,287,194,0,391,1,198,211,409,164,360,921,284,637,0,0,0,91,0.298360655737705,1717,9.55154338963308
"1457",2023,"Texas",16,9,56.2,574,890,518,319,1,680,4,457,329,786,326,547,1432,531,901,0,0,0,202,0.35191637630662,3120,10.4487179487179
"1458",2022,"Grand Canyon",25,14,56,483,692,389,249,0,618,2,374,363,737,379,520,1115,351,764,0,0,0,154,0.318840579710145,2508,15.1116427432217
"1459",2021,"IUPUI",9,5,55.6,283,543,274,174,0,300,0,204,169,373,156,316,747,298,449,0,0,0,108,0.381625441696113,1717,9.08561444379732
"1460",2021,"Idaho State",9,5,55.6,312,719,245,161,0,428,3,310,211,521,208,371,998,376,622,0,0,0,106,0.33974358974359,2141,9.71508640822046
"1461",2021,"Iowa State",9,5,55.6,314,795,313,242,0,402,1,359,272,631,135,388,1095,379,716,0,0,0,107,0.340764331210191,2317,5.82649978420371
"1462",2021,"Milwaukee",9,5,55.6,317,717,288,224,0,499,0,278,235,513,181,469,896,295,601,0,0,0,86,0.271293375394322,2141,8.45399346099953
"1463",2021,"Samford",9,5,55.6,195,396,158,107,0,222,0,180,146,326,122,257,595,213,382,0,0,0,60,0.307692307692308,1287,9.47940947940948
"1464",2022,"Jacksonville State",9,5,55.6,441,786,364,231,1,468,1,332,304,636,202,361,1227,395,832,0,0,0,157,0.356009070294785,2402,8.40965861781848
"1465",2023,"Loyola Chicago",9,5,55.6,333,643,306,207,0,452,1,280,343,623,217,438,1026,321,705,0,0,0,98,0.294294294294294,2094,10.3629417382999
"1466",2023,"Oklahoma",9,5,55.6,472,1002,440,304,0,666,1,530,378,908,257,554,1314,468,846,0,0,0,168,0.35593220338983,3143,8.17690104995227
"1467",2024,"San Francisco",9,5,55.6,467,768,375,237,0,451,2,375,368,743,194,443,1035,323,712,0,0,0,161,0.34475374732334,2480,7.82258064516129
"1468",2023,"Idaho",29,16,55.2,184,818,335,230,0,411,1,302,236,538,150,350,1164,402,762,0,0,0,63,0.342391304347826,2142,7.00280112044818
"1469",2021,"Green Bay",11,6,54.5,219,479,213,137,0,305,1,207,152,359,147,270,690,247,443,0,0,0,79,0.360730593607306,1472,9.98641304347826
"1470",2021,"SE Louisiana",11,6,54.5,193,476,245,152,0,328,2,217,178,395,158,300,608,239,369,0,0,0,61,0.316062176165803,1485,10.6397306397306
"1471",2022,"Oral Roberts",11,6,54.5,380,820,462,307,0,448,0,418,417,835,264,460,968,288,680,0,0,0,129,0.339473684210526,2489,10.6066693451185
"1472",2022,"South Dakota State",11,6,54.5,445,1015,403,272,0,496,0,548,378,926,262,487,1231,487,744,0,0,0,180,0.404494382022472,3101,8.44888745565946
"1473",2023,"Texas A&M",11,6,54.5,368,703,334,196,1,540,2,290,251,541,194,526,1032,321,711,0,0,0,123,0.334239130434783,2285,8.49015317286652
"1474",2023,"Western Illinois",11,6,54.5,361,755,456,310,0,536,2,342,435,777,255,423,989,284,705,0,0,0,117,0.32409972299169,2263,11.2682280159081
"1475",2024,"Chicago State",11,6,54.5,385,673,320,211,0,556,3,266,282,548,167,569,1084,333,751,0,0,0,127,0.32987012987013,2301,7.25771403737505
"1476",2024,"Northern Kentucky",11,6,54.5,344,719,403,256,0,485,1,300,277,577,176,435,1081,388,693,0,0,0,144,0.418604651162791,2280,7.71929824561404
"1477",2022,"Albany",13,7,53.8,407,753,296,185,0,430,0,352,363,715,260,544,949,329,620,0,0,0,144,0.353808353808354,2467,10.5391163356303
"1478",2022,"Oakland",13,7,53.8,441,710,352,219,0,515,2,309,296,605,223,460,1169,370,799,0,0,0,138,0.312925170068027,2367,9.42120828052387
"1479",2022,"UNC Asheville",13,7,53.8,415,795,372,226,0,548,2,305,252,557,237,492,1354,439,915,0,0,0,144,0.346987951807229,2532,9.36018957345972
"1480",2024,"Cal State Northridge",26,14,53.8,374,781,351,217,0,524,0,270,315,585,265,538,1167,337,830,0,0,0,112,0.299465240641711,2388,11.0971524288107
"1481",2024,"Fresno State",13,7,53.8,447,744,333,222,0,488,1,401,393,794,284,436,1158,375,783,0,0,0,158,0.353467561521253,2485,11.4285714285714
"1482",2024,"George Mason",13,7,53.8,521,764,408,273,1,494,2,330,303,633,276,391,1277,424,853,0,0,0,180,0.345489443378119,2532,10.9004739336493
"1483",2024,"Iona",13,7,53.8,296,734,257,174,0,425,1,235,257,492,169,490,1098,389,709,0,0,0,79,0.266891891891892,2209,7.65052059755545
"1484",2023,"NJIT",28,15,53.6,362,698,340,211,0,468,1,358,370,728,172,478,872,291,581,0,0,0,110,0.303867403314917,2264,7.59717314487632
"1485",2021,"Hawai'i",15,8,53.3,214,419,195,129,0,229,1,157,160,317,72,222,528,152,376,0,0,0,65,0.303738317757009,1208,5.96026490066225
"1486",2021,"South Alabama",15,8,53.3,291,545,271,154,0,323,1,253,234,487,186,361,723,206,517,0,0,0,97,0.333333333333333,1717,10.8328479906814
"1487",2022,"Nicholls",15,8,53.3,328,629,317,211,0,438,1,226,254,480,208,501,941,311,630,0,0,0,110,0.335365853658537,2070,10.048309178744
"1488",2022,"Siena",15,8,53.3,411,695,326,194,0,546,1,275,276,551,261,529,1139,352,787,0,0,0,113,0.274939172749392,2342,11.1443210930828
"1489",2023,"San Diego State",19,10,52.6,371,787,347,223,0,542,1,422,299,721,304,445,1098,376,722,0,0,0,122,0.328840970350404,2484,12.2383252818035
"1490",2024,"Oklahoma",19,10,52.6,477,970,397,257,0,591,1,508,398,906,287,530,1314,432,882,0,0,0,151,0.316561844863732,3022,9.49702183984116
"1491",2021,"Toledo",21,11,52.4,298,606,317,206,0,439,1,290,239,529,197,328,931,296,635,0,0,0,91,0.305369127516779,1887,10.4398516163222
"1492",2024,"Akron",23,12,52.2,394,717,320,213,0,451,1,337,360,697,178,473,989,315,674,0,0,0,120,0.304568527918782,2314,7.69230769230769
"1493",2024,"Minnesota",23,12,52.2,519,935,414,259,0,510,0,388,238,626,277,485,1632,555,1077,0,0,0,205,0.394990366088632,3002,9.2271818787475
"1494",2024,"Cal State Bakersfield",25,13,52,287,684,262,164,0,483,0,234,231,465,221,391,1236,388,848,0,0,0,81,0.282229965156794,2046,10.8015640273705
"1495",2024,"Bradley",27,14,51.9,300,771,342,226,0,510,1,279,229,508,175,523,1262,426,836,0,0,0,103,0.343333333333333,2396,7.30383973288815
"1496",2021,"Alabama A&M",2,1,50,174,291,150,91,0,196,0,142,98,240,64,159,433,135,298,0,0,0,68,0.390804597701149,936,6.83760683760684
"1497",2021,"American University",2,1,50,93,277,135,90,0,173,1,149,98,247,81,182,319,107,212,0,0,0,31,0.333333333333333,838,9.66587112171838
"1498",2021,"Arkansas-Pine Bluff",6,3,50,287,507,294,180,0,377,1,179,160,339,123,364,781,237,544,0,0,0,102,0.355400696864112,1640,7.5
"1499",2021,"BYU",6,3,50,262,600,204,136,0,364,2,275,155,430,169,326,867,309,558,0,0,0,96,0.366412213740458,1833,9.21985815602837
"1500",2021,"Belmont",20,10,50,328,565,232,152,0,413,0,316,190,506,259,333,971,334,637,0,0,0,129,0.393292682926829,1937,13.3711925658234
"1501",2021,"Cal State Bakersfield",6,3,50,186,381,191,124,0,291,2,178,162,340,135,253,584,189,395,0,0,0,58,0.311827956989247,1242,10.8695652173913
"1502",2021,"Cleveland State",10,5,50,271,595,350,212,0,381,0,245,220,465,225,360,851,268,583,0,0,0,84,0.309963099630996,1821,12.3558484349259
"1503",2021,"Detroit Mercy",2,1,50,157,301,179,120,1,294,0,113,127,240,122,273,520,157,363,0,0,0,54,0.343949044585987,1038,11.7533718689788
"1504",2021,"Fresno Pacific",2,1,50,33,83,34,21,1,42,0,24,51,75,15,61,108,33,75,0,0,0,9,0.272727272727273,240,6.25
"1505",2021,"Holy Cross",2,1,50,181,353,125,85,1,201,0,167,183,350,103,212,482,152,330,0,0,0,59,0.325966850828729,1097,9.38924339106654
"1506",2021,"Montana State",8,4,50,352,559,295,204,0,449,0,215,187,402,248,294,1034,356,678,0,0,0,124,0.352272727272727,1844,13.4490238611714
"1507",2021,"North Carolina A&T",4,2,50,151,261,111,74,0,169,0,153,123,276,115,156,396,117,279,0,0,0,45,0.298013245033113,864,13.3101851851852
"1508",2021,"Oral Roberts",8,4,50,243,547,312,193,0,426,0,196,242,438,150,349,846,260,586,0,0,0,80,0.329218106995885,1675,8.95522388059701
"1509",2021,"Penn State",12,6,50,344,619,250,161,0,370,0,316,283,599,184,371,967,333,634,0,0,0,125,0.363372093023256,2042,9.01077375122429
"1510",2021,"Rice",8,4,50,271,757,265,185,1,323,1,360,228,588,137,412,782,299,483,0,0,0,98,0.361623616236162,2172,6.30755064456722
"1511",2021,"Saint Louis",10,5,50,253,544,237,156,0,241,1,198,201,399,94,241,670,225,445,0,0,0,88,0.347826086956522,1520,6.18421052631579
"1512",2021,"South Dakota",6,3,50,323,662,346,228,0,436,1,286,173,459,198,284,1061,385,676,0,0,0,115,0.356037151702786,2022,9.79228486646884
"1513",2021,"South Dakota State",6,3,50,302,633,360,244,0,388,1,291,233,524,181,341,827,284,543,0,0,0,97,0.321192052980132,1936,9.34917355371901
"1514",2021,"UC Riverside",10,5,50,208,438,199,128,0,303,1,183,170,353,176,284,717,230,487,0,0,0,53,0.254807692307692,1385,12.7075812274368
"1515",2021,"UT Arlington",6,3,50,209,485,194,127,0,280,3,192,154,346,159,281,661,200,461,0,0,0,64,0.30622009569378,1403,11.3328581610834
"1516",2021,"UT Rio Grande Valley",8,4,50,254,520,240,147,0,336,2,188,181,369,108,321,734,229,505,0,0,0,72,0.283464566929134,1564,6.90537084398977
"1517",2021,"Valparaiso",18,9,50,217,591,301,195,0,462,1,281,285,566,245,363,828,261,567,0,0,0,62,0.285714285714286,1779,13.7717818999438
"1518",2021,"Western Illinois",8,4,50,280,633,349,219,1,430,0,225,212,437,184,408,990,340,650,0,0,0,92,0.328571428571429,1960,9.38775510204082
"1519",2021,"Young Harris College",2,1,50,8,15,11,9,0,15,0,8,17,25,12,11,39,13,26,0,0,0,2,0.25,59,20.3389830508475
"1520",2022,"Little Rock",16,8,50,381,665,273,172,0,475,2,285,212,497,208,423,1084,353,731,0,0,0,127,0.333333333333333,2183,9.52817224003665
"1521",2022,"Mercer",6,3,50,182,451,183,119,1,269,1,154,111,265,115,228,724,270,454,0,0,0,65,0.357142857142857,1335,8.61423220973783
"1522",2022,"Miami",14,7,50,399,814,343,219,0,561,2,377,312,689,301,547,1175,367,808,0,0,0,109,0.273182957393484,2593,11.6081758580794
"1523",2022,"Morehead State",6,3,50,294,616,233,146,0,479,1,241,269,510,192,482,1038,308,730,0,0,0,78,0.26530612244898,2000,9.6
"1524",2022,"North Carolina A&T",8,4,50,364,592,321,207,1,389,2,356,261,617,222,441,893,285,608,0,0,0,132,0.362637362637363,2134,10.4029990627929
"1525",2022,"Pikeville",2,1,50,24,52,26,15,2,35,0,16,20,36,12,41,63,16,47,0,0,0,7,0.291666666666667,155,7.74193548387097
"1526",2022,"Sacramento State",16,8,50,301,750,295,195,1,452,0,330,253,583,169,394,1068,385,683,0,0,0,107,0.355481727574751,2235,7.56152125279642
"1527",2022,"South Alabama",10,5,50,345,612,311,175,0,444,4,270,270,540,232,417,1037,302,735,0,0,0,122,0.353623188405797,2011,11.5365489806067
"1528",2022,"South Carolina State",2,1,50,181,403,160,92,0,250,0,105,119,224,81,343,627,163,464,0,0,0,46,0.25414364640884,1230,6.58536585365854
"1529",2022,"Southern Miss",24,12,50,481,782,394,246,0,561,0,396,288,684,256,501,1090,371,719,0,0,0,180,0.374220374220374,2632,9.72644376899696
"1530",2022,"Syracuse",4,2,50,372,670,242,178,1,440,6,358,295,653,294,422,1298,406,892,0,0,0,110,0.295698924731183,2277,12.9117259552042
"1531",2022,"Westminster (UT)",4,2,50,17,27,12,7,0,20,0,20,6,26,2,15,41,12,29,0,0,0,6,0.352941176470588,95,2.10526315789474
"1532",2023,"Anderson",2,1,50,16,26,11,7,0,11,0,13,5,18,8,8,50,15,35,0,0,0,6,0.375,82,9.75609756097561
"1533",2023,"Bradley",6,3,50,331,754,302,196,0,505,0,219,198,417,193,487,1362,456,906,0,0,0,104,0.314199395770393,2325,8.3010752688172
"1534",2023,"Colorado",12,6,50,473,888,414,263,0,613,3,535,426,961,324,520,1042,335,707,0,0,0,130,0.274841437632135,2851,11.364433532094
"1535",2023,"Florida Gulf Coast",2,1,50,358,935,369,239,0,541,1,570,337,907,327,456,1275,472,803,0,0,0,146,0.407821229050279,2889,11.318795430945
"1536",2023,"Jackson State",4,2,50,522,866,489,301,0,476,3,371,315,686,192,438,1035,344,691,0,0,0,200,0.383141762452107,2659,7.22075968409176
"1537",2023,"Kent State",18,9,50,347,814,355,251,0,539,1,381,361,742,213,418,1168,420,748,0,0,0,103,0.296829971181556,2473,8.61302062272543
"1538",2023,"Lafayette",4,2,50,288,698,250,161,0,406,1,211,231,442,187,421,1171,393,778,0,0,0,95,0.329861111111111,2075,9.01204819277108
"1539",2023,"Longwood",8,4,50,323,682,398,264,0,535,3,330,387,717,264,515,1030,302,728,0,0,0,101,0.312693498452012,2257,11.6969428444838
"1540",2023,"NW Nazarene",4,2,50,11,18,16,11,0,20,0,4,12,16,15,17,43,17,26,0,0,0,2,0.181818181818182,69,21.7391304347826
"1541",2023,"Northwestern",12,6,50,408,764,417,257,1,565,4,419,400,819,281,524,985,270,715,0,0,0,144,0.352941176470588,2489,11.2896745680996
"1542",2023,"Ohio State",6,3,50,407,896,535,351,0,639,3,571,360,931,407,494,1357,484,873,0,0,0,142,0.348894348894349,3015,13.4991708126036
"1543",2023,"Queens University",2,1,50,366,652,374,239,0,588,3,275,291,566,242,464,1145,332,813,0,0,0,96,0.262295081967213,2171,11.1469368954399
"1544",2023,"Robert Morris",8,4,50,338,718,343,221,0,560,1,294,333,627,252,426,1146,326,820,0,0,0,85,0.251479289940828,2178,11.5702479338843
"1545",2023,"Rust College",2,1,50,14,30,19,11,0,15,0,10,12,22,14,28,32,8,24,0,0,0,8,0.571428571428571,95,14.7368421052632
"1546",2023,"Utah Tech",14,7,50,301,877,329,218,0,482,1,339,260,599,239,476,1166,464,702,0,0,0,124,0.411960132890365,2554,9.35787000783085
"1547",2023,"Virginia Tech",8,4,50,432,992,426,290,0,548,3,378,234,612,190,489,1452,551,901,0,0,0,152,0.351851851851852,2960,6.41891891891892
"1548",2024,"Alabama A&M",20,10,50,513,776,406,256,0,509,1,257,259,516,249,542,1318,445,873,0,0,0,167,0.325536062378168,2625,9.48571428571429
"1549",2024,"Cincinnati",4,2,50,471,741,488,323,0,510,2,320,363,683,191,476,1007,287,720,0,0,0,148,0.314225053078556,2425,7.87628865979381
"1550",2024,"Cornell",14,7,50,305,605,304,196,0,482,2,275,315,590,165,421,862,268,594,0,0,0,88,0.288524590163934,1952,8.45286885245902
"1551",2024,"Dartmouth",12,6,50,273,630,202,127,0,281,0,173,218,391,144,416,945,301,644,0,0,0,88,0.322344322344322,1849,7.78799351000541
"1552",2024,"Detroit Mercy",22,11,50,399,892,367,239,1,515,1,304,289,593,197,605,1141,419,722,0,0,0,142,0.355889724310777,2715,7.25598526703499
"1553",2024,"Fairfield",12,6,50,401,849,319,207,0,622,1,464,293,757,303,561,1171,426,745,0,0,0,138,0.344139650872818,2782,10.8914450035945
"1554",2024,"Georgia State",14,7,50,449,777,422,278,0,543,6,406,338,744,284,467,1135,353,782,0,0,0,155,0.345211581291759,2575,11.0291262135922
"1555",2024,"Hampton",6,3,50,381,666,420,252,0,571,9,278,375,653,266,509,1006,286,720,0,0,0,118,0.309711286089239,2211,12.0307553143374
"1556",2024,"Hope International",2,1,50,20,31,6,3,0,15,0,4,5,9,9,13,62,18,44,0,0,0,3,0.15,87,10.3448275862069
"1557",2024,"Indiana",10,5,50,272,881,392,264,0,497,1,512,246,758,205,417,1101,421,680,0,0,0,92,0.338235294117647,2617,7.83339701948796
"1558",2024,"La Salle",16,8,50,400,686,280,168,0,508,1,168,191,359,263,494,1426,457,969,0,0,0,114,0.285,2276,11.5553602811951
"1559",2024,"Niagara",18,9,50,626,718,476,300,0,750,5,497,501,998,530,680,1411,419,992,0,0,0,196,0.313099041533546,3058,17.3315892740353
"1560",2024,"Richmond",12,6,50,289,899,355,261,0,455,1,460,305,765,202,475,1031,396,635,0,0,0,104,0.359861591695502,2615,7.72466539196941
"1561",2024,"San José State",14,7,50,402,702,262,178,0,547,1,350,317,667,252,613,979,324,655,0,0,0,127,0.31592039800995,2453,10.2731349368121
"1562",2024,"Siena",16,8,50,367,688,288,187,0,489,3,345,258,603,305,481,1128,378,750,0,0,0,110,0.299727520435967,2337,13.050919982884
"1563",2024,"South Carolina",8,4,50,540,1176,509,324,0,531,5,679,439,1118,318,481,1331,514,817,0,0,0,197,0.364814814814815,3535,8.995756718529
"1564",2024,"South Dakota State",6,3,50,409,950,462,302,0,465,0,481,331,812,193,485,1024,395,629,0,0,0,166,0.405867970660147,2858,6.75297410776767
"1565",2024,"UAlbany",12,6,50,404,731,341,226,0,403,0,305,292,597,227,479,1005,380,625,0,0,0,119,0.294554455445545,2395,9.47807933194155
"1566",2024,"UL Monroe",22,11,50,456,975,459,320,0,626,5,429,336,765,288,477,1472,488,984,0,0,0,160,0.350877192982456,2942,9.78925900747791
"1567",2024,"UT Arlington",14,7,50,429,868,456,293,1,599,4,433,385,818,251,489,1185,411,774,0,0,0,167,0.389277389277389,2743,9.15056507473569
"1568",2024,"Washington",18,9,50,383,787,265,168,0,408,3,361,292,653,212,413,1100,377,723,0,0,0,142,0.370757180156658,2392,8.8628762541806
"1569",2024,"Louisiana Tech",33,16,48.5,390,812,369,237,1,548,1,304,274,578,232,513,1245,446,799,0,0,0,135,0.346153846153846,2559,9.06604142243064
"1570",2022,"Utah State",31,15,48.4,440,802,371,248,0,456,9,365,353,718,211,503,1184,377,807,0,0,0,155,0.352272727272727,2581,8.17512592018597
"1571",2023,"Lehigh",25,12,48,285,869,302,223,0,424,0,262,226,488,194,450,1343,501,842,0,0,0,99,0.347368421052632,2424,8.003300330033
"1572",2024,"Grambling",25,12,48,558,808,451,297,1,628,1,301,307,608,341,562,1353,466,887,0,0,0,164,0.293906810035842,2791,12.2178430670011
"1573",2023,"Bethune-Cookman",23,11,47.8,465,625,463,279,0,488,0,260,275,535,271,456,1053,319,734,0,0,0,162,0.348387096774194,2239,12.1036176864672
"1574",2024,"North Alabama",23,11,47.8,322,741,333,219,0,501,4,382,317,699,199,520,997,332,665,0,0,0,104,0.322981366459627,2380,8.36134453781512
"1575",2023,"Cal State Northridge",21,10,47.6,357,737,351,235,0,618,1,277,265,542,220,519,1045,352,693,0,0,0,108,0.302521008403361,2327,9.45423291792007
"1576",2023,"Southern Illinois",21,10,47.6,406,742,408,260,0,649,5,488,364,852,307,454,1142,373,769,0,0,0,146,0.359605911330049,2569,11.950175165434
"1577",2023,"St. Francis Brooklyn",21,10,47.6,386,743,334,210,0,436,0,250,264,514,171,499,1057,347,710,0,0,0,109,0.282383419689119,2306,7.41543798785776
"1578",2021,"Clemson",19,9,47.4,365,609,317,190,0,430,1,270,219,489,180,400,980,343,637,0,0,0,113,0.30958904109589,2079,8.65800865800866
"1579",2021,"Florida International",19,9,47.4,433,730,386,238,0,528,3,398,343,741,214,481,1022,344,678,0,0,0,148,0.341801385681293,2485,8.61167002012072
"1580",2022,"SMU",19,9,47.4,395,781,336,208,0,440,1,275,282,557,211,415,1182,400,782,0,0,0,131,0.331645569620253,2349,8.98254576415496
"1581",2022,"St. Bonaventure",19,9,47.4,256,710,326,209,0,420,1,307,302,609,166,420,916,290,626,0,0,0,78,0.3046875,2064,8.04263565891473
"1582",2022,"Western Kentucky",19,9,47.4,469,712,471,283,0,538,0,371,291,662,281,540,1080,351,729,0,0,0,155,0.330490405117271,2562,10.967993754879
"1583",2023,"Arizona",19,9,47.4,441,791,431,272,0,596,5,468,372,840,339,399,1194,421,773,0,0,0,157,0.356009070294785,2627,12.9044537495242
"1584",2023,"La Salle",19,9,47.4,392,752,325,219,0,490,1,265,235,500,277,513,1283,412,871,0,0,0,127,0.323979591836735,2401,11.5368596418159
"1585",2024,"Rider",19,9,47.4,281,751,313,200,0,469,1,289,301,590,198,553,1008,328,680,0,0,0,65,0.231316725978648,2278,8.6918349429324
"1586",2024,"Vermont",19,9,47.4,353,887,298,194,0,474,0,354,269,623,196,454,1307,502,805,0,0,0,125,0.354107648725212,2627,7.46098210886943
"1587",2022,"UMBC",17,8,47.1,299,556,250,169,0,388,0,251,309,560,201,435,844,266,578,0,0,0,84,0.280936454849498,1862,10.7948442534909
"1588",2024,"Drexel",17,8,47.1,406,748,257,170,0,466,2,320,278,598,235,460,1311,444,867,0,0,0,118,0.29064039408867,2439,9.63509635096351
"1589",2024,"Illinois State",17,8,47.1,353,968,492,344,0,519,1,424,331,755,150,483,1133,415,718,0,0,0,147,0.41643059490085,2776,5.40345821325648
"1590",2024,"Southern Indiana",17,8,47.1,398,928,372,256,0,594,0,375,308,683,225,523,1188,466,722,0,0,0,151,0.379396984924623,2778,8.09935205183585
"1591",2021,"Georgia Southern",15,7,46.7,369,602,315,210,0,430,1,304,251,555,218,456,811,248,563,0,0,0,132,0.357723577235772,2062,10.5722599418041
"1592",2021,"UC Santa Barbara",15,7,46.7,201,497,202,145,0,275,0,167,136,303,86,278,782,278,504,0,0,0,66,0.328358208955224,1475,5.83050847457627
"1593",2022,"Louisiana",15,7,46.7,269,689,352,223,0,398,2,311,180,491,180,362,895,320,575,0,0,0,113,0.420074349442379,2039,8.82785679254537
"1594",2022,"Missouri",15,7,46.7,319,863,359,237,1,491,3,365,248,613,175,458,1131,424,707,0,0,0,120,0.376175548589342,2517,6.95272149384188
"1595",2022,"UT Arlington",15,7,46.7,338,761,439,279,0,463,2,440,286,726,221,392,959,282,677,0,0,0,129,0.381656804733728,2331,9.48090948090948
"1596",2024,"Houston",15,7,46.7,455,655,366,247,0,568,2,345,282,627,335,463,1309,380,929,0,0,0,152,0.334065934065934,2384,14.0520134228188
"1597",2024,"Liberty",15,7,46.7,454,868,312,205,1,540,0,374,286,660,151,494,1148,397,751,0,0,0,168,0.370044052863436,2664,5.66816816816817
"1598",2024,"Tennessee State",30,14,46.7,470,663,389,246,0,564,1,317,329,646,299,561,1176,383,793,0,0,0,168,0.357446808510638,2482,12.0467365028203
"1599",2022,"Colgate",28,13,46.4,311,688,222,153,0,467,2,236,232,468,170,498,1149,382,767,0,0,0,102,0.327974276527331,2169,7.8377132319041
"1600",2023,"Miami (OH)",28,13,46.4,370,774,408,285,0,534,2,318,235,553,193,475,1194,433,761,0,0,0,134,0.362162162162162,2471,7.81060299473897
"1601",2021,"Cal State Fullerton",13,6,46.2,237,544,236,141,0,357,5,228,178,406,156,422,753,227,526,0,0,0,65,0.274261603375527,1712,9.11214953271028
"1602",2021,"New Orleans",13,6,46.2,220,439,256,163,1,419,1,170,191,361,164,405,705,210,495,0,0,0,62,0.281818181818182,1511,10.8537392455328
"1603",2022,"American University",13,6,46.2,298,760,344,224,0,493,0,431,319,750,267,507,963,286,677,0,0,0,107,0.359060402684564,2380,11.218487394958
"1604",2022,"Brown",13,6,46.2,273,658,237,149,0,398,0,215,195,410,255,444,1073,332,741,0,0,0,81,0.296703296703297,1983,12.8593040847201
"1605",2022,"Buffalo",26,12,46.2,515,946,427,289,3,480,7,471,337,808,327,479,1425,483,942,0,0,0,157,0.304854368932039,2995,10.9181969949917
"1606",2022,"Kentucky",13,6,46.2,437,768,364,239,0,499,3,428,291,719,247,433,1239,415,824,0,0,0,160,0.366132723112128,2576,9.58850931677019
"1607",2022,"Nevada",26,12,46.2,374,703,272,200,0,480,1,323,283,606,262,374,1199,409,790,0,0,0,112,0.299465240641711,2248,11.6548042704626
"1608",2022,"St. John's",26,12,46.2,305,794,324,225,0,413,3,431,337,768,173,451,1137,390,747,0,0,0,94,0.308196721311475,2454,7.04971475142624
"1609",2022,"Utah",13,6,46.2,468,853,409,289,1,537,7,476,402,878,218,498,1091,385,706,0,0,0,165,0.352564102564103,2763,7.88997466521896
"1610",2023,"Drake",13,6,46.2,382,993,425,282,0,463,2,560,318,878,241,541,970,326,644,0,0,0,134,0.350785340314136,2902,8.30461750516885
"1611",2023,"Ohio",13,6,46.2,280,697,318,218,1,530,3,341,345,686,235,491,931,294,637,0,0,0,90,0.321428571428571,2186,10.7502287282708
"1612",2023,"Providence",13,6,46.2,336,867,366,225,0,389,0,385,409,794,197,462,1035,351,684,0,0,0,97,0.288690476190476,2489,7.91482523101647
"1613",2024,"Boston College",13,6,46.2,529,687,429,270,0,583,1,516,392,908,377,497,1141,351,790,0,0,0,180,0.340264650283554,2691,14.0096618357488
"1614",2024,"Gardner-Webb",13,6,46.2,317,619,248,157,0,520,6,239,229,468,141,473,1106,345,761,0,0,0,104,0.32807570977918,2057,6.85464268351969
"1615",2024,"Lamar",13,6,46.2,422,729,367,245,0,474,2,357,263,620,249,396,1086,359,727,0,0,0,150,0.355450236966825,2345,10.6183368869936
"1616",2024,"Texas A&M-Corpus Christi",13,6,46.2,397,851,493,318,0,497,1,420,395,815,348,513,982,294,688,0,0,0,133,0.335012594458438,2599,13.389765294344
"1617",2021,"Southeast Missouri State",24,11,45.8,372,635,305,203,0,390,2,285,227,512,197,377,959,312,647,0,0,0,124,0.333333333333333,2061,9.55846676370694
"1618",2022,"Hartford",24,11,45.8,375,718,272,158,1,494,0,239,241,480,211,623,1178,366,812,0,0,0,101,0.269333333333333,2386,8.84325230511316
"1619",2023,"North Dakota",24,11,45.8,442,824,432,299,0,593,3,414,402,816,291,468,1187,430,757,0,0,0,144,0.32579185520362,2672,10.8907185628743
"1620",2024,"Jacksonville",24,11,45.8,420,703,519,334,0,614,8,344,354,698,262,626,915,307,608,0,0,0,139,0.330952380952381,2521,10.3927013090044
"1621",2021,"Colorado",11,5,45.5,277,551,307,187,0,380,2,268,225,493,196,343,735,252,483,0,0,0,96,0.346570397111913,1769,11.079706048615
"1622",2021,"Howard",11,5,45.5,309,550,391,239,0,379,1,205,181,386,166,355,763,221,542,0,0,0,86,0.27831715210356,1734,9.57324106113033
"1623",2021,"Louisville",11,5,45.5,339,791,271,197,0,481,1,360,198,558,210,348,1258,478,780,0,0,0,113,0.333333333333333,2392,8.77926421404682
"1624",2021,"Ohio State",11,5,45.5,268,555,313,206,0,367,3,341,246,587,176,251,743,239,504,0,0,0,84,0.313432835820896,1741,10.1091326823665
"1625",2021,"UIC",11,5,45.5,241,419,294,161,0,358,2,157,169,326,188,375,725,261,464,0,0,0,87,0.360995850622407,1524,12.3359580052493
"1626",2021,"Wright State",22,10,45.5,503,731,405,228,0,496,4,298,259,557,211,388,1040,335,705,0,0,0,182,0.36182902584493,2359,8.9444679949131
"1627",2022,"Dayton",11,5,45.5,408,823,348,215,1,436,3,298,261,559,168,354,1118,380,738,0,0,0,139,0.340686274509804,2344,7.16723549488055
"1628",2022,"Georgetown",11,5,45.5,404,749,327,208,0,488,0,312,260,572,233,526,1096,330,766,0,0,0,154,0.381188118811881,2408,9.67607973421927
"1629",2022,"Maryland",11,5,45.5,522,782,429,299,1,483,5,470,333,803,297,404,1297,451,846,0,0,0,207,0.396551724137931,2753,10.7882310207047
"1630",2022,"Monmouth",22,10,45.5,367,789,296,181,0,478,1,318,328,646,215,574,1103,342,761,0,0,0,113,0.307901907356948,2459,8.74339162261082
"1631",2022,"Pennsylvania",11,5,45.5,377,680,277,182,0,375,0,280,268,548,203,366,992,306,686,0,0,0,121,0.320954907161804,2076,9.77842003853565
"1632",2023,"Coastal Carolina",11,5,45.5,387,750,436,300,0,528,1,369,334,703,258,523,1020,339,681,0,0,0,113,0.291989664082687,2470,10.4453441295547
"1633",2023,"Creighton",22,10,45.5,325,807,256,176,0,484,1,350,206,556,199,362,1281,469,812,0,0,0,104,0.32,2376,8.37542087542088
"1634",2023,"Mississippi Valley State",11,5,45.5,304,552,283,163,0,395,0,167,207,374,157,443,962,301,661,0,0,0,82,0.269736842105263,1825,8.6027397260274
"1635",2023,"South Dakota",22,10,45.5,320,782,379,267,0,516,0,377,384,761,196,418,942,332,610,0,0,0,100,0.3125,2323,8.437365475678
"1636",2023,"Tulsa",11,5,45.5,289,851,313,208,0,507,3,340,254,594,180,450,1177,390,787,0,0,0,93,0.321799307958477,2393,7.52193898871709
"1637",2024,"Maine",11,5,45.5,470,848,295,201,0,489,0,394,371,765,245,428,1237,416,821,0,0,0,152,0.323404255319149,2631,9.31204865070315
"1638",2024,"Manhattan",22,10,45.5,350,732,268,188,0,386,0,270,240,510,176,481,1090,361,729,0,0,0,100,0.285714285714286,2258,7.79450841452613
"1639",2024,"Rhode Island",22,10,45.5,554,863,419,253,0,519,1,395,380,775,274,497,1294,448,846,0,0,0,172,0.310469314079422,2866,9.56036287508723
"1640",2024,"Stephen F. Austin",22,10,45.5,478,902,471,323,0,560,2,458,349,807,332,510,1293,431,862,0,0,0,193,0.403765690376569,2902,11.4403859407305
"1641",2024,"Western Illinois",11,5,45.5,405,895,467,323,0,539,0,351,293,644,212,478,1151,409,742,0,0,0,142,0.350617283950617,2645,8.01512287334594
"1642",2024,"Chattanooga",20,9,45,267,788,357,255,0,496,1,271,229,500,182,378,1064,438,626,0,0,0,105,0.393258426966292,2234,8.1468218442256
"1643",2024,"Miami (OH)",20,9,45,306,683,259,166,0,495,3,271,246,517,247,547,1029,309,720,0,0,0,88,0.287581699346405,2179,11.3354749885268
"1644",2024,"Texas A&M-Commerce",20,9,45,325,875,352,230,0,474,7,317,362,679,219,410,1274,429,845,0,0,0,101,0.310769230769231,2432,9.00493421052632
"1645",2021,"UTSA",9,4,44.4,294,385,234,139,0,316,1,179,162,341,131,264,707,205,502,0,0,0,104,0.353741496598639,1382,9.47901591895803
"1646",2021,"Wagner",9,4,44.4,197,475,196,119,0,338,0,204,206,410,167,342,655,227,428,0,0,0,61,0.309644670050761,1491,11.2005365526492
"1647",2022,"Cornell",9,4,44.4,369,557,286,164,0,405,2,217,220,437,176,446,885,251,634,0,0,0,106,0.287262872628726,1891,9.30724484399788
"1648",2022,"Princeton",9,4,44.4,405,752,300,209,0,463,0,303,284,587,288,386,1193,434,759,0,0,0,126,0.311111111111111,2369,12.1570282819755
"1649",2022,"Rhode Island",9,4,44.4,398,803,312,193,0,365,3,373,319,692,225,412,954,329,625,0,0,0,128,0.321608040201005,2390,9.41422594142259
"1650",2023,"Dartmouth",9,4,44.4,336,622,278,170,0,469,0,213,281,494,201,492,994,308,686,0,0,0,92,0.273809523809524,2047,9.81924767953102
"1651",2023,"Georgia",9,4,44.4,433,745,394,257,0,516,5,355,233,588,311,492,1152,407,745,0,0,0,155,0.35796766743649,2531,12.2876333465034
"1652",2023,"St. John's",9,4,44.4,360,772,349,244,0,407,4,354,294,648,169,448,1082,401,681,0,0,0,118,0.327777777777778,2429,6.95759571840263
"1653",2023,"Texas A&M-Commerce",18,8,44.4,511,865,553,344,0,507,3,439,435,874,276,559,1052,330,722,0,0,0,192,0.37573385518591,2834,9.73888496824277
"1654",2024,"Colgate",27,12,44.4,365,858,369,249,1,481,1,333,303,636,199,458,1193,454,739,0,0,0,139,0.380821917808219,2567,7.75223996883522
"1655",2024,"Denver",9,4,44.4,328,714,348,222,0,501,1,221,210,431,191,415,1233,447,786,0,0,0,111,0.338414634146341,2202,8.67393278837421
"1656",2024,"New Hampshire",18,8,44.4,418,625,262,172,0,477,3,244,274,518,276,484,1106,346,760,0,0,0,114,0.272727272727273,2184,12.6373626373626
"1657",2024,"Notre Dame",18,8,44.4,460,933,432,309,0,536,1,537,335,872,380,471,1337,467,870,0,0,0,149,0.323913043478261,2988,12.7175368139224
"1658",2022,"Air Force",25,11,44,476,730,330,220,0,585,2,302,320,622,362,439,1404,464,940,0,0,0,183,0.384453781512605,2483,14.5791381393476
"1659",2024,"Fordham",25,11,44,436,698,282,171,0,461,0,338,354,692,281,474,1048,363,685,0,0,0,145,0.33256880733945,2385,11.7819706498952
"1660",2022,"UC Irvine",16,7,43.8,458,815,399,274,0,564,0,346,358,704,307,460,1285,417,868,0,0,0,129,0.281659388646288,2592,11.8441358024691
"1661",2022,"Valparaiso",16,7,43.8,180,697,296,202,0,503,1,338,313,651,231,478,849,287,562,0,0,0,51,0.283333333333333,2046,11.2903225806452
"1662",2022,"Washington State",16,7,43.8,380,731,264,170,0,471,4,343,315,658,231,421,1082,327,755,0,0,0,118,0.310526315789474,2280,10.1315789473684
"1663",2023,"San Francisco",16,7,43.8,452,857,374,249,1,555,1,401,408,809,252,454,1196,383,813,0,0,0,135,0.298672566371681,2643,9.53461975028377
"1664",2024,"Kent State",16,7,43.8,417,896,380,253,1,481,1,425,345,770,238,432,1220,417,803,0,0,0,152,0.364508393285372,2684,8.86736214605067
"1665",2024,"Saint Mary's",16,7,43.8,286,674,294,199,0,503,0,345,263,608,258,491,998,357,641,0,0,0,104,0.363636363636364,2223,11.6059379217274
"1666",2024,"Santa Clara",16,7,43.8,443,863,321,239,0,489,1,411,370,781,225,457,1213,445,768,0,0,0,153,0.345372460496614,2702,8.32716506291636
"1667",2021,"Miami (OH)",23,10,43.5,336,573,242,166,0,508,2,231,167,398,200,456,1057,353,704,0,0,0,116,0.345238095238095,2016,9.92063492063492
"1668",2022,"Binghamton",23,10,43.5,290,722,248,165,0,443,1,198,187,385,193,447,1173,421,752,0,0,0,97,0.33448275862069,2134,9.04404873477038
"1669",2024,"Incarnate Word",23,10,43.5,436,713,364,245,0,459,0,306,291,597,201,399,1036,308,728,0,0,0,131,0.30045871559633,2257,8.90562693841382
"1670",2024,"North Texas",23,10,43.5,422,911,540,335,0,502,7,501,330,831,254,542,1028,357,671,0,0,0,142,0.336492890995261,2855,8.89667250437828
"1671",2022,"Florida",30,13,43.3,414,862,384,259,0,622,4,395,372,767,278,538,1210,405,805,0,0,0,111,0.268115942028986,2707,10.2696712227558
"1672",2024,"Eastern Illinois",30,13,43.3,441,891,381,253,0,491,1,375,270,645,235,584,1318,428,890,0,0,0,142,0.321995464852608,2811,8.36001422981145
"1673",2021,"Cal Poly",21,9,42.9,324,599,184,127,0,426,1,211,180,391,179,361,982,342,640,0,0,0,98,0.302469135802469,1890,9.47089947089947
"1674",2021,"Creighton",21,9,42.9,149,437,135,96,0,239,0,145,128,273,84,243,625,208,417,0,0,0,49,0.328859060402685,1216,6.90789473684211
"1675",2021,"Hofstra",7,3,42.9,340,477,296,171,0,369,3,264,282,546,192,361,587,170,417,0,0,0,119,0.35,1686,11.3879003558719
"1676",2021,"Idaho",7,3,42.9,320,698,310,206,0,300,0,273,250,523,144,284,1033,335,698,0,0,0,109,0.340625,1973,7.29853015712114
"1677",2021,"Lehigh",7,3,42.9,152,464,148,106,0,210,0,145,140,285,90,201,724,256,468,0,0,0,58,0.381578947368421,1253,7.18276137270551
"1678",2021,"Maryland",7,3,42.9,424,708,362,264,0,419,1,466,254,720,242,310,1090,435,655,0,0,0,153,0.360849056603774,2429,9.9629477151091
"1679",2021,"Morehead State",14,6,42.9,286,530,287,196,0,393,0,216,225,441,165,381,791,219,572,0,0,0,71,0.248251748251748,1690,9.76331360946746
"1680",2021,"North Alabama",7,3,42.9,255,605,314,205,0,434,2,339,280,619,175,425,770,234,536,0,0,0,91,0.356862745098039,1928,9.07676348547718
"1681",2021,"Northern Illinois",14,6,42.9,323,697,322,215,0,405,1,292,294,586,138,437,832,314,518,0,0,0,115,0.356037151702786,2142,6.44257703081232
"1682",2021,"Northern Iowa",14,6,42.9,332,722,336,234,0,439,1,294,214,508,194,403,1089,353,736,0,0,0,117,0.352409638554217,2179,8.90316659017898
"1683",2021,"Robert Morris",7,3,42.9,151,341,128,77,0,314,0,148,140,288,125,215,612,181,431,0,0,0,40,0.264900662251656,1060,11.7924528301887
"1684",2021,"St. Francis Brooklyn",14,6,42.9,180,332,169,105,0,223,0,169,220,389,127,232,448,161,287,0,0,0,49,0.272222222222222,1109,11.4517583408476
"1685",2021,"Temple",7,3,42.9,282,504,282,173,0,329,2,239,240,479,175,347,663,197,466,0,0,0,81,0.287234042553192,1635,10.7033639143731
"1686",2021,"Tulsa",7,3,42.9,234,429,196,117,0,286,0,154,223,377,182,233,725,224,501,0,0,0,65,0.277777777777778,1321,13.777441332324
"1687",2022,"Robert Morris",7,3,42.9,282,603,232,138,0,478,1,222,224,446,232,427,1073,350,723,0,0,0,65,0.230496453900709,1938,11.9711042311661
"1688",2022,"South Dakota",7,3,42.9,338,815,342,234,0,503,0,382,253,635,293,349,1308,476,832,0,0,0,118,0.349112426035503,2452,11.9494290375204
"1689",2023,"American University",21,9,42.9,273,710,303,200,0,575,1,327,317,644,245,559,999,333,666,0,0,0,75,0.274725274725275,2272,10.7834507042254
"1690",2023,"Harvard",21,9,42.9,383,773,327,213,0,563,1,440,308,748,265,478,1165,416,749,0,0,0,132,0.344647519582245,2575,10.2912621359223
"1691",2023,"Long Island University",21,9,42.9,324,695,283,184,0,571,1,181,198,379,267,550,1220,414,806,0,0,0,90,0.277777777777778,2232,11.9623655913978
"1692",2023,"Memphis",21,9,42.9,634,888,527,321,0,564,12,375,384,759,259,475,1299,409,890,0,0,0,207,0.326498422712934,2907,8.90952872377021
"1693",2023,"NC State",7,3,42.9,359,928,387,252,0,438,0,416,291,707,218,425,1252,436,816,0,0,0,135,0.376044568245125,2677,8.14344415390362
"1694",2023,"Southern",14,6,42.9,392,652,388,211,0,593,0,223,260,483,248,428,1147,392,755,0,0,0,122,0.311224489795918,2185,11.350114416476
"1695",2023,"Toledo",14,6,42.9,341,960,454,325,1,507,1,450,309,759,227,420,1171,418,753,0,0,0,123,0.360703812316716,2707,8.38566678980421
"1696",2024,"BYU",14,6,42.9,387,937,398,232,0,562,2,367,317,684,184,558,1145,425,720,0,0,0,122,0.315245478036176,2751,6.68847691748455
"1697",2024,"Bethune-Cookman",35,15,42.9,560,765,504,309,0,520,1,294,331,625,335,482,1246,431,815,0,0,0,202,0.360714285714286,2651,12.6367408525085
"1698",2024,"Buffalo",14,6,42.9,343,868,398,270,0,604,3,433,442,875,233,455,1026,355,671,0,0,0,106,0.309037900874636,2549,9.14083954491958
"1699",2024,"Central Michigan",21,9,42.9,418,792,330,197,0,500,3,335,313,648,175,586,1009,303,706,0,0,0,122,0.291866028708134,2509,6.97489039457951
"1700",2024,"Grand Canyon",28,12,42.9,390,767,344,230,0,514,2,465,347,812,309,466,988,340,648,0,0,0,132,0.338461538461538,2504,12.3402555910543
"1701",2024,"Mercer",42,18,42.9,514,777,312,215,0,537,0,319,310,629,246,459,1378,464,914,0,0,0,172,0.334630350194553,2598,9.46882217090069
"1702",2024,"Missouri State",28,12,42.9,439,775,412,264,0,603,2,416,247,663,275,473,1326,449,877,0,0,0,147,0.334851936218679,2648,10.3851963746224
"1703",2022,"Manhattan",33,14,42.4,535,939,403,262,0,496,2,402,348,750,255,583,1214,387,827,0,0,0,183,0.342056074766355,2944,8.6616847826087
"1704",2023,"Monmouth",26,11,42.3,455,888,369,238,0,497,0,368,338,706,205,589,1193,413,780,0,0,0,157,0.345054945054945,2805,7.30837789661319
"1705",2023,"Portland State",26,11,42.3,340,697,280,190,1,448,1,259,263,522,249,417,1203,415,788,0,0,0,123,0.361764705882353,2207,11.2822836429542
"1706",2021,"Kansas City",19,8,42.1,222,482,208,139,0,422,1,191,146,337,144,321,809,295,514,0,0,0,76,0.342342342342342,1555,9.2604501607717
"1707",2021,"Oakland",19,8,42.1,342,551,365,225,0,469,2,295,224,519,192,358,963,299,664,0,0,0,118,0.345029239766082,1936,9.91735537190083
"1708",2021,"Villanova",19,8,42.1,230,506,167,116,0,318,0,233,177,410,127,278,747,256,491,0,0,0,70,0.304347826086957,1554,8.17245817245817
"1709",2022,"Boston College",19,8,42.1,487,822,425,271,0,542,1,524,338,862,273,605,1120,367,753,0,0,0,162,0.33264887063655,2923,9.33971946630174
"1710",2022,"Marist",19,8,42.1,335,698,310,193,0,383,1,264,301,565,245,451,1059,293,766,0,0,0,88,0.262686567164179,2124,11.5348399246704
"1711",2022,"Oklahoma State",19,8,42.1,427,714,370,212,0,467,1,281,302,583,262,420,1186,329,857,0,0,0,127,0.297423887587822,2257,11.6083296411165
"1712",2022,"Saint Joseph's",19,8,42.1,382,703,292,197,0,443,0,303,258,561,192,457,1019,327,692,0,0,0,123,0.321989528795811,2237,8.58292355833706
"1713",2022,"St. Francis (PA)",19,8,42.1,389,754,293,187,0,446,1,300,298,598,144,544,985,309,676,0,0,0,114,0.29305912596401,2368,6.08108108108108
"1714",2022,"UMass Lowell",19,8,42.1,300,579,275,173,0,438,5,252,264,516,190,471,869,280,589,0,0,0,80,0.266666666666667,1947,9.75860297894196
"1715",2022,"UT Rio Grande Valley",19,8,42.1,400,830,309,199,1,601,2,313,352,665,267,603,1218,415,803,0,0,0,106,0.265,2638,10.1213040181956
"1716",2023,"Illinois State",19,8,42.1,408,794,415,277,0,526,0,315,282,597,185,382,1252,454,798,0,0,0,146,0.357843137254902,2456,7.53257328990228
"1717",2023,"Merrimack",19,8,42.1,409,678,312,200,0,463,3,315,336,651,206,468,1046,334,712,0,0,0,112,0.273838630806846,2275,9.05494505494505
"1718",2023,"Quinnipiac",19,8,42.1,360,810,382,246,0,502,1,352,303,655,239,524,967,315,652,0,0,0,112,0.311111111111111,2468,9.6839546191248
"1719",2023,"UAB",19,8,42.1,310,851,390,273,0,581,2,407,311,718,155,478,1065,344,721,0,0,0,89,0.287096774193548,2485,6.2374245472837
"1720",2024,"Lafayette",19,8,42.1,252,675,216,138,0,371,1,227,201,428,163,421,1009,359,650,0,0,0,83,0.329365079365079,1988,8.19919517102616
"1721",2024,"Oakland",19,8,42.1,540,632,480,295,0,585,3,342,336,678,351,430,1202,381,821,0,0,0,176,0.325925925925926,2449,14.3323805634953
"1722",2024,"Omaha",19,8,42.1,344,671,522,350,0,547,1,256,279,535,224,438,1134,429,705,0,0,0,147,0.427325581395349,2274,9.8504837291117
"1723",2023,"Tennessee State",31,13,41.9,445,645,444,274,0,539,7,365,269,634,294,550,1072,336,736,0,0,0,160,0.359550561797753,2444,12.0294599018003
"1724",2021,"East Carolina",12,5,41.7,368,434,283,165,0,442,1,252,245,497,260,348,879,239,640,0,0,0,118,0.320652173913043,1710,15.2046783625731
"1725",2021,"Longwood",12,5,41.7,348,622,280,199,0,443,1,356,289,645,187,345,898,255,643,0,0,0,122,0.350574712643678,1994,9.37813440320963
"1726",2021,"NC State",12,5,41.7,260,739,282,199,0,321,1,345,200,545,155,313,912,333,579,0,0,0,88,0.338461538461538,2079,7.45550745550746
"1727",2021,"North Dakota State",12,5,41.7,304,613,317,224,0,489,1,190,190,380,148,392,955,376,579,0,0,0,100,0.328947368421053,1941,7.62493560020608
"1728",2021,"Oklahoma State",12,5,41.7,339,762,301,189,0,375,0,334,254,588,243,364,1130,405,725,0,0,0,122,0.359882005899705,2291,10.606721955478
"1729",2022,"Cal Poly",12,5,41.7,326,666,273,165,0,466,1,285,292,577,149,398,927,264,663,0,0,0,99,0.303680981595092,2009,7.41662518666003
"1730",2022,"Furman",12,5,41.7,485,714,352,242,0,402,2,304,317,621,184,419,1028,316,712,0,0,0,152,0.31340206185567,2330,7.89699570815451
"1731",2022,"North Carolina",12,5,41.7,436,861,426,279,0,468,2,406,279,685,284,417,1247,391,856,0,0,0,127,0.291284403669725,2620,10.8396946564885
"1732",2022,"Ohio",12,5,41.7,426,772,397,249,0,484,1,422,395,817,291,397,1117,360,757,0,0,0,132,0.309859154929577,2470,11.7813765182186
"1733",2022,"Radford",12,5,41.7,316,751,266,164,0,535,2,305,242,547,172,565,1043,330,713,0,0,0,88,0.278481012658228,2339,7.35356990166738
"1734",2022,"Saint Peter's",12,5,41.7,493,804,401,260,1,568,1,326,382,708,278,609,1064,319,745,0,0,0,151,0.306288032454361,2645,10.5103969754253
"1735",2023,"Appalachian State",24,10,41.7,431,770,440,271,0,591,0,380,391,771,272,487,1120,352,768,0,0,0,144,0.334106728538283,2537,10.7213243988963
"1736",2023,"Bryant",12,5,41.7,355,707,287,191,0,423,0,335,371,706,231,448,949,297,652,0,0,0,100,0.28169014084507,2214,10.4336043360434
"1737",2023,"Butler",12,5,41.7,288,705,274,183,0,388,2,305,272,577,166,482,999,358,641,0,0,0,82,0.284722222222222,2206,7.52493200362647
"1738",2023,"George Washington",12,5,41.7,439,731,272,174,0,468,1,304,352,656,200,388,1128,368,760,0,0,0,123,0.280182232346241,2309,8.6617583369424
"1739",2023,"Michigan",12,5,41.7,385,840,419,298,0,486,3,453,294,747,242,532,1143,426,717,0,0,0,142,0.368831168831169,2744,8.81924198250729
"1740",2023,"Northwestern State",12,5,41.7,353,725,331,212,0,490,6,251,294,545,210,497,1178,365,813,0,0,0,94,0.26628895184136,2266,9.26743159752868
"1741",2023,"SIU Edwardsville",12,5,41.7,431,734,421,284,0,627,1,310,294,604,234,631,1213,374,839,0,0,0,136,0.31554524361949,2579,9.07328421868941
"1742",2023,"Samford",24,10,41.7,355,753,349,219,0,466,1,366,230,596,214,479,1011,340,671,0,0,0,121,0.340845070422535,2393,8.94274968658588
"1743",2023,"Southeast Missouri State",12,5,41.7,425,697,405,266,0,606,1,352,355,707,318,546,1016,306,710,0,0,0,149,0.350588235294118,2426,13.1079967023908
"1744",2023,"Wagner",12,5,41.7,345,602,355,222,0,541,2,277,259,536,263,419,1128,386,742,0,0,0,115,0.333333333333333,2108,12.4762808349146
"1745",2024,"Army",12,5,41.7,397,626,310,208,0,498,0,289,339,628,255,417,1081,337,744,0,0,0,118,0.297229219143577,2156,11.8274582560297
"1746",2024,"Central Connecticut",24,10,41.7,302,682,279,192,0,511,0,274,298,572,206,424,1161,390,771,0,0,0,107,0.354304635761589,2144,9.60820895522388
"1747",2024,"James Madison",12,5,41.7,618,1144,493,310,0,608,3,497,411,908,190,593,1326,444,882,0,0,0,231,0.37378640776699,3417,5.56043312847527
"1748",2024,"Maryland",12,5,41.7,475,873,475,333,0,571,2,487,395,882,250,499,1226,441,785,0,0,0,178,0.374736842105263,2901,8.61771802826611
"1749",2024,"Mississippi State",24,10,41.7,484,904,420,277,0,431,2,441,248,689,246,465,1303,451,852,0,0,0,197,0.40702479338843,2850,8.63157894736842
"1750",2024,"Norfolk State",12,5,41.7,496,792,396,267,0,557,4,389,426,815,412,448,1195,421,774,0,0,0,166,0.334677419354839,2646,15.5706727135299
"1751",2024,"North Carolina Central",12,5,41.7,487,847,409,242,0,558,0,357,381,738,281,594,1166,374,792,0,0,0,178,0.365503080082136,2760,10.1811594202899
"1752",2021,"Texas Tech",17,7,41.2,314,630,326,221,1,374,1,268,189,457,136,341,1007,334,673,0,0,0,111,0.353503184713376,1967,6.91408235892222
"1753",2022,"Bucknell",17,7,41.2,302,913,376,245,0,467,1,424,407,831,240,420,1056,361,695,0,0,0,103,0.341059602649007,2515,9.5427435387674
"1754",2022,"Duke",17,7,41.2,407,787,324,194,0,439,1,344,266,610,200,494,1167,382,785,0,0,0,116,0.285012285012285,2484,8.05152979066023
"1755",2022,"Miami (OH)",17,7,41.2,383,710,269,182,0,606,2,351,312,663,281,517,1197,400,797,0,0,0,126,0.328981723237598,2437,11.5305703734099
"1756",2022,"Mississippi Valley State",17,7,41.2,421,534,349,203,1,470,3,202,248,450,212,425,1023,290,733,0,0,0,135,0.320665083135392,1965,10.7888040712468
"1757",2022,"North Florida",17,7,41.2,266,837,278,188,0,527,0,379,233,612,238,514,1105,358,747,0,0,0,95,0.357142857142857,2425,9.81443298969072
"1758",2024,"Bellarmine",17,7,41.2,408,705,362,244,0,588,3,260,305,565,229,453,1176,409,767,0,0,0,149,0.365196078431373,2326,9.84522785898538
"1759",2024,"Washington State",17,7,41.2,387,951,328,234,0,456,3,466,330,796,238,449,1331,482,849,0,0,0,123,0.317829457364341,2824,8.42776203966006
"1760",2021,"Air Force",22,9,40.9,345,588,208,138,0,409,2,232,235,467,244,399,1068,338,730,0,0,0,95,0.27536231884058,1950,12.5128205128205
"1761",2021,"Duquesne",22,9,40.9,219,389,221,139,0,271,0,164,173,337,100,237,578,175,403,0,0,0,72,0.328767123287671,1241,8.058017727639
"1762",2021,"Loyola Chicago",22,9,40.9,277,659,259,170,0,402,1,221,214,435,173,387,981,336,645,0,0,0,83,0.299638989169675,1935,8.9405684754522
"1763",2022,"Detroit Mercy",22,9,40.9,353,657,325,195,0,480,0,271,284,555,245,541,953,293,660,0,0,0,108,0.305949008498584,2198,11.1464968152866
"1764",2022,"Oklahoma",22,9,40.9,423,998,484,329,0,643,2,509,361,870,323,641,1351,467,884,0,0,0,131,0.309692671394799,3155,10.2377179080824
"1765",2023,"Ball State",22,9,40.9,362,927,460,297,0,610,1,490,326,816,268,458,1293,500,793,0,0,0,140,0.386740331491713,2846,9.41672522839072
"1766",2023,"Southern Miss",22,9,40.9,492,788,425,274,1,564,5,414,298,712,289,543,1058,328,730,0,0,0,181,0.367886178861789,2680,10.7835820895522
"1767",2024,"Southern Utah",22,9,40.9,379,772,322,195,0,461,6,343,257,600,132,454,1218,410,808,0,0,0,116,0.306068601583113,2437,5.41649569142388
"1768",2024,"Texas State",22,9,40.9,395,714,400,271,0,580,0,439,416,855,274,575,939,293,646,0,0,0,109,0.275949367088608,2504,10.9424920127796
"1769",2024,"Youngstown State",22,9,40.9,346,797,282,194,0,530,0,345,243,588,224,529,1189,359,830,0,0,0,113,0.326589595375723,2444,9.16530278232406
"1770",2024,"Monmouth",27,11,40.7,460,954,380,253,0,484,2,380,358,738,186,558,1047,349,698,0,0,0,164,0.356521739130435,2809,6.62157351370594
"1771",2024,"Nevada",32,13,40.6,438,757,349,228,0,559,1,343,385,728,323,467,1274,418,856,0,0,0,139,0.317351598173516,2508,12.8787878787879
"1772",2021,"Akron",5,2,40,167,518,192,129,1,353,0,225,205,430,142,319,767,273,494,0,0,0,56,0.335329341317365,1547,9.17905623787977
"1773",2021,"Auburn",10,4,40,347,536,286,187,0,355,2,275,216,491,245,357,967,279,688,0,0,0,109,0.314121037463977,1870,13.1016042780749
"1774",2021,"Boston College",10,4,40,302,414,189,136,0,359,1,222,207,429,168,303,801,251,550,0,0,0,95,0.314569536423841,1541,10.9020116807268
"1775",2021,"Charlotte",30,12,40,262,573,329,221,0,363,0,225,152,377,103,258,817,289,528,0,0,0,103,0.393129770992366,1691,6.09107037256061
"1776",2021,"Chattanooga",5,2,40,267,645,298,191,0,385,1,294,235,529,164,433,782,251,531,0,0,0,80,0.299625468164794,1967,8.3375699034062
"1777",2021,"Lipscomb",5,2,40,181,585,193,123,0,364,2,217,184,401,101,317,801,249,552,0,0,0,56,0.30939226519337,1599,6.31644777986241
"1778",2021,"Michigan",10,4,40,339,625,328,225,0,368,0,360,240,600,122,344,721,232,489,0,0,0,120,0.353982300884956,1986,6.14300100704935
"1779",2021,"Omaha",10,4,40,173,479,238,156,0,334,0,224,203,427,110,281,596,202,394,0,0,0,58,0.335260115606936,1418,7.7574047954866
"1780",2021,"SIU Edwardsville",5,2,40,371,562,299,162,0,386,1,273,298,571,183,436,733,203,530,0,0,0,117,0.315363881401617,1906,9.601259181532
"1781",2021,"San Diego",10,4,40,284,385,232,137,0,340,0,184,133,317,237,296,771,244,527,0,0,0,90,0.316901408450704,1450,16.3448275862069
"1782",2021,"Tennessee Tech",10,4,40,261,509,225,155,0,311,0,246,178,424,143,324,730,258,472,0,0,0,91,0.348659003831418,1665,8.58858858858859
"1783",2021,"Texas State",15,6,40,256,507,300,205,0,378,0,242,194,436,185,355,767,236,531,0,0,0,73,0.28515625,1663,11.1244738424534
"1784",2021,"Troy",5,2,40,475,718,344,234,0,427,2,325,245,570,224,342,1140,394,746,0,0,0,169,0.355789473684211,2331,9.60960960960961
"1785",2021,"USC",10,4,40,158,527,196,133,1,288,2,181,155,336,142,280,819,299,520,0,0,0,44,0.278481012658228,1495,9.49832775919732
"1786",2021,"Western Carolina",5,2,40,279,551,211,138,0,412,1,175,172,347,160,398,917,304,613,0,0,0,92,0.329749103942652,1751,9.13763563677898
"1787",2022,"BYU",5,2,40,386,761,274,190,0,440,1,471,260,731,272,354,1052,363,689,0,0,0,131,0.339378238341969,2404,11.3144758735441
"1788",2022,"Louisiana Tech",25,10,40,376,824,437,303,0,484,1,377,351,728,272,471,1137,430,707,0,0,0,133,0.353723404255319,2576,10.5590062111801
"1789",2022,"Montana State",25,10,40,486,862,446,314,0,603,0,327,307,634,323,415,1574,507,1067,0,0,0,160,0.329218106995885,2692,11.998514115899
"1790",2022,"Penn State",10,4,40,322,692,309,215,1,460,1,435,329,764,276,452,1021,334,687,0,0,0,115,0.357142857142857,2325,11.8709677419355
"1791",2022,"Utah Tech",15,6,40,266,882,268,169,0,451,0,233,240,473,162,479,1225,468,757,0,0,0,100,0.37593984962406,2394,6.76691729323308
"1792",2022,"Vermont",20,8,40,329,730,297,199,0,418,0,370,309,679,218,423,985,329,656,0,0,0,107,0.325227963525836,2262,9.63748894783378
"1793",2022,"Xavier",20,8,40,397,738,367,251,0,497,1,397,368,765,225,491,1006,303,703,0,0,0,136,0.342569269521411,2409,9.33997509339975
"1794",2023,"Binghamton",35,14,40,354,778,315,197,0,486,0,248,261,509,263,452,1264,447,817,0,0,0,110,0.310734463276836,2358,11.1535199321459
"1795",2023,"Denver",5,2,40,364,744,429,269,0,507,4,341,304,645,151,451,1044,312,732,0,0,0,128,0.351648351648352,2317,6.517047906776
"1796",2023,"Fordham",45,18,40,383,865,242,173,0,479,0,287,274,561,276,426,1503,579,924,0,0,0,125,0.326370757180157,2596,10.6317411402157
"1797",2023,"Houston Christian",10,4,40,335,703,325,215,0,467,0,256,279,535,206,464,1060,345,715,0,0,0,101,0.301492537313433,2178,9.45821854912764
"1798",2023,"Kentucky",20,8,40,459,691,380,255,0,608,5,354,282,636,301,530,1278,418,860,0,0,0,153,0.333333333333333,2553,11.7900509204857
"1799",2023,"Lindenwood",10,4,40,236,572,242,151,0,409,0,280,250,530,171,533,787,251,536,0,0,0,70,0.296610169491525,1923,8.89235569422777
"1800",2023,"Loyola Marymount",10,4,40,294,605,271,192,0,515,4,261,271,532,213,491,1029,330,699,0,0,0,72,0.244897959183673,2052,10.3801169590643
"1801",2023,"Ole Miss",20,8,40,562,932,460,286,0,612,5,404,321,725,246,488,1369,469,900,0,0,0,192,0.341637010676157,2975,8.26890756302521
"1802",2023,"Pepperdine",15,6,40,460,810,409,261,0,536,1,367,374,741,185,527,993,334,659,0,0,0,140,0.304347826086957,2603,7.10718401844026
"1803",2023,"Richmond",15,6,40,306,889,325,224,0,419,1,428,369,797,203,450,962,348,614,0,0,0,110,0.359477124183007,2502,8.11350919264588
"1804",2023,"Syracuse",5,2,40,531,863,414,274,0,467,7,446,315,761,339,491,1417,471,946,0,0,0,172,0.32391713747646,2901,11.6856256463289
"1805",2023,"Texas Tech",15,6,40,440,858,500,344,0,650,13,397,282,679,252,542,1297,435,862,0,0,0,142,0.322727272727273,2793,9.02255639097744
"1806",2023,"Troy",35,14,40,723,890,515,325,0,606,7,399,321,720,346,469,1661,534,1127,0,0,0,248,0.343015214384509,3128,11.0613810741688
"1807",2024,"Alcorn State",15,6,40,408,787,397,243,0,580,0,287,303,590,223,542,1017,298,719,0,0,0,124,0.303921568627451,2422,9.20726672171759
"1808",2024,"Georgia Tech",25,10,40,414,883,386,249,0,491,0,406,278,684,205,443,1313,427,886,0,0,0,149,0.359903381642512,2667,7.68653918260217
"1809",2024,"Kansas State",25,10,40,338,982,405,258,0,524,1,523,312,835,293,478,1186,396,790,0,0,0,127,0.375739644970414,2839,10.3205353997887
"1810",2024,"Louisville",15,6,40,447,787,428,293,0,544,4,419,276,695,257,482,1139,407,732,0,0,0,159,0.355704697986577,2640,9.73484848484848
"1811",2024,"Missouri",15,6,40,285,805,284,199,0,494,2,376,274,650,203,484,1092,394,698,0,0,0,90,0.31578947368421,2419,8.39189747829682
"1812",2024,"Murray State",15,6,40,468,885,445,323,0,576,1,535,313,848,265,490,1299,437,862,0,0,0,176,0.376068376068376,2922,9.06913073237509
"1813",2024,"Ohio State",5,2,40,330,738,429,284,0,540,7,479,276,755,326,407,1162,405,757,0,0,0,107,0.324242424242424,2465,13.2251521298174
"1814",2024,"Rutgers",10,4,40,390,772,436,290,0,588,3,402,340,742,207,569,971,312,659,0,0,0,123,0.315384615384615,2551,8.11446491571933
"1815",2024,"Saint Louis",20,8,40,556,914,474,340,1,705,3,529,426,955,375,629,1434,491,943,0,0,0,194,0.348920863309353,3239,11.5776474220438
"1816",2024,"Samford",10,4,40,380,737,385,227,0,430,3,254,254,508,186,422,1070,347,723,0,0,0,133,0.35,2233,8.32960143304971
"1817",2024,"Southern Illinois",30,12,40,470,704,455,292,0,606,6,433,479,912,344,501,963,304,659,0,0,0,170,0.361702127659574,2534,13.5753749013418
"1818",2024,"Southern Miss",15,6,40,489,916,396,273,0,557,8,484,398,882,269,566,1173,387,786,0,0,0,174,0.355828220858896,2942,9.14343983684568
"1819",2024,"St. Thomas-Minnesota",15,6,40,379,744,351,247,0,562,0,361,247,608,249,544,1171,402,769,0,0,0,133,0.350923482849604,2521,9.87703292344308
"1820",2024,"TCU",10,4,40,350,888,342,230,0,482,0,354,265,619,172,461,1179,420,759,0,0,0,111,0.317142857142857,2566,6.70303975058457
"1821",2024,"UTEP",15,6,40,367,721,428,262,0,509,4,362,265,627,205,467,1033,365,668,0,0,0,134,0.365122615803815,2377,8.62431636516618
"1822",2024,"VCU",5,2,40,456,822,392,255,0,460,1,368,360,728,248,478,974,333,641,0,0,0,143,0.31359649122807,2550,9.72549019607843
"1823",2021,"Washington State",33,13,39.4,340,595,232,152,0,394,1,252,253,505,190,351,931,301,630,0,0,0,93,0.273529411764706,1884,10.0849256900212
"1824",2022,"Navy",33,13,39.4,372,744,286,175,0,493,2,251,252,503,218,446,1291,389,902,0,0,0,100,0.268817204301075,2262,9.63748894783378
"1825",2023,"Northern Illinois",28,11,39.3,438,846,353,242,0,499,0,388,360,748,233,454,1281,447,834,0,0,0,140,0.319634703196347,2650,8.79245283018868
"1826",2021,"Kansas",23,9,39.1,330,670,338,234,0,474,1,285,289,574,181,382,974,331,643,0,0,0,95,0.287878787878788,2071,8.73973925639788
"1827",2022,"Loyola Marymount",23,9,39.1,325,689,332,213,0,446,1,320,286,606,219,533,951,304,647,0,0,0,107,0.329230769230769,2258,9.69884853852967
"1828",2022,"Niagara",23,9,39.1,494,617,456,279,0,593,1,426,451,877,395,609,1125,332,793,0,0,0,131,0.265182186234818,2591,15.2450791200309
"1829",2022,"UC San Diego",23,9,39.1,303,780,216,143,0,439,0,265,233,498,155,401,1104,336,768,0,0,0,94,0.31023102310231,2142,7.23622782446312
"1830",2023,"Coppin State",23,9,39.1,387,767,357,213,3,450,3,236,304,540,190,493,1063,288,775,0,0,0,102,0.263565891472868,2252,8.43694493783304
"1831",2021,"Gardner-Webb",18,7,38.9,331,464,237,148,2,429,4,217,197,414,259,347,1002,286,716,0,0,0,95,0.287009063444109,1701,15.2263374485597
"1832",2021,"North Carolina",18,7,38.9,321,674,304,205,0,378,2,311,215,526,155,296,974,314,660,0,0,0,101,0.314641744548287,1999,7.75387693846923
"1833",2021,"TCU",18,7,38.9,272,667,313,210,0,474,3,255,257,512,181,370,1026,357,669,0,0,0,89,0.327205882352941,2005,9.02743142144638
"1834",2021,"Texas A&M",18,7,38.9,305,786,410,274,0,417,0,407,259,666,210,408,991,369,622,0,0,0,114,0.373770491803279,2396,8.76460767946578
"1835",2021,"Tulane",18,7,38.9,355,683,376,233,0,385,4,342,265,607,224,405,898,303,595,0,0,0,121,0.340845070422535,2173,10.3083294983893
"1836",2021,"Wofford",18,7,38.9,357,589,270,171,0,314,0,242,210,452,144,349,858,251,607,0,0,0,112,0.313725490196078,1843,7.81334780249593
"1837",2022,"Kent State",18,7,38.9,393,825,350,235,0,476,3,390,370,760,187,436,1066,360,706,0,0,0,121,0.307888040712468,2480,7.54032258064516
"1838",2023,"Detroit Mercy",18,7,38.9,374,826,353,223,0,483,2,348,314,662,147,594,999,279,720,0,0,0,114,0.304812834224599,2507,5.86358197048265
"1839",2023,"Maryland",18,7,38.9,444,880,449,325,2,591,3,451,325,776,364,469,1473,552,921,0,0,0,161,0.362612612612613,2928,12.431693989071
"1840",2023,"Middle Tennessee",18,7,38.9,392,865,453,320,0,572,3,426,259,685,273,397,1209,391,818,0,0,0,127,0.323979591836735,2567,10.6349824698091
"1841",2023,"Oral Roberts",18,7,38.9,354,833,422,287,0,578,1,502,380,882,299,510,1190,373,817,0,0,0,140,0.395480225988701,2677,11.1692192753082
"1842",2023,"UMBC",18,7,38.9,369,683,296,196,0,447,1,300,279,579,205,451,1048,375,673,0,0,0,117,0.317073170731707,2267,9.04278782531981
"1843",2023,"UT Martin",18,7,38.9,305,643,342,245,0,515,0,308,228,536,296,510,1101,366,735,0,0,0,114,0.373770491803279,2222,13.3213321332133
"1844",2024,"Florida State",18,7,38.9,371,948,419,300,0,457,1,434,407,841,224,374,1353,469,884,0,0,0,104,0.280323450134771,2719,8.2383229128356
"1845",2024,"Presbyterian",18,7,38.9,388,901,333,204,0,462,0,392,346,738,210,607,1140,350,790,0,0,0,101,0.260309278350515,2713,7.74050866199779
"1846",2024,"Virginia",18,7,38.9,510,873,391,274,0,600,2,413,374,787,258,465,1312,421,891,0,0,0,172,0.337254901960784,2776,9.29394812680115
"1847",2023,"Oklahoma State",31,12,38.7,349,904,389,257,0,490,1,448,319,767,218,440,1258,466,792,0,0,0,116,0.332378223495702,2719,8.01765354909893
"1848",2021,"Drake",13,5,38.5,291,755,306,201,0,421,0,457,264,721,206,483,831,299,532,0,0,0,96,0.329896907216495,2361,8.72511647606946
"1849",2021,"Hampton",13,5,38.5,185,313,180,107,0,270,1,138,151,289,129,193,561,143,418,0,0,0,49,0.264864864864865,1011,12.7596439169139
"1850",2021,"High Point",13,5,38.5,223,861,352,240,0,478,0,278,251,529,143,399,1122,428,694,0,0,0,61,0.273542600896861,2262,6.32183908045977
"1851",2021,"Nevada",13,5,38.5,313,554,227,161,1,340,0,218,210,428,141,307,879,280,599,0,0,0,91,0.29073482428115,1731,8.14558058925477
"1852",2021,"Portland",13,5,38.5,332,530,319,207,0,478,2,403,330,733,263,445,710,229,481,0,0,0,112,0.337349397590361,2026,12.9812438302073
"1853",2021,"Stony Brook",13,5,38.5,298,531,245,158,0,312,1,237,191,428,172,339,711,225,486,0,0,0,85,0.285234899328859,1687,10.1956135151156
"1854",2022,"Boise State",26,10,38.5,472,805,369,222,0,482,0,370,322,692,162,467,1024,309,715,0,0,0,184,0.389830508474576,2519,6.43112346169115
"1855",2022,"Drake",13,5,38.5,388,985,389,264,0,494,0,564,389,953,237,590,1019,328,691,0,0,0,133,0.342783505154639,2948,8.0393487109905
"1856",2022,"Gardner-Webb",13,5,38.5,420,752,433,276,0,591,5,402,283,685,269,491,1222,375,847,0,0,0,143,0.34047619047619,2536,10.6072555205047
"1857",2022,"Maryland-Eastern Shore",13,5,38.5,429,660,366,216,0,503,2,312,297,609,191,411,931,274,657,0,0,0,112,0.261072261072261,2171,8.79778903731
"1858",2022,"Mississippi State",13,5,38.5,345,673,321,188,0,410,1,382,250,632,258,333,1160,385,775,0,0,0,109,0.315942028985507,2193,11.7647058823529
"1859",2022,"Portland",13,5,38.5,436,775,391,254,1,577,2,497,307,804,340,506,1056,311,745,0,0,0,155,0.355504587155963,2623,12.962256957682
"1860",2022,"Portland State",13,5,38.5,298,647,223,158,0,419,0,272,279,551,223,428,1096,337,759,0,0,0,70,0.23489932885906,2035,10.958230958231
"1861",2022,"South Florida",13,5,38.5,507,841,364,238,0,479,6,367,346,713,218,464,1127,338,789,0,0,0,146,0.287968441814596,2599,8.38784147749134
"1862",2022,"Southern",13,5,38.5,480,602,369,211,0,606,1,267,280,547,350,449,1272,398,874,0,0,0,151,0.314583333333333,2282,15.3374233128834
"1863",2023,"Florida",13,5,38.5,408,828,448,294,0,602,5,407,346,753,262,522,1179,366,813,0,0,0,124,0.303921568627451,2641,9.92048466489966
"1864",2023,"North Carolina A&T",13,5,38.5,408,656,356,228,0,446,3,385,295,680,237,538,862,280,582,0,0,0,138,0.338235294117647,2349,10.0893997445722
"1865",2023,"UT Arlington",13,5,38.5,430,788,551,350,0,609,5,536,452,988,303,530,915,272,643,0,0,0,160,0.372093023255814,2699,11.2263801407929
"1866",2024,"Bowling Green",13,5,38.5,336,759,359,230,1,524,1,404,322,726,186,470,1012,352,660,0,0,0,99,0.294642857142857,2403,7.74032459425718
"1867",2024,"East Carolina",13,5,38.5,531,780,467,307,0,609,7,440,370,810,350,568,1180,342,838,0,0,0,171,0.322033898305085,2774,12.6171593366979
"1868",2024,"Lipscomb",13,5,38.5,354,814,364,227,0,475,0,318,328,646,185,408,1109,374,735,0,0,0,120,0.338983050847458,2352,7.8656462585034
"1869",2024,"Massachusetts",13,5,38.5,359,639,273,171,0,547,1,324,289,613,238,520,1133,372,761,0,0,0,128,0.356545961002786,2281,10.4340201665936
"1870",2022,"Northern Colorado",34,13,38.2,365,828,326,222,0,473,0,349,359,708,224,540,963,325,638,0,0,0,110,0.301369863013699,2475,9.05050505050505
"1871",2021,"San Diego State",21,8,38.1,253,572,238,151,0,321,1,202,155,357,124,306,875,259,616,0,0,0,86,0.339920948616601,1645,7.53799392097264
"1872",2022,"Austin Peay",21,8,38.1,382,739,389,238,3,526,3,386,301,687,217,490,892,333,559,0,0,0,159,0.416230366492147,2430,8.93004115226337
"1873",2022,"Providence",21,8,38.1,318,844,347,220,0,474,0,398,377,775,211,539,877,256,621,0,0,0,110,0.345911949685535,2438,8.6546349466776
"1874",2023,"Grambling",21,8,38.1,377,666,345,218,0,531,1,223,257,480,237,452,1148,362,786,0,0,0,114,0.302387267904509,2164,10.9519408502773
"1875",2023,"Western Kentucky",21,8,38.1,502,683,463,287,2,626,7,391,290,681,389,494,1341,403,938,0,0,0,166,0.330677290836653,2583,15.0600077429346
"1876",2024,"Marist",42,16,38.1,338,864,325,212,0,422,0,244,312,556,193,542,1191,371,820,0,0,0,82,0.242603550295858,2437,7.91957324579401
"1877",2024,"New Mexico",21,8,38.1,337,926,369,239,1,399,2,375,360,735,214,443,1086,345,741,0,0,0,109,0.323442136498516,2521,8.48869496231654
"1878",2024,"UMBC",21,8,38.1,365,687,310,193,0,466,1,343,380,723,177,484,876,287,589,0,0,0,118,0.323287671232877,2229,7.94078061911171
"1879",2024,"Boston University",29,11,37.9,314,806,353,230,0,451,2,392,318,710,230,510,952,339,613,0,0,0,103,0.328025477707006,2462,9.34199837530463
"1880",2024,"Long Island University",29,11,37.9,412,739,336,211,0,482,1,205,202,407,230,563,1253,429,824,0,0,0,144,0.349514563106796,2440,9.42622950819672
"1881",2022,"Middle Tennessee",37,14,37.8,409,887,322,221,0,626,1,365,289,654,312,462,1448,490,958,0,0,0,138,0.337408312958435,2701,11.551277304702
"1882",2021,"Gonzaga",16,6,37.5,383,726,274,189,0,424,2,360,245,605,201,403,956,371,585,0,0,0,139,0.362924281984334,2329,8.63031343924431
"1883",2021,"Oregon State",8,3,37.5,170,549,216,147,0,240,2,220,164,384,74,257,608,226,382,0,0,0,76,0.447058823529412,1483,4.98988536749831
"1884",2021,"Tarleton",8,3,37.5,231,529,360,239,0,308,4,194,253,447,151,305,693,193,500,0,0,0,73,0.316017316017316,1536,9.83072916666667
"1885",2022,"Canisius",24,9,37.5,333,667,275,168,0,458,2,237,226,463,192,539,1212,380,832,0,0,0,91,0.273273273273273,2221,8.64475461503827
"1886",2022,"Hofstra",16,6,37.5,342,643,298,174,0,481,4,315,293,608,247,501,880,226,654,0,0,0,90,0.263157894736842,2106,11.7283950617284
"1887",2022,"Holy Cross",16,6,37.5,395,824,297,187,0,410,2,388,383,771,205,485,987,317,670,0,0,0,141,0.356962025316456,2488,8.2395498392283
"1888",2022,"Iowa State",8,3,37.5,410,1038,391,294,0,448,1,426,280,706,185,438,1416,492,924,0,0,0,134,0.326829268292683,2902,6.37491385251551
"1889",2022,"Kansas",8,3,37.5,321,909,455,312,0,514,2,433,333,766,247,532,1025,350,675,0,0,0,96,0.299065420560748,2649,9.32427331068328
"1890",2022,"UCF",8,3,37.5,447,699,348,223,0,410,1,294,265,559,313,450,1046,362,684,0,0,0,133,0.297539149888143,2338,13.3875106928999
"1891",2023,"Alcorn State",8,3,37.5,296,475,292,164,1,417,3,200,212,412,168,338,739,214,525,0,0,0,99,0.33445945945946,1597,10.5197244834064
"1892",2023,"Austin Peay",16,6,37.5,319,711,367,248,0,533,7,333,251,584,234,495,861,286,575,0,0,0,124,0.38871473354232,2256,10.3723404255319
"1893",2023,"Cal Poly",16,6,37.5,324,577,318,205,0,498,0,241,290,531,188,442,878,267,611,0,0,0,98,0.302469135802469,1927,9.75609756097561
"1894",2023,"Cleveland State",8,3,37.5,484,979,575,373,0,531,3,482,437,919,306,514,1091,375,716,0,0,0,141,0.291322314049587,2957,10.3483260060873
"1895",2023,"Colorado State",24,9,37.5,204,860,308,222,0,472,1,329,221,550,196,271,1285,491,794,0,0,0,96,0.470588235294118,2236,8.76565295169946
"1896",2023,"Illinois",16,6,37.5,408,842,313,216,0,529,1,436,281,717,196,413,1280,476,804,0,0,0,152,0.372549019607843,2658,7.3739653875094
"1897",2023,"New Orleans",32,12,37.5,457,618,341,221,0,537,2,242,313,555,242,531,1064,353,711,0,0,0,132,0.288840262582057,2277,10.6280193236715
"1898",2023,"Saint Louis",32,12,37.5,538,903,418,294,0,604,1,505,383,888,329,608,1324,377,947,0,0,0,165,0.306691449814126,3032,10.8509234828496
"1899",2023,"San Diego",24,9,37.5,531,795,455,292,1,590,2,400,312,712,268,457,1222,355,867,0,0,0,187,0.352165725047081,2642,10.1438304314913
"1900",2023,"St. Bonaventure",8,3,37.5,315,763,292,189,0,518,2,247,315,562,216,554,1144,342,802,0,0,0,72,0.228571428571429,2288,9.44055944055944
"1901",2023,"St. Francis (PA)",8,3,37.5,391,710,321,190,0,438,0,272,301,573,157,577,898,261,637,0,0,0,134,0.342710997442455,2283,6.87691633815156
"1902",2023,"Utah",8,3,37.5,367,846,446,320,0,543,1,573,374,947,215,452,890,312,578,0,0,0,135,0.367847411444142,2650,8.11320754716981
"1903",2024,"California",16,6,37.5,446,800,320,217,0,545,3,388,332,720,229,486,1246,393,853,0,0,0,133,0.298206278026906,2586,8.8553750966744
"1904",2024,"High Point",8,3,37.5,250,716,322,201,0,473,2,272,275,547,180,436,980,351,629,0,0,0,90,0.36,2092,8.60420650095602
"1905",2023,"Elon",35,13,37.1,392,699,304,189,0,493,3,292,249,541,214,530,1065,352,713,0,0,0,119,0.303571428571429,2343,9.13358941527956
"1906",2022,"VCU",27,10,37,342,601,307,191,0,369,1,216,212,428,194,306,1016,335,681,0,0,0,114,0.333333333333333,1885,10.2917771883289
"1907",2023,"Southern Utah",27,10,37,400,1017,406,279,0,472,4,452,335,787,143,553,1143,383,760,0,0,0,133,0.3325,2922,4.89390828199863
"1908",2024,"Bryant",27,10,37,340,771,353,204,0,448,0,353,319,672,188,480,967,313,654,0,0,0,104,0.305882352941176,2338,8.04106073567151
"1909",2024,"Florida A&M",27,10,37,436,683,364,242,1,621,0,283,339,622,263,596,1092,363,729,0,0,0,142,0.325688073394495,2451,10.7303141574867
"1910",2021,"Eastern Illinois",19,7,36.8,305,570,280,196,0,456,0,331,255,586,231,393,865,280,585,0,0,0,104,0.340983606557377,1942,11.8949536560247
"1911",2021,"Nebraska",19,7,36.8,295,728,293,194,0,393,1,246,198,444,117,344,1040,381,659,0,0,0,97,0.328813559322034,2065,5.66585956416465
"1912",2022,"Cal State Northridge",19,7,36.8,324,647,306,193,0,515,0,257,264,521,289,464,1006,322,684,0,0,0,98,0.302469135802469,2084,13.8675623800384
"1913",2023,"Iowa State",19,7,36.8,386,996,385,286,0,486,0,408,263,671,194,430,1288,420,868,0,0,0,127,0.329015544041451,2725,7.11926605504587
"1914",2023,"UMass",19,7,36.8,499,915,379,254,0,505,3,563,409,972,284,465,1246,416,830,0,0,0,159,0.318637274549098,2951,9.62385631989156
"1915",2023,"Vermont",19,7,36.8,375,802,315,198,0,435,0,347,293,640,190,426,1088,392,696,0,0,0,120,0.32,2416,7.86423841059603
"1916",2024,"UCLA",19,7,36.8,574,983,411,281,0,599,0,487,335,822,263,513,1367,489,878,0,0,0,187,0.325783972125436,3168,8.30176767676768
"1917",2024,"Western Michigan",19,7,36.8,268,603,275,179,0,498,2,325,280,605,241,443,945,293,652,0,0,0,70,0.261194029850746,1998,12.0620620620621
"1918",2021,"Fresno State",30,11,36.7,279,702,274,182,0,312,2,366,296,662,205,307,961,367,594,0,0,0,101,0.362007168458781,2092,9.79923518164436
"1919",2024,"USC",30,11,36.7,488,928,463,316,0,563,1,413,303,716,280,423,1473,512,961,0,0,0,173,0.354508196721311,2902,9.64851826326671
"1920",2021,"Kennesaw State",11,4,36.4,295,503,246,150,1,319,1,260,216,476,127,353,680,214,466,0,0,0,106,0.359322033898305,1685,7.53709198813056
"1921",2021,"Merrimack",11,4,36.4,177,384,155,101,0,267,1,166,187,353,137,260,530,183,347,0,0,0,58,0.327683615819209,1219,11.2387202625103
"1922",2021,"Murray State",22,8,36.4,330,650,342,249,0,368,0,288,220,508,155,354,927,311,616,0,0,0,111,0.336363636363636,2006,7.72681954137587
"1923",2021,"NJIT",11,4,36.4,191,461,198,131,0,300,0,113,130,243,88,305,616,183,433,0,0,0,53,0.277486910994764,1301,6.76402767102229
"1924",2021,"Northeastern",11,4,36.4,220,433,166,112,0,321,0,206,179,385,130,325,653,228,425,0,0,0,70,0.318181818181818,1455,8.93470790378007
"1925",2021,"Quinnipiac",22,8,36.4,356,537,254,165,0,302,1,244,272,516,173,306,769,239,530,0,0,0,87,0.24438202247191,1739,9.94824611845888
"1926",2021,"St. Bonaventure",11,4,36.4,229,512,199,127,0,326,2,239,235,474,152,307,704,231,473,0,0,0,81,0.353711790393013,1567,9.70006381620932
"1927",2021,"Xavier",11,4,36.4,233,338,188,125,0,296,2,176,141,317,148,288,593,171,422,0,0,0,69,0.296137339055794,1253,11.8116520351157
"1928",2022,"Charlotte",22,8,36.4,426,877,431,287,0,489,1,332,291,623,209,473,1208,387,821,0,0,0,120,0.28169014084507,2610,8.00766283524904
"1929",2022,"DePaul",22,8,36.4,559,838,359,251,0,500,2,552,409,961,325,455,1518,555,963,0,0,0,211,0.377459749552773,3050,10.655737704918
"1930",2022,"Jacksonville",11,4,36.4,392,690,357,224,0,511,5,322,309,631,287,459,949,290,659,0,0,0,135,0.344387755102041,2228,12.8815080789946
"1931",2022,"LSU",22,8,36.4,478,893,452,273,0,438,4,414,291,705,254,405,1222,440,782,0,0,0,174,0.364016736401674,2745,9.25318761384335
"1932",2022,"Stetson",11,4,36.4,392,861,396,251,1,481,0,446,397,843,285,522,904,281,623,0,0,0,139,0.354591836734694,2602,10.9531129900077
"1933",2022,"Temple",22,8,36.4,432,728,367,242,1,510,3,338,356,694,214,499,894,264,630,0,0,0,148,0.342592592592593,2356,9.08319185059423
"1934",2022,"Texas",22,8,36.4,496,827,508,322,5,659,2,412,347,759,356,513,1401,526,875,0,0,0,156,0.314516129032258,2905,12.2547332185886
"1935",2022,"Wagner",11,4,36.4,358,665,335,208,0,535,4,311,285,596,262,474,1043,346,697,0,0,0,104,0.290502793296089,2225,11.7752808988764
"1936",2023,"Mississippi State",11,4,36.4,425,919,426,263,0,505,2,442,279,721,278,515,1166,406,760,0,0,0,142,0.334117647058824,2814,9.87917555081734
"1937",2023,"Mount St. Mary's",22,8,36.4,306,734,283,186,0,521,0,278,290,568,241,502,1173,359,814,0,0,0,76,0.248366013071895,2250,10.7111111111111
"1938",2023,"SE Louisiana",11,4,36.4,367,769,363,227,1,446,1,307,245,552,282,399,1255,423,832,0,0,0,106,0.288828337874659,2356,11.9694397283531
"1939",2024,"Delaware State",11,4,36.4,334,560,274,171,0,345,1,189,234,423,187,462,908,281,627,0,0,0,96,0.287425149700599,1895,9.86807387862797
"1940",2024,"Gonzaga",11,4,36.4,447,860,334,247,0,459,2,473,304,777,257,432,1252,496,756,0,0,0,160,0.357941834451902,2799,9.18185066095034
"1941",2024,"IUPUI",22,8,36.4,403,770,468,292,0,539,1,350,373,723,186,559,978,332,646,0,0,0,144,0.357320099255583,2534,7.34017363851618
"1942",2022,"Ball State",36,13,36.1,323,827,354,228,0,529,0,367,279,646,247,438,1300,475,825,0,0,0,114,0.352941176470588,2527,9.77443609022556
"1943",2022,"Long Beach State",25,9,36,339,606,320,203,0,448,0,308,232,540,336,370,1086,333,753,0,0,0,115,0.339233038348083,2027,16.5762210162802
"1944",2023,"Buffalo",25,9,36,250,692,308,200,0,360,0,365,288,653,179,368,830,287,543,0,0,0,105,0.42,2042,8.76591576885406
"1945",2023,"Sam Houston",25,9,36,544,688,436,270,0,537,2,337,402,739,240,473,1136,370,766,0,0,0,169,0.310661764705882,2529,9.48991696322657
"1946",2024,"Idaho",25,9,36,301,809,267,190,0,411,0,343,366,709,223,419,995,329,666,0,0,0,84,0.27906976744186,2263,9.85417587273531
"1947",2024,"Oregon State",25,9,36,384,1103,345,226,0,470,2,445,290,735,157,477,1263,481,782,0,0,0,150,0.390625,2988,5.25435073627845
"1948",2021,"Grambling",14,5,35.7,248,418,247,154,0,363,0,190,171,361,147,309,607,183,424,0,0,0,79,0.318548387096774,1395,10.5376344086022
"1949",2021,"Marshall",14,5,35.7,230,509,223,140,0,353,2,210,164,374,125,290,700,195,505,0,0,0,64,0.278260869565217,1486,8.41184387617766
"1950",2021,"Rutgers",14,5,35.7,272,419,206,148,0,315,2,254,153,407,240,257,735,279,456,0,0,0,83,0.305147058823529,1539,15.5945419103314
"1951",2022,"Auburn",14,5,35.7,395,666,426,260,0,517,4,358,339,697,236,420,967,284,683,0,0,0,117,0.29620253164557,2227,10.5972159856309
"1952",2022,"Michigan State",28,10,35.7,394,738,363,242,0,478,3,339,224,563,211,432,1137,393,744,0,0,0,122,0.309644670050761,2380,8.8655462184874
"1953",2022,"Omaha",14,5,35.7,252,632,281,192,0,447,1,290,299,589,202,428,800,249,551,0,0,0,69,0.273809523809524,1928,10.4771784232365
"1954",2022,"Presbyterian",14,5,35.7,370,762,349,229,0,454,0,332,273,605,187,579,984,318,666,0,0,0,130,0.351351351351351,2431,7.69230769230769
"1955",2022,"Troy",14,5,35.7,669,1030,525,349,0,603,8,472,389,861,342,542,1484,431,1053,0,0,0,232,0.34678624813154,3262,10.4843654199877
"1956",2023,"UNLV",14,5,35.7,388,875,388,274,0,452,1,441,262,703,203,382,1184,436,748,0,0,0,168,0.43298969072165,2623,7.73922988943957
"1957",2024,"East Tennessee State",14,5,35.7,374,757,339,213,0,421,1,290,258,548,204,409,1061,353,708,0,0,0,114,0.304812834224599,2258,9.03454384410983
"1958",2024,"Louisiana",28,10,35.7,316,721,350,223,0,536,7,293,257,550,236,458,1133,364,769,0,0,0,95,0.300632911392405,2235,10.5592841163311
"1959",2024,"Penn State",14,5,35.7,418,920,434,297,1,651,4,564,328,892,321,585,1302,500,802,0,0,0,179,0.42822966507177,3101,10.3514995162851
"1960",2024,"Syracuse",28,10,35.7,580,801,388,258,0,456,3,376,268,644,296,470,1453,494,959,0,0,0,206,0.355172413793103,2822,10.4890148830617
"1961",2024,"Texas Southern",14,5,35.7,417,717,351,220,0,523,0,228,250,478,204,581,1170,366,804,0,0,0,147,0.352517985611511,2395,8.51774530271399
"1962",2024,"Tulsa",14,5,35.7,327,928,402,257,0,568,3,381,332,713,218,516,1172,409,763,0,0,0,107,0.327217125382263,2668,8.17091454272864
"1963",2021,"Denver",17,6,35.3,245,594,312,217,1,364,0,183,170,353,118,333,941,334,607,0,0,0,85,0.346938775510204,1771,6.66290231507623
"1964",2021,"Prairie View A&M",17,6,35.3,144,305,135,74,0,238,1,131,109,240,89,221,365,125,240,0,0,0,53,0.368055555555556,959,9.28050052137643
"1965",2021,"Tennessee",17,6,35.3,390,752,289,190,0,395,4,386,236,622,165,416,942,299,643,0,0,0,130,0.333333333333333,2324,7.09982788296041
"1966",2022,"Fairleigh Dickinson",17,6,35.3,389,856,369,238,0,481,0,257,317,574,187,456,1154,422,732,0,0,0,138,0.354755784061697,2466,7.5831305758313
"1967",2022,"UC Riverside",17,6,35.3,292,674,295,198,0,407,0,246,247,493,205,347,958,289,669,0,0,0,90,0.308219178082192,1921,10.671525247267
"1968",2022,"Washington",17,6,35.3,200,479,177,111,0,245,1,182,136,318,119,331,635,220,415,0,0,0,54,0.27,1446,8.22959889349931
"1969",2023,"Central Arkansas",17,6,35.3,327,625,284,175,0,396,1,250,260,510,165,431,869,254,615,0,0,0,100,0.305810397553517,1948,8.47022587268994
"1970",2023,"Nebraska",17,6,35.3,442,911,396,267,0,532,2,420,316,736,238,480,1228,386,842,0,0,0,140,0.316742081447964,2749,8.65769370680247
"1971",2023,"Nevada",17,6,35.3,417,749,412,274,0,538,3,332,304,636,250,470,1151,380,771,0,0,0,126,0.302158273381295,2450,10.2040816326531
"1972",2023,"Tennessee",17,6,35.3,576,1041,547,362,0,649,2,560,367,927,263,565,1420,493,927,0,0,0,208,0.361111111111111,3395,7.74668630338733
"1973",2023,"UC Irvine",34,12,35.3,469,752,350,239,0,456,0,327,329,656,314,467,1181,363,818,0,0,0,140,0.298507462686567,2470,12.7125506072874
"1974",2023,"UTSA",34,12,35.3,484,832,362,246,1,641,2,383,305,688,207,562,1153,368,785,0,0,0,174,0.359504132231405,2732,7.57686676427526
"1975",2023,"VCU",34,12,35.3,381,639,253,159,0,398,2,280,285,565,180,395,923,269,654,0,0,0,110,0.288713910761155,2036,8.84086444007858
"1976",2023,"Yale",17,6,35.3,379,608,294,178,0,519,3,274,319,593,231,459,914,284,630,0,0,0,100,0.263852242744063,2067,11.1756168359942
"1977",2024,"Hofstra",17,6,35.3,526,776,361,216,0,585,5,305,365,670,252,594,1123,349,774,0,0,0,145,0.275665399239544,2623,9.60731986275257
"1978",2024,"Longwood",17,6,35.3,417,731,390,245,0,457,0,270,272,542,313,535,1179,390,789,0,0,0,130,0.311750599520384,2441,12.8226136829168
"1979",2024,"UT Rio Grande Valley",17,6,35.3,328,720,376,250,0,471,3,238,294,532,176,436,1163,335,828,0,0,0,99,0.301829268292683,2145,8.2051282051282
"1980",2023,"Arizona State",20,7,35,381,667,367,244,0,471,3,298,336,634,191,334,1109,321,788,0,0,0,115,0.301837270341207,2064,9.25387596899225
"1981",2024,"Charleston",20,7,35,541,852,401,266,0,521,3,370,345,715,329,425,1474,508,966,0,0,0,210,0.388170055452865,2790,11.7921146953405
"1982",2024,"SMU",20,7,35,358,763,429,271,1,491,4,401,294,695,238,424,1034,345,689,0,0,0,135,0.377094972067039,2396,9.93322203672788
"1983",2024,"UC Riverside",20,7,35,414,712,333,223,0,494,2,301,311,612,353,452,1265,378,887,0,0,0,152,0.367149758454106,2340,15.0854700854701
"1984",2024,"Wake Forest",20,7,35,327,669,318,211,1,527,1,356,368,724,246,468,1009,297,712,0,0,0,110,0.336391437308869,2212,11.121157323689
"1985",2022,"Alabama",23,8,34.8,415,856,490,325,0,554,4,465,407,872,304,510,1126,375,751,0,0,0,142,0.342168674698795,2759,11.0184849583182
"1986",2022,"Army",23,8,34.8,462,767,334,206,0,470,0,291,351,642,194,503,1147,382,765,0,0,0,147,0.318181818181818,2493,7.78178900922583
"1987",2022,"California",23,8,34.8,325,588,306,221,0,431,6,305,295,600,201,359,812,256,556,0,0,0,99,0.304615384615385,1909,10.5290728129911
"1988",2022,"Oregon State",23,8,34.8,326,948,317,215,0,389,3,337,248,585,146,455,1110,379,731,0,0,0,125,0.383435582822086,2524,5.78446909667195
"1989",2022,"SE Louisiana",23,8,34.8,330,640,321,190,0,406,4,298,261,559,237,379,865,283,582,0,0,0,100,0.303030303030303,2009,11.7969138875062
"1990",2022,"Wichita State",23,8,34.8,471,820,335,232,0,492,4,417,381,798,260,527,1050,298,752,0,0,0,151,0.320594479830149,2617,9.93504012227742
"1991",2023,"Princeton",23,8,34.8,393,711,330,214,0,434,0,335,317,652,257,379,1050,360,690,0,0,0,107,0.272264631043257,2253,11.4070128717266
"1992",2024,"Austin Peay",23,8,34.8,373,843,431,272,0,599,2,439,351,790,212,562,916,316,600,0,0,0,159,0.42627345844504,2640,8.03030303030303
"1993",2024,"Central Arkansas",23,8,34.8,369,921,383,245,1,534,0,393,288,681,241,501,1196,407,789,0,0,0,135,0.365853658536585,2696,8.93916913946588
"1994",2024,"Illinois",23,8,34.8,370,870,366,266,0,494,0,468,329,797,214,401,1241,460,781,0,0,0,121,0.327027027027027,2662,8.03906836964688
"1995",2024,"SIU Edwardsville",23,8,34.8,369,775,393,280,0,610,3,317,358,675,201,553,1133,393,740,0,0,0,120,0.32520325203252,2500,8.04
"1996",2023,"UT Rio Grande Valley",26,9,34.6,435,752,374,250,0,545,3,276,348,624,191,456,1183,347,836,0,0,0,108,0.248275862068966,2353,8.11729706757331
"1997",2024,"Duquesne",26,9,34.6,409,923,378,244,0,533,2,356,302,658,198,497,1298,472,826,0,0,0,146,0.356968215158924,2756,7.18432510885341
"1998",2023,"UC Riverside",29,10,34.5,359,691,304,205,0,464,2,277,326,603,237,480,1126,299,827,0,0,0,94,0.261838440111421,2181,10.8665749656121
"1999",2023,"Fresno State",35,12,34.3,383,729,369,256,0,480,4,328,279,607,217,477,1088,335,753,0,0,0,135,0.352480417754569,2339,9.2774690038478
"2000",2021,"Arkansas",18,6,33.3,255,672,428,289,0,409,2,358,239,597,202,285,1036,373,663,0,0,0,103,0.403921568627451,2060,9.80582524271845
"2001",2021,"Ball State",15,5,33.3,315,639,385,249,0,397,2,305,228,533,159,403,773,270,503,0,0,0,118,0.374603174603175,2021,7.8673923800099
"2002",2021,"Central Michigan",30,10,33.3,303,712,277,196,0,462,1,291,187,478,201,372,1192,469,723,0,0,0,104,0.343234323432343,2222,9.04590459045905
"2003",2021,"Coastal Carolina",9,3,33.3,251,432,223,135,0,309,1,248,220,468,140,359,540,160,380,0,0,0,70,0.278884462151394,1503,9.31470392548237
"2004",2021,"Colorado State",12,4,33.3,207,612,191,134,0,276,0,224,141,365,120,205,956,368,588,0,0,0,68,0.328502415458937,1667,7.19856028794241
"2005",2021,"Evansville",3,1,33.3,167,536,281,166,0,288,1,196,184,380,127,395,625,171,454,0,0,0,49,0.293413173652695,1522,8.3442838370565
"2006",2021,"Georgia",21,7,33.3,350,726,310,210,0,447,1,366,235,601,226,457,1060,346,714,0,0,0,110,0.314285714285714,2328,9.70790378006873
"2007",2021,"Hartford",6,2,33.3,143,290,106,65,0,192,0,66,82,148,69,220,467,144,323,0,0,0,48,0.335664335664336,891,7.74410774410774
"2008",2021,"LSU",18,6,33.3,274,459,286,174,0,408,3,218,169,387,200,345,835,255,580,0,0,0,78,0.284671532846715,1622,12.3304562268804
"2009",2021,"Marist",9,3,33.3,302,580,242,152,0,280,0,284,237,521,175,309,745,232,513,0,0,0,101,0.334437086092715,1773,9.8702763677383
"2010",2021,"McNeese",6,2,33.3,289,588,318,203,0,461,0,181,239,420,165,424,813,230,583,0,0,0,95,0.328719723183391,1781,9.26445816956766
"2011",2021,"Miami",9,3,33.3,266,508,246,153,0,328,2,234,187,421,150,284,850,270,580,0,0,0,81,0.304511278195489,1622,9.2478421701603
"2012",2021,"Mount St. Mary's",15,5,33.3,276,584,231,166,0,368,3,303,301,604,204,326,741,266,475,0,0,0,92,0.333333333333333,1811,11.2644947542794
"2013",2021,"Portland State",18,6,33.3,322,592,266,177,0,366,3,258,230,488,231,348,943,287,656,0,0,0,114,0.354037267080745,1876,12.3134328358209
"2014",2021,"Radford",18,6,33.3,192,597,242,156,0,325,1,218,196,414,97,341,715,221,494,0,0,0,58,0.302083333333333,1630,5.95092024539877
"2015",2021,"Richmond",21,7,33.3,273,552,219,147,0,305,0,254,261,515,139,337,618,186,432,0,0,0,86,0.315018315018315,1662,8.36341756919374
"2016",2021,"Rider",15,5,33.3,295,632,238,158,0,440,0,222,261,483,177,467,849,255,594,0,0,0,84,0.284745762711864,1933,9.15675116399379
"2017",2021,"Saint Mary's",9,3,33.3,295,628,215,143,0,362,1,279,241,520,174,472,835,276,559,0,0,0,94,0.31864406779661,2011,8.652411735455
"2018",2021,"Saint Peter's",24,8,33.3,503,631,311,187,0,488,2,235,342,577,205,393,1107,328,779,0,0,0,154,0.306163021868787,2156,9.50834879406308
"2019",2021,"Stetson",21,7,33.3,232,634,284,182,0,395,2,277,257,534,197,369,860,271,589,0,0,0,68,0.293103448275862,1852,10.6371490280778
"2020",2021,"Texas",15,5,33.3,481,714,411,267,1,558,2,349,324,673,250,426,1263,431,832,0,0,0,172,0.357588357588358,2507,9.97207818109294
"2021",2021,"UAB",15,5,33.3,279,642,265,187,0,358,3,230,168,398,85,302,881,276,605,0,0,0,89,0.318996415770609,1794,4.73801560758082
"2022",2021,"UC Irvine",12,4,33.3,287,552,365,232,0,389,0,258,247,505,212,360,805,260,545,0,0,0,97,0.337979094076655,1804,11.7516629711752
"2023",2021,"UCLA",15,5,33.3,360,509,274,188,0,335,2,214,202,416,197,252,893,302,591,0,0,0,111,0.308333333333333,1707,11.5407147041593
"2024",2021,"UNC Asheville",15,5,33.3,309,564,274,176,0,377,0,135,175,310,138,322,971,332,639,0,0,0,84,0.271844660194175,1721,8.01859384079024
"2025",2021,"UNC Greensboro",15,5,33.3,241,421,216,127,0,285,2,158,151,309,129,283,716,189,527,0,0,0,54,0.224066390041494,1352,9.5414201183432
"2026",2021,"UTEP",24,8,33.3,371,567,314,188,0,415,2,303,226,529,172,358,914,321,593,0,0,0,139,0.37466307277628,2001,8.59570214892554
"2027",2021,"Utah Valley",15,5,33.3,241,544,253,163,1,311,1,227,223,450,136,323,612,198,414,0,0,0,81,0.336099585062241,1593,8.53735091023227
"2028",2021,"West Virginia",15,5,33.3,402,766,365,246,0,481,1,384,299,683,224,436,1049,380,669,0,0,0,140,0.348258706467662,2443,9.16905444126074
"2029",2021,"William & Mary",6,2,33.3,156,313,146,93,0,241,1,128,121,249,69,194,460,142,318,0,0,0,47,0.301282051282051,968,7.12809917355372
"2030",2022,"Belmont",18,6,33.3,400,754,331,211,0,456,0,363,251,614,276,396,1218,427,791,0,0,0,137,0.3425,2426,11.3767518549052
"2031",2022,"Claflin",3,1,33.3,29,55,19,13,0,37,0,13,25,38,20,49,90,27,63,0,0,0,11,0.379310344827586,179,11.1731843575419
"2032",2022,"Coastal Carolina",12,4,33.3,416,707,358,230,0,458,4,388,321,709,199,460,766,238,528,0,0,0,130,0.3125,2305,8.63340563991323
"2033",2022,"Colorado State",15,5,33.3,282,1010,319,227,0,385,1,315,205,520,162,315,1477,518,959,0,0,0,111,0.393617021276596,2517,6.43623361144219
"2034",2022,"Dartmouth",6,2,33.3,332,642,201,119,0,406,1,179,266,445,164,480,974,273,701,0,0,0,102,0.307228915662651,1956,8.38445807770961
"2035",2022,"Delaware State",3,1,33.3,239,548,238,144,0,275,3,156,162,318,96,490,766,212,554,0,0,0,72,0.301255230125523,1691,5.67711413364873
"2036",2022,"Duquesne",21,7,33.3,315,725,312,198,0,467,1,289,275,564,217,420,1083,369,714,0,0,0,83,0.263492063492063,2198,9.87261146496815
"2037",2022,"Fresno State",33,11,33.3,318,768,300,206,0,414,3,337,271,608,185,339,1134,388,746,0,0,0,92,0.289308176100629,2219,8.33708877872916
"2038",2022,"Georgia State",21,7,33.3,355,648,363,215,0,519,7,321,308,629,240,414,938,289,649,0,0,0,122,0.343661971830986,2114,11.352885525071
"2039",2022,"Hampton",9,3,33.3,363,660,401,237,0,494,3,312,356,668,244,434,925,279,646,0,0,0,103,0.283746556473829,2120,11.5094339622642
"2040",2022,"Harvard",30,10,33.3,401,619,238,148,0,463,0,315,322,637,291,336,1200,406,794,0,0,0,108,0.269326683291771,2127,13.6812411847673
"2041",2022,"High Point",6,2,33.3,235,780,340,205,0,462,2,362,347,709,259,350,982,302,680,0,0,0,84,0.357446808510638,2112,12.2632575757576
"2042",2022,"Illinois State",18,6,33.3,329,796,379,263,0,498,1,357,276,633,172,428,1075,382,693,0,0,0,117,0.355623100303951,2378,7.23296888141295
"2043",2022,"Louisville",12,4,33.3,465,855,316,207,0,535,11,451,283,734,345,470,1372,506,866,0,0,0,171,0.367741935483871,2844,12.1308016877637
"2044",2022,"McNeese",6,2,33.3,442,740,379,246,0,554,2,328,319,647,267,524,1067,342,725,0,0,0,123,0.278280542986425,2455,10.8757637474542
"2045",2022,"Missouri State",15,5,33.3,554,869,454,303,0,596,1,378,293,671,304,441,1395,385,1010,0,0,0,177,0.319494584837545,2727,11.1477814448111
"2046",2022,"Morgan State",12,4,33.3,404,482,271,167,0,410,6,243,222,465,257,374,931,277,654,0,0,0,130,0.321782178217822,1840,13.9673913043478
"2047",2022,"Ohio State",12,4,33.3,336,850,384,258,0,529,2,420,259,679,286,436,1325,495,830,0,0,0,139,0.413690476190476,2633,10.8621344473984
"2048",2022,"Purdue",18,6,33.3,370,778,308,212,0,528,0,377,262,639,216,450,1180,396,784,0,0,0,139,0.375675675675676,2460,8.78048780487805
"2049",2022,"Rutgers",24,8,33.3,471,771,353,215,0,524,2,322,254,576,263,573,1104,360,744,0,0,0,145,0.307855626326964,2593,10.1426918627073
"2050",2022,"Santa Clara",39,13,33.3,403,763,368,264,0,518,2,382,301,683,207,454,1083,354,729,0,0,0,139,0.344913151364764,2440,8.48360655737705
"2051",2022,"Southeast Missouri State",6,2,33.3,391,681,343,214,1,525,1,370,340,710,242,538,973,297,676,0,0,0,149,0.381074168797954,2357,10.2672889266016
"2052",2022,"Stephen F. Austin",6,2,33.3,418,738,440,282,1,516,4,395,307,702,363,475,1094,400,694,0,0,0,152,0.363636363636364,2529,14.3534994068802
"2053",2022,"TCU",12,4,33.3,290,735,348,222,0,514,1,291,284,575,190,473,1044,309,735,0,0,0,97,0.33448275862069,2178,8.72359963269054
"2054",2022,"UC Santa Barbara",15,5,33.3,315,698,336,220,0,384,0,254,209,463,180,414,930,298,632,0,0,0,126,0.4,2058,8.7463556851312
"2055",2022,"UT Martin",15,5,33.3,234,659,317,223,0,469,0,261,229,490,274,446,963,315,648,0,0,0,86,0.367521367521368,1988,13.7826961770624
"2056",2022,"Vanderbilt",18,6,33.3,517,766,397,248,0,574,3,346,310,656,380,593,1389,473,916,0,0,0,162,0.313346228239845,2782,13.6592379583034
"2057",2022,"Virginia",3,1,33.3,376,614,326,186,0,517,6,304,329,633,195,504,862,247,615,0,0,0,111,0.295212765957447,2120,9.19811320754717
"2058",2022,"Wofford",6,2,33.3,376,776,294,201,0,391,3,269,286,555,199,378,1299,422,877,0,0,0,129,0.343085106382979,2299,8.65593736407133
"2059",2023,"BYU",18,6,33.3,376,918,307,207,0,498,2,430,369,799,179,541,998,355,643,0,0,0,125,0.332446808510638,2693,6.64686223542518
"2060",2023,"Boston University",12,4,33.3,348,905,351,233,0,451,1,437,317,754,212,480,1039,383,656,0,0,0,116,0.333333333333333,2639,8.03334596438045
"2061",2023,"Canisius",30,10,33.3,361,708,314,212,0,609,3,310,309,619,237,540,1098,330,768,0,0,0,104,0.28808864265928,2320,10.2155172413793
"2062",2023,"Charleston Southern",21,7,33.3,387,743,257,164,0,559,3,259,255,514,231,620,1220,339,881,0,0,0,110,0.284237726098191,2408,9.59302325581395
"2063",2023,"Dayton",27,9,33.3,423,775,303,196,1,477,4,323,261,584,152,510,1085,356,729,0,0,0,142,0.335697399527187,2455,6.19144602851324
"2064",2023,"Florida Atlantic",9,3,33.3,414,785,433,279,0,519,4,391,349,740,251,537,971,296,675,0,0,0,137,0.330917874396135,2518,9.96822875297855
"2065",2023,"Indiana",15,5,33.3,333,908,432,301,0,517,0,526,272,798,254,404,1111,424,687,0,0,0,141,0.423423423423423,2723,9.3279471171502
"2066",2023,"James Madison",15,5,33.3,449,982,480,317,0,581,2,392,303,695,189,463,1255,400,855,0,0,0,135,0.300668151447661,2814,6.71641791044776
"2067",2023,"Minnesota",33,11,33.3,457,862,372,251,0,529,2,389,336,725,211,532,1211,400,811,0,0,0,148,0.323851203501094,2734,7.71762984637893
"2068",2023,"Niagara",27,9,33.3,565,578,435,272,0,665,5,399,428,827,472,574,1258,348,910,0,0,0,165,0.292035398230089,2558,18.4519155590305
"2069",2023,"North Texas",24,8,33.3,373,697,376,227,0,556,2,365,243,608,258,502,1127,365,762,0,0,0,115,0.308310991957105,2396,10.7679465776294
"2070",2023,"Notre Dame",12,4,33.3,461,906,447,293,0,477,3,504,331,835,266,498,1008,335,673,0,0,0,160,0.3470715835141,2825,9.41592920353982
"2071",2023,"Saint Peter's",21,7,33.3,330,705,328,200,0,510,3,231,311,542,223,678,984,300,684,0,0,0,112,0.339393939393939,2311,9.64950237992211
"2072",2023,"Towson",9,3,33.3,484,867,449,295,0,557,4,411,379,790,247,504,1192,391,801,0,0,0,188,0.388429752066116,2787,8.86257624686042
"2073",2023,"Utah State",3,1,33.3,385,696,367,249,1,551,6,301,426,727,247,482,1043,284,759,0,0,0,131,0.34025974025974,2246,10.9973285841496
"2074",2024,"Alabama State",9,3,33.3,390,669,330,194,0,599,2,265,303,568,201,663,978,249,729,0,0,0,116,0.297435897435897,2307,8.71261378413524
"2075",2024,"Bucknell",18,6,33.3,281,791,357,242,0,436,2,246,212,458,189,471,1125,368,757,0,0,0,94,0.334519572953737,2247,8.41121495327103
"2076",2024,"Canisius",12,4,33.3,374,736,321,197,0,497,2,316,299,615,179,503,1032,333,699,0,0,0,112,0.299465240641711,2340,7.64957264957265
"2077",2024,"Coastal Carolina",12,4,33.3,549,809,524,323,0,584,5,433,398,831,244,593,1016,299,717,0,0,0,189,0.344262295081967,2829,8.62495581477554
"2078",2024,"Columbia",9,3,33.3,455,771,361,231,0,519,0,469,319,788,219,450,1052,359,693,0,0,0,154,0.338461538461538,2572,8.51477449455676
"2079",2024,"Eastern Kentucky",15,5,33.3,531,866,478,309,0,572,2,458,415,873,282,502,1216,402,814,0,0,0,170,0.32015065913371,2877,9.80187695516163
"2080",2024,"George Washington",18,6,33.3,419,787,313,202,0,517,1,288,328,616,199,506,1137,359,778,0,0,0,118,0.281622911694511,2432,8.18256578947368
"2081",2024,"Green Bay",9,3,33.3,353,841,331,241,0,424,0,359,223,582,240,360,1331,555,776,0,0,0,124,0.351274787535411,2546,9.42655145326002
"2082",2024,"Illinois-Springfield",3,1,33.3,17,18,17,9,0,19,0,10,11,21,16,14,49,15,34,0,0,0,8,0.470588235294118,76,21.0526315789474
"2083",2024,"Long Beach State",24,8,33.3,497,870,429,271,0,609,4,435,348,783,352,668,1218,378,840,0,0,0,161,0.323943661971831,2939,11.9768628785301
"2084",2024,"Miami",18,6,33.3,429,770,313,186,1,504,4,407,310,717,272,499,1134,390,744,0,0,0,135,0.314685314685315,2584,10.5263157894737
"2085",2024,"Mississippi Valley State",6,2,33.3,443,683,390,230,0,632,4,283,364,647,299,558,1203,320,883,0,0,0,122,0.275395033860045,2377,12.5788809423643
"2086",2024,"Navy",21,7,33.3,402,787,317,197,0,550,0,265,233,498,266,449,1411,461,950,0,0,0,113,0.281094527363184,2437,10.9150594993845
"2087",2024,"New Orleans",33,11,33.3,392,775,436,295,1,525,2,359,449,808,273,511,1040,290,750,0,0,0,104,0.26530612244898,2435,11.211498973306
"2088",2024,"Nicholls",30,10,33.3,383,806,354,227,0,586,2,359,341,700,290,467,1213,382,831,0,0,0,127,0.331592689295039,2484,11.6747181964573
"2089",2024,"Northeastern",9,3,33.3,302,626,258,154,0,402,5,274,235,509,173,460,901,305,596,0,0,0,100,0.33112582781457,2028,8.53057199211045
"2090",2024,"Northern Arizona",9,3,33.3,381,876,359,262,0,573,0,404,377,781,232,419,1287,456,831,0,0,0,118,0.309711286089239,2628,8.82800608828006
"2091",2024,"Ohio",9,3,33.3,301,634,360,230,0,508,2,381,408,789,314,513,824,250,574,0,0,0,98,0.325581395348837,2173,14.4500690289922
"2092",2024,"Portland",18,6,33.3,457,792,436,276,0,607,4,487,377,864,365,584,1060,332,728,0,0,0,165,0.361050328227571,2754,13.2534495279593
"2093",2024,"South Carolina State",6,2,33.3,314,652,335,207,1,448,2,216,235,451,194,623,868,243,625,0,0,0,79,0.251592356687898,2107,9.20740389178927
"2094",2024,"South Carolina Upstate",27,9,33.3,381,768,359,238,0,517,0,313,313,626,223,587,1029,330,699,0,0,0,133,0.349081364829396,2471,9.02468636179684
"2095",2024,"St. Bonaventure",6,2,33.3,335,696,305,203,0,456,1,234,266,500,185,492,1116,346,770,0,0,0,107,0.319402985074627,2177,8.49793293523197
"2096",2024,"Texas",12,4,33.3,572,980,594,387,0,652,2,564,346,910,334,520,1447,591,856,0,0,0,224,0.391608391608392,3396,9.83510011778563
"2097",2024,"UConn",6,2,33.3,413,1078,413,288,0,553,2,568,294,862,377,492,1469,580,889,0,0,0,133,0.322033898305085,3273,11.5184845707302
"2098",2024,"UNLV",12,4,33.3,420,985,359,256,2,457,1,444,311,755,231,344,1368,540,828,0,0,0,177,0.421428571428571,2844,8.12236286919831
"2099",2024,"Valparaiso",12,4,33.3,266,646,370,239,0,623,1,366,354,720,272,549,892,270,622,0,0,0,80,0.300751879699248,2187,12.4371284865112
"2100",2024,"West Virginia",18,6,33.3,437,741,479,304,0,573,1,543,386,929,449,493,1035,334,701,0,0,0,161,0.368421052631579,2671,16.8101834518907
"2101",2024,"Wyoming",27,9,33.3,291,865,282,195,0,493,0,470,289,759,186,438,1019,338,681,0,0,0,123,0.422680412371134,2469,7.53341433778858
"2102",2023,"Fairfield",40,13,32.5,402,749,354,207,0,495,3,324,353,677,254,556,1067,338,729,0,0,0,135,0.335820895522388,2458,10.33360455655
"2103",2023,"Wisconsin",31,10,32.3,312,676,320,225,1,449,1,323,229,552,235,484,1063,367,696,0,0,0,106,0.33974358974359,2242,10.4817127564674
"2104",2022,"Tennessee State",28,9,32.1,424,621,343,223,0,606,4,307,272,579,365,582,1218,416,802,0,0,0,158,0.372641509433962,2418,15.0951199338296
"2105",2024,"Montana State",28,9,32.1,401,745,383,263,0,518,0,304,319,623,301,501,1135,355,780,0,0,0,120,0.29925187032419,2393,12.5783535311325
"2106",2024,"Virginia Tech",28,9,32.1,422,956,305,215,0,516,0,306,162,468,132,415,1574,617,957,0,0,0,159,0.376777251184834,2800,4.71428571428571
"2107",2022,"Eastern Illinois",25,8,32,411,717,336,237,1,529,0,339,345,684,331,475,1109,407,702,0,0,0,135,0.328467153284672,2429,13.6270069987649
"2108",2022,"Georgia",25,8,32,448,819,329,221,1,441,3,387,262,649,254,481,1223,418,805,0,0,0,168,0.375,2636,9.63581183611533
"2109",2022,"Rider",25,8,32,275,725,286,188,0,455,2,310,294,604,251,510,1010,326,684,0,0,0,76,0.276363636363636,2218,11.3165013525699
"2110",2023,"North Alabama",25,8,32,314,737,244,166,1,517,4,340,338,678,193,409,1069,364,705,0,0,0,108,0.343949044585987,2228,8.6624775583483
"2111",2024,"American University",25,8,32,327,706,352,223,0,536,1,343,297,640,248,496,1069,339,730,0,0,0,95,0.290519877675841,2303,10.7685627442466
"2112",2024,"North Florida",25,8,32,355,730,312,194,0,510,0,392,322,714,197,503,1039,302,737,0,0,0,106,0.298591549295775,2352,8.37585034013605
"2113",2021,"Ohio",22,7,31.8,291,544,299,198,0,399,1,331,277,608,254,315,845,283,562,0,0,0,93,0.319587628865979,1837,13.826891671203
"2114",2022,"Northern Iowa",22,7,31.8,380,889,365,255,0,474,0,385,277,662,215,418,1280,420,860,0,0,0,119,0.313157894736842,2576,8.34627329192547
"2115",2022,"SIU Edwardsville",22,7,31.8,485,689,462,301,0,585,3,415,362,777,330,614,1140,356,784,0,0,0,162,0.334020618556701,2676,12.3318385650224
"2116",2022,"Samford",22,7,31.8,378,720,324,207,0,428,0,364,295,659,221,529,922,293,629,0,0,0,126,0.333333333333333,2368,9.33277027027027
"2117",2022,"UTEP",22,7,31.8,457,635,435,279,0,506,1,283,234,517,213,473,1080,348,732,0,0,0,171,0.37417943107221,2295,9.28104575163399
"2118",2023,"Drexel",22,7,31.8,332,678,316,221,0,486,2,318,194,512,246,376,1236,469,767,0,0,0,123,0.370481927710843,2249,10.9381947532237
"2119",2023,"Louisville",22,7,31.8,515,966,458,315,0,669,9,480,298,778,317,566,1546,565,981,0,0,0,188,0.36504854368932,3228,9.82032218091698
"2120",2024,"Eastern Michigan",22,7,31.8,374,707,295,192,0,523,5,329,327,656,239,541,1011,286,725,0,0,0,112,0.299465240641711,2307,10.3597745990464
"2121",2021,"Georgia State",19,6,31.6,285,555,299,180,0,393,6,279,248,527,181,332,756,220,536,0,0,0,107,0.375438596491228,1737,10.4202648244099
"2122",2021,"Western Kentucky",19,6,31.6,349,524,300,179,0,349,2,274,247,521,189,379,749,204,545,0,0,0,103,0.29512893982808,1813,10.4247104247104
"2123",2022,"Clemson",19,6,31.6,408,657,357,233,0,496,4,365,296,661,262,472,1110,329,781,0,0,0,117,0.286764705882353,2306,11.3616652211622
"2124",2022,"George Washington",19,6,31.6,439,740,310,172,0,470,0,283,318,601,221,441,1095,301,794,0,0,0,112,0.255125284738041,2276,9.71001757469244
"2125",2022,"Indiana State",19,6,31.6,426,669,320,207,0,616,2,350,278,628,313,522,1177,414,763,0,0,0,151,0.354460093896714,2465,12.6977687626775
"2126",2022,"Pepperdine",19,6,31.6,300,554,230,141,0,382,3,282,255,537,177,376,794,253,541,0,0,0,99,0.33,1824,9.70394736842105
"2127",2022,"UNLV",19,6,31.6,440,951,437,294,0,465,3,477,354,831,225,469,1161,428,733,0,0,0,172,0.390909090909091,2855,7.88091068301226
"2128",2023,"Iowa",19,6,31.6,346,1136,538,380,0,574,3,636,257,893,285,546,1418,539,879,0,0,0,118,0.341040462427746,3360,8.48214285714286
"2129",2023,"Morgan State",19,6,31.6,385,522,287,191,0,461,2,275,254,529,261,391,949,282,667,0,0,0,100,0.25974025974026,1925,13.5584415584416
"2130",2023,"Radford",19,6,31.6,318,856,360,233,0,497,0,385,277,662,260,561,1057,342,715,0,0,0,113,0.355345911949686,2563,10.1443620756925
"2131",2023,"Santa Clara",19,6,31.6,386,801,332,236,0,526,2,454,361,815,203,412,1132,382,750,0,0,0,136,0.352331606217617,2519,8.05875347360064
"2132",2023,"Seattle U",19,6,31.6,379,733,339,216,0,573,1,326,336,662,194,595,1015,304,711,0,0,0,113,0.298153034300792,2397,8.09345014601585
"2133",2023,"Utah Valley",19,6,31.6,286,720,304,200,0,495,2,296,300,596,247,487,938,292,646,0,0,0,96,0.335664335664336,2159,11.4404817044928
"2134",2024,"Abilene Christian",19,6,31.6,454,735,366,241,0,469,2,346,288,634,220,459,1106,372,734,0,0,0,160,0.352422907488987,2461,8.93945550589191
"2135",2024,"Idaho State",19,6,31.6,397,743,315,208,0,530,3,311,291,602,237,451,1144,348,796,0,0,0,126,0.317380352644836,2320,10.2155172413793
"2136",2024,"Lindenwood",19,6,31.6,366,550,374,224,0,587,0,261,239,500,238,409,1154,407,747,0,0,0,122,0.333333333333333,2081,11.4368092263335
"2137",2022,"Drexel",35,11,31.4,427,823,293,208,0,467,2,367,240,607,248,376,1400,483,917,0,0,0,149,0.348946135831382,2551,9.72167777342219
"2138",2021,"Eastern Michigan",16,5,31.2,272,566,261,166,0,414,1,255,243,498,176,301,735,209,526,0,0,0,90,0.330882352941176,1660,10.6024096385542
"2139",2021,"Jacksonville State",16,5,31.2,322,666,277,166,0,356,0,264,216,480,133,313,958,300,658,0,0,0,105,0.326086956521739,1935,6.8733850129199
"2140",2021,"Lamar",16,5,31.2,261,503,276,188,0,420,1,224,216,440,210,344,849,269,580,0,0,0,91,0.348659003831418,1655,12.6888217522659
"2141",2021,"Manhattan",16,5,31.2,310,524,237,149,1,320,0,186,215,401,169,327,762,209,553,0,0,0,94,0.303225806451613,1618,10.4449938195303
"2142",2022,"Arkansas",16,5,31.2,435,872,476,295,0,523,2,455,410,865,237,356,1174,378,796,0,0,0,147,0.337931034482759,2609,9.08394020697585
"2143",2022,"Bradley",16,5,31.2,301,685,298,185,0,454,1,163,156,319,139,396,1183,381,802,0,0,0,94,0.312292358803987,1983,7.0095814422592
"2144",2022,"Norfolk State",16,5,31.2,434,636,361,221,0,519,6,345,310,655,327,460,937,244,693,0,0,0,133,0.306451612903226,2191,14.924691921497
"2145",2022,"Southern Utah",16,5,31.2,423,857,410,272,0,433,3,389,352,741,197,443,1088,376,712,0,0,0,143,0.33806146572104,2585,7.62088974854932
"2146",2023,"Alabama",16,5,31.2,361,766,323,216,0,531,2,397,316,713,274,483,1040,376,664,0,0,0,99,0.274238227146814,2461,11.1336854937017
"2147",2023,"Florida A&M",32,10,31.2,361,596,290,168,0,483,4,216,268,484,261,531,962,338,624,0,0,0,99,0.274238227146814,2107,12.3872804935928
"2148",2023,"Florida State",16,5,31.2,440,1010,520,353,0,561,5,477,371,848,265,446,1337,447,890,0,0,0,163,0.370454545454545,2962,8.94665766374072
"2149",2023,"Howard",16,5,31.2,375,687,353,211,0,470,2,210,248,458,193,405,1073,327,746,0,0,0,114,0.304,2083,9.26548247719635
"2150",2023,"McNeese",16,5,31.2,371,833,469,293,0,579,8,403,336,739,276,614,944,288,656,0,0,0,129,0.347708894878706,2625,10.5142857142857
"2151",2023,"North Carolina Central",16,5,31.2,465,796,488,294,0,645,6,388,333,721,299,621,1176,356,820,0,0,0,146,0.313978494623656,2753,10.8608790410461
"2152",2023,"Temple",16,5,31.2,410,730,333,219,0,534,15,304,334,638,217,452,1114,354,760,0,0,0,116,0.282926829268293,2326,9.32932072226999
"2153",2023,"Wyoming",16,5,31.2,369,911,338,240,0,491,0,479,352,831,197,459,1001,339,662,0,0,0,148,0.401084010840108,2641,7.45929572131768
"2154",2024,"Arizona",32,10,31.2,409,752,412,283,0,634,4,506,408,914,398,510,1106,385,721,0,0,0,128,0.312958435207824,2668,14.9175412293853
"2155",2024,"Ball State",16,5,31.2,365,833,453,295,0,539,2,447,296,743,355,488,1246,436,810,0,0,0,121,0.331506849315069,2696,13.1676557863501
"2156",2024,"Georgetown",16,5,31.2,462,863,347,225,1,571,1,409,335,744,229,537,1182,359,823,0,0,0,163,0.352813852813853,2732,8.38213762811127
"2157",2024,"Morgan State",16,5,31.2,414,572,286,180,0,478,2,275,332,607,288,490,999,277,722,0,0,0,108,0.260869565217391,2097,13.7339055793991
"2158",2024,"Providence",16,5,31.2,420,898,406,253,0,530,2,434,420,854,244,654,911,280,631,0,0,0,122,0.29047619047619,2780,8.77697841726619
"2159",2024,"Vanderbilt",16,5,31.2,494,807,417,271,0,535,5,429,337,766,331,484,1248,394,854,0,0,0,164,0.331983805668016,2729,12.1289849761818
"2160",2022,"Incarnate Word",58,18,31,427,721,380,238,0,494,0,289,294,583,245,513,1084,338,746,0,0,0,137,0.320843091334895,2380,10.2941176470588
"2161",2024,"Western Kentucky",29,9,31,380,718,367,235,1,557,4,325,288,613,343,474,1290,417,873,0,0,0,130,0.342105263157895,2404,14.2678868552413
"2162",2021,"Davidson",13,4,30.8,259,538,239,148,0,373,2,223,209,432,112,300,871,276,595,0,0,0,84,0.324324324324324,1654,6.7714631197098
"2163",2021,"Indiana State",13,4,30.8,273,475,258,161,0,373,1,222,221,443,163,302,782,236,546,0,0,0,79,0.289377289377289,1576,10.3426395939086
"2164",2021,"Navy",13,4,30.8,145,302,115,78,0,189,1,126,106,232,84,189,404,120,284,0,0,0,40,0.275862068965517,909,9.24092409240924
"2165",2021,"Norfolk State",13,4,30.8,196,301,183,110,0,218,0,117,126,243,128,216,402,111,291,0,0,0,43,0.219387755102041,984,13.0081300813008
"2166",2021,"Oregon",13,4,30.8,283,577,177,115,0,316,4,272,199,471,177,285,863,315,548,0,0,0,109,0.385159010600707,1787,9.90486849468383
"2167",2021,"Southern Utah",13,4,30.8,298,605,272,197,0,347,2,304,311,615,135,330,579,189,390,0,0,0,90,0.302013422818792,1785,7.56302521008403
"2168",2022,"Boston University",13,4,30.8,386,858,292,179,1,465,1,300,274,574,184,500,1177,440,737,0,0,0,126,0.326424870466321,2560,7.1875
"2169",2022,"Charleston Southern",13,4,30.8,279,713,249,139,0,483,0,206,213,419,183,610,1060,319,741,0,0,0,91,0.326164874551971,2178,8.40220385674931
"2170",2022,"Howard",13,4,30.8,421,673,376,230,0,437,0,275,262,537,232,425,995,274,721,0,0,0,135,0.320665083135392,2158,10.7506950880445
"2171",2022,"Pacific",26,8,30.8,373,758,376,239,0,559,1,378,366,744,226,488,1064,342,722,0,0,0,123,0.329758713136729,2425,9.31958762886598
"2172",2022,"Towson",13,4,30.8,554,924,437,287,0,472,12,396,357,753,250,444,1324,434,890,0,0,0,186,0.335740072202166,2868,8.71687587168759
"2173",2022,"UCLA",13,4,30.8,418,765,312,218,0,508,3,339,278,617,205,388,1206,394,812,0,0,0,155,0.370813397129187,2390,8.57740585774059
"2174",2023,"Lamar",26,8,30.8,386,799,305,206,0,493,3,348,276,624,188,517,1078,385,693,0,0,0,121,0.313471502590674,2505,7.50499001996008
"2175",2023,"Liberty",13,4,30.8,437,866,352,225,0,537,1,457,306,763,188,480,1076,385,691,0,0,0,173,0.395881006864989,2717,6.9193963930806
"2176",2024,"Charlotte",26,8,30.8,437,779,448,297,0,523,7,323,313,636,265,535,1050,331,719,0,0,0,136,0.311212814645309,2514,10.5409705648369
"2177",2024,"Jacksonville State",13,4,30.8,392,749,306,193,0,443,2,320,331,651,199,458,1081,301,780,0,0,0,115,0.293367346938776,2300,8.65217391304348
"2178",2024,"Kentucky",13,4,30.8,438,662,415,243,0,462,3,383,339,722,190,440,993,313,680,0,0,0,161,0.367579908675799,2343,8.10926163038839
"2179",2024,"Michigan",13,4,30.8,462,819,379,254,0,571,1,412,343,755,222,511,1276,465,811,0,0,0,163,0.352813852813853,2764,8.03183791606368
"2180",2021,"Northern Colorado",36,11,30.6,349,702,344,221,0,431,0,319,288,607,179,403,818,274,544,0,0,0,135,0.386819484240688,2127,8.41560883874001
"2181",2022,"Idaho State",23,7,30.4,383,737,254,178,0,536,1,359,282,641,280,445,1272,435,837,0,0,0,116,0.302872062663185,2422,11.5606936416185
"2182",2022,"Indiana",23,7,30.4,341,903,412,284,0,504,2,428,280,708,216,430,1208,437,771,0,0,0,121,0.354838709677419,2655,8.13559322033898
"2183",2023,"Cal State Fullerton",23,7,30.4,287,746,362,247,0,443,1,286,261,547,220,441,1074,370,704,0,0,0,94,0.327526132404181,2226,9.88319856244385
"2184",2023,"Delaware",23,7,30.4,399,852,383,251,0,567,13,337,276,613,237,568,1122,375,747,0,0,0,121,0.303258145363409,2632,9.00455927051672
"2185",2023,"Lipscomb",23,7,30.4,369,897,397,251,0,506,0,399,310,709,176,489,1087,383,704,0,0,0,131,0.355013550135501,2649,6.64401661004153
"2186",2023,"Rice",23,7,30.4,420,786,453,299,0,603,3,434,274,708,237,513,1154,379,775,0,0,0,151,0.35952380952381,2636,8.99089529590288
"2187",2024,"Charleston Southern",23,7,30.4,439,765,308,193,0,474,3,320,313,633,204,568,1073,351,722,0,0,0,157,0.357630979498861,2518,8.10166799046863
"2188",2024,"Georgia Southern",23,7,30.4,658,945,499,303,0,642,11,496,406,902,331,599,1401,406,995,0,0,0,226,0.343465045592705,3208,10.3179551122195
"2189",2024,"Lehigh",23,7,30.4,291,826,358,251,0,399,0,299,219,518,206,482,1161,413,748,0,0,0,104,0.357388316151203,2390,8.61924686192468
"2190",2024,"Howard",33,10,30.3,456,783,431,268,0,534,1,237,305,542,270,498,1176,372,804,0,0,0,139,0.304824561403509,2433,11.0974106041924
"2191",2024,"SE Louisiana",33,10,30.3,345,851,413,263,0,552,3,338,249,587,248,414,1237,395,842,0,0,0,120,0.347826086956522,2447,10.1348590110339
"2192",2021,"George Mason",10,3,30,333,581,236,150,1,332,1,168,211,379,104,380,858,212,646,0,0,0,97,0.291291291291291,1725,6.02898550724638
"2193",2021,"James Madison",10,3,30,301,556,234,161,0,342,2,256,205,461,110,342,735,241,494,0,0,0,96,0.318936877076412,1749,6.28930817610063
"2194",2021,"Kentucky",20,6,30,341,621,284,188,0,428,1,300,220,520,226,328,1121,406,715,0,0,0,109,0.319648093841642,2074,10.8968177434908
"2195",2021,"Marquette",10,3,30,299,606,230,151,0,318,0,353,252,605,175,340,758,280,478,0,0,0,105,0.351170568561873,1943,9.00669068450849
"2196",2021,"Southern Illinois",10,3,30,277,538,245,148,0,390,0,297,275,572,172,324,756,247,509,0,0,0,96,0.346570397111913,1735,9.9135446685879
"2197",2021,"Southern Miss",10,3,30,306,453,215,124,0,370,0,255,161,416,149,336,751,241,510,0,0,0,102,0.333333333333333,1632,9.12990196078431
"2198",2021,"Syracuse",10,3,30,345,606,306,199,0,372,1,302,224,526,167,375,902,284,618,0,0,0,112,0.32463768115942,1988,8.40040241448692
"2199",2021,"UNLV",10,3,30,313,643,369,242,0,305,0,286,297,583,157,321,717,226,491,0,0,0,100,0.319488817891374,1870,8.39572192513369
"2200",2022,"Arkansas State",10,3,30,427,722,421,275,0,544,4,408,324,732,256,414,1108,368,740,0,0,0,156,0.365339578454333,2439,10.4961049610496
"2201",2022,"Davidson",30,9,30,382,706,264,181,0,530,2,295,269,564,180,456,1146,407,739,0,0,0,130,0.340314136125654,2302,7.81928757602085
"2202",2022,"Denver",10,3,30,310,751,342,239,0,468,2,265,271,536,179,447,1115,373,742,0,0,0,111,0.358064516129032,2230,8.02690582959641
"2203",2022,"Jackson State",10,3,30,515,886,497,314,1,460,4,467,322,789,243,443,1045,346,699,0,0,0,216,0.419417475728155,2756,8.81712626995646
"2204",2022,"Rice",20,6,30,392,694,400,260,0,440,2,292,203,495,192,455,1005,309,696,0,0,0,145,0.369897959183673,2242,8.56378233719893
"2205",2022,"Western Illinois",20,6,30,292,803,392,239,0,399,2,309,255,564,236,419,1181,416,765,0,0,0,108,0.36986301369863,2322,10.1636520241171
"2206",2023,"Air Force",30,9,30,374,653,344,229,0,524,5,306,275,581,338,419,1256,426,830,0,0,0,146,0.390374331550802,2268,14.9029982363316
"2207",2023,"Auburn",10,3,30,424,725,429,264,0,610,1,387,333,720,308,491,1194,380,814,0,0,0,136,0.320754716981132,2504,12.3003194888179
"2208",2023,"Gonzaga",20,6,30,426,818,342,249,0,511,5,394,305,699,257,473,1211,461,750,0,0,0,159,0.373239436619718,2661,9.65802329951146
"2209",2023,"Iona",20,6,30,257,809,230,143,0,471,1,406,260,666,259,617,1026,395,631,0,0,0,77,0.299610894941634,2531,10.2331094429079
"2210",2023,"Louisiana",20,6,30,478,718,430,254,0,529,4,316,259,575,271,496,1165,330,835,0,0,0,143,0.299163179916318,2430,11.1522633744856
"2211",2023,"Missouri",10,3,30,330,783,315,210,1,561,1,367,254,621,234,490,1111,383,728,0,0,0,112,0.339393939393939,2425,9.64948453608247
"2212",2023,"Siena",20,6,30,458,834,384,246,0,577,1,418,347,765,300,581,1192,387,805,0,0,0,152,0.331877729257642,2769,10.8342361863489
"2213",2024,"Cal Poly",20,6,30,383,722,323,220,0,576,5,366,358,724,276,576,873,287,586,0,0,0,123,0.321148825065274,2406,11.4713216957606
"2214",2024,"Florida Atlantic",20,6,30,370,762,383,228,1,451,2,350,329,679,189,513,941,293,648,0,0,0,113,0.305405405405405,2376,7.95454545454545
"2215",2024,"Northern Colorado",20,6,30,379,788,416,265,0,484,1,407,355,762,239,537,888,303,585,0,0,0,130,0.343007915567282,2510,9.52191235059761
"2216",2024,"Stony Brook",10,3,30,448,987,389,276,1,468,2,440,343,783,245,513,1179,398,781,0,0,0,155,0.345982142857143,2899,8.45119006553984
"2217",2024,"Tennessee",10,3,30,452,996,442,301,0,485,1,436,297,733,158,492,1362,472,890,0,0,0,153,0.338495575221239,2969,5.32165712361064
"2218",2024,"UMass Lowell",20,6,30,292,660,263,155,0,426,2,292,348,640,228,468,946,297,649,0,0,0,91,0.311643835616438,2075,10.9879518072289
"2219",2021,"Mercer",27,8,29.6,360,607,261,171,0,401,0,250,186,436,224,282,1202,419,783,0,0,0,125,0.347222222222222,1988,11.2676056338028
"2220",2023,"Mercer",27,8,29.6,290,651,234,174,0,470,1,254,158,412,153,396,1123,421,702,0,0,0,98,0.337931034482759,2067,7.40203193033382
"2221",2021,"Campbell",17,5,29.4,277,573,195,111,0,319,2,248,256,504,162,309,741,232,509,0,0,0,79,0.285198555956679,1687,9.60284528749259
"2222",2022,"Cal State Fullerton",17,5,29.4,326,705,367,230,0,500,1,293,251,544,218,465,1048,348,700,0,0,0,98,0.300613496932515,2224,9.8021582733813
"2223",2022,"UIC",17,5,29.4,289,538,386,230,0,472,0,203,226,429,224,468,882,272,610,0,0,0,88,0.304498269896194,1855,12.0754716981132
"2224",2023,"Alabama State",17,5,29.4,361,652,398,258,0,490,1,321,303,624,203,525,924,295,629,0,0,0,109,0.301939058171745,2248,9.03024911032028
"2225",2023,"Charlotte",17,5,29.4,387,802,376,254,0,550,3,335,250,585,196,505,1141,371,770,0,0,0,139,0.359173126614987,2507,7.81810929397686
"2226",2023,"Marist",17,5,29.4,345,751,393,263,0,381,2,266,277,543,228,451,1104,327,777,0,0,0,98,0.284057971014493,2247,10.1468624833111
"2227",2023,"Marquette",17,5,29.4,411,837,279,198,0,464,0,387,351,738,252,432,1206,403,803,0,0,0,120,0.291970802919708,2537,9.9329917225069
"2228",2023,"Murray State",17,5,29.4,365,821,339,247,0,418,0,367,254,621,177,434,1140,391,749,0,0,0,127,0.347945205479452,2457,7.2039072039072
"2229",2023,"Purdue",17,5,29.4,329,812,322,228,0,488,2,400,223,623,230,460,1098,375,723,0,0,0,133,0.404255319148936,2472,9.3042071197411
"2230",2024,"NJIT",17,5,29.4,386,747,352,224,0,471,0,360,393,753,212,537,887,272,615,0,0,0,117,0.303108808290155,2386,8.88516345347863
"2231",2024,"Pittsburgh",17,5,29.4,457,821,359,231,0,521,7,384,326,710,205,561,1143,349,794,0,0,0,161,0.352297592997812,2662,7.70097670924117
"2232",2024,"Quinnipiac",34,10,29.4,315,770,318,208,0,532,1,309,238,547,180,504,1089,347,742,0,0,0,95,0.301587301587302,2319,7.76196636481242
"2233",2024,"Seton Hall",17,5,29.4,355,754,326,221,0,506,3,401,348,749,278,439,1102,360,742,0,0,0,106,0.298591549295775,2390,11.6317991631799
"2234",2022,"Charleston",24,7,29.2,463,739,337,232,0,454,2,430,303,733,340,398,1343,395,948,0,0,0,150,0.323974082073434,2493,13.6381869233855
"2235",2022,"Chattanooga",24,7,29.2,323,737,346,227,0,482,0,281,257,538,166,480,1083,344,739,0,0,0,110,0.340557275541796,2246,7.39091718610864
"2236",2022,"New Hampshire",24,7,29.2,364,582,341,209,0,493,1,296,358,654,246,485,828,241,587,0,0,0,107,0.293956043956044,2045,12.0293398533007
"2237",2023,"Alabama A&M",24,7,29.2,397,731,341,222,0,403,0,245,323,568,165,465,957,288,669,0,0,0,101,0.254408060453401,2206,7.47960108794198
"2238",2023,"Omaha",24,7,29.2,290,822,407,289,0,546,4,379,326,705,242,493,1118,361,757,0,0,0,101,0.348275862068965,2456,9.85342019543974
"2239",2021,"Wake Forest",31,9,29,284,611,307,212,0,379,1,271,227,498,151,333,950,323,627,0,0,0,81,0.285211267605634,1909,7.90990047145102
"2240",2022,"Florida Atlantic",31,9,29,352,741,325,222,0,442,0,261,273,534,165,460,1042,335,707,0,0,0,106,0.301136363636364,2225,7.41573033707865
"2241",2024,"Memphis",31,9,29,608,697,404,237,0,633,6,385,366,751,320,488,1286,372,914,0,0,0,187,0.307565789473684,2654,12.0572720422005
"2242",2024,"William & Mary",31,9,29,320,742,367,248,0,520,3,338,315,653,249,482,1005,307,698,0,0,0,98,0.30625,2262,11.0079575596817
"2243",2024,"UNC Asheville",45,13,28.9,465,766,334,212,0,501,4,237,249,486,177,454,1268,415,853,0,0,0,147,0.316129032258064,2418,7.32009925558313
"2244",2021,"Arkansas State",7,2,28.6,271,533,250,159,1,324,2,220,217,437,140,314,677,217,460,0,0,0,99,0.365313653136531,1623,8.62600123228589
"2245",2021,"Bryant",14,4,28.6,259,563,211,129,0,363,1,250,290,540,160,440,646,206,440,0,0,0,79,0.305019305019305,1770,9.03954802259887
"2246",2021,"DePaul",14,4,28.6,337,504,258,182,0,360,1,300,291,591,255,307,1013,370,643,0,0,0,113,0.335311572700297,1887,13.5135135135135
"2247",2021,"Jackson State",7,2,28.6,415,666,395,247,0,407,3,284,230,514,191,432,809,261,548,0,0,0,149,0.359036144578313,2150,8.88372093023256
"2248",2021,"Liberty",14,4,28.6,367,738,303,191,0,467,0,419,322,741,195,405,914,321,593,0,0,0,134,0.365122615803815,2322,8.39793281653747
"2249",2021,"Minnesota",7,2,28.6,299,504,264,176,1,340,1,184,174,358,129,323,913,326,587,0,0,0,99,0.331103678929766,1689,7.63765541740675
"2250",2021,"New Hampshire",14,4,28.6,201,383,190,124,0,285,0,176,241,417,131,300,517,144,373,0,0,0,53,0.263681592039801,1242,10.5475040257649
"2251",2021,"North Dakota",14,4,28.6,301,470,253,156,0,366,2,178,203,381,107,256,697,215,482,0,0,0,111,0.368770764119601,1487,7.19569603227976
"2252",2021,"Northern Arizona",14,4,28.6,326,691,276,179,0,452,0,328,247,575,202,351,1134,400,734,0,0,0,110,0.337423312883436,2170,9.30875576036866
"2253",2021,"Seattle U",7,2,28.6,301,593,288,170,0,393,3,295,283,578,231,337,825,259,566,0,0,0,101,0.335548172757475,1852,12.4730021598272
"2254",2021,"St. Francis (PA)",7,2,28.6,230,485,215,157,0,270,2,221,201,422,127,319,616,200,416,0,0,0,73,0.317391304347826,1503,8.44976713240186
"2255",2022,"Butler",7,2,28.6,292,683,239,154,0,403,0,317,257,574,138,558,934,269,665,0,0,0,94,0.321917808219178,2182,6.32447296058662
"2256",2022,"Colorado",21,6,28.6,444,753,402,251,0,537,1,456,386,842,331,437,953,286,667,0,0,0,172,0.387387387387387,2468,13.4116693679092
"2257",2022,"NC State",14,4,28.6,455,1074,381,267,0,475,2,497,320,817,267,433,1415,543,872,0,0,0,164,0.36043956043956,3120,8.55769230769231
"2258",2022,"Northwestern",14,4,28.6,407,668,353,227,0,442,1,270,277,547,270,373,1112,376,736,0,0,0,117,0.287469287469287,2173,12.4252185918086
"2259",2022,"Stanford",21,6,28.6,504,1035,430,274,1,579,0,537,360,897,308,482,1296,442,854,0,0,0,160,0.317460317460317,3137,9.81829773669111
"2260",2022,"UConn",7,2,28.6,430,998,355,230,1,513,1,556,255,811,321,502,1345,471,874,0,0,0,147,0.341860465116279,3078,10.4288499025341
"2261",2023,"Albany",14,4,28.6,335,779,314,213,0,416,0,327,314,641,184,452,985,348,637,0,0,0,88,0.262686567164179,2336,7.87671232876712
"2262",2023,"Bucknell",14,4,28.6,237,798,342,221,0,391,1,316,296,612,121,412,927,312,615,0,0,0,80,0.337552742616034,2162,5.59666975023127
"2263",2023,"Cal State-Los Angeles",7,2,28.6,20,31,10,5,0,22,0,11,17,28,12,19,45,10,35,0,0,0,6,0.3,93,12.9032258064516
"2264",2023,"Gardner-Webb",7,2,28.6,511,769,511,329,0,654,12,439,342,781,330,521,1349,492,857,0,0,0,183,0.35812133072407,2858,11.5465360391882
"2265",2023,"High Point",7,2,28.6,276,781,326,203,0,493,5,351,263,614,239,453,1146,406,740,0,0,0,93,0.33695652173913,2345,10.1918976545842
"2266",2023,"Kansas City",14,4,28.6,416,765,367,249,0,559,2,348,323,671,247,541,1173,386,787,0,0,0,151,0.362980769230769,2544,9.70911949685535
"2267",2023,"Little Rock",14,4,28.6,407,759,408,254,0,516,2,305,237,542,240,465,1145,339,806,0,0,0,120,0.294840294840295,2371,10.1223112610713
"2268",2023,"Louisiana Tech",21,6,28.6,302,807,382,270,0,484,2,334,276,610,163,461,1053,382,671,0,0,0,107,0.354304635761589,2379,6.85161832702816
"2269",2023,"Loyola Maryland",21,6,28.6,355,711,330,214,0,517,0,287,310,597,197,528,1026,335,691,0,0,0,101,0.284507042253521,2316,8.50604490500864
"2270",2023,"Maryland-Eastern Shore",14,4,28.6,455,724,428,271,0,507,1,286,276,562,238,524,1029,311,718,0,0,0,141,0.30989010989011,2395,9.93736951983299
"2271",2023,"Milwaukee",21,6,28.6,299,777,258,173,0,469,0,337,224,561,156,495,1052,331,721,0,0,0,90,0.301003344481605,2299,6.78555893866899
"2272",2023,"Presbyterian",28,8,28.6,350,851,245,148,0,480,1,358,260,618,185,595,1100,389,711,0,0,0,126,0.36,2603,7.10718401844026
"2273",2023,"Stephen F. Austin",7,2,28.6,487,829,501,328,0,554,5,541,395,936,314,522,926,320,606,0,0,0,186,0.381930184804928,2818,11.1426543647977
"2274",2023,"UNC Wilmington",14,4,28.6,386,703,300,208,0,447,3,303,279,582,193,565,972,276,696,0,0,0,124,0.321243523316062,2308,8.36221837088388
"2275",2023,"Weber State",14,4,28.6,344,814,450,303,0,663,3,306,358,664,211,550,988,285,703,0,0,0,127,0.369186046511628,2408,8.7624584717608
"2276",2024,"Appalachian State",14,4,28.6,440,754,481,303,2,544,2,357,349,706,254,524,1163,370,793,0,0,0,126,0.286363636363636,2560,9.921875
"2277",2024,"Belmont",14,4,28.6,370,924,445,289,0,552,1,436,293,729,281,507,1250,441,809,0,0,0,132,0.356756756756757,2781,10.1042790363179
"2278",2024,"Clemson",14,4,28.6,342,667,351,227,0,413,4,370,247,617,217,462,956,299,657,0,0,0,115,0.33625730994152,2237,9.70049172999553
"2279",2024,"Georgia",7,2,28.6,447,798,369,228,0,486,2,349,231,580,232,486,1214,377,837,0,0,0,157,0.351230425055928,2553,9.087348217783
"2280",2024,"Indiana State",21,6,28.6,472,798,419,288,0,627,3,363,316,679,263,568,1202,361,841,0,0,0,143,0.302966101694915,2654,9.9095704596835
"2281",2024,"Montana",14,4,28.6,375,867,299,214,0,445,3,308,308,616,196,418,1262,495,767,0,0,0,124,0.330666666666667,2541,7.71349862258953
"2282",2024,"North Dakota",14,4,28.6,415,803,390,265,0,586,2,286,246,532,215,529,1305,446,859,0,0,0,141,0.339759036144578,2580,8.33333333333333
"2283",2024,"St. John's",21,6,28.6,333,728,355,242,0,429,0,367,307,674,227,441,1056,369,687,0,0,0,112,0.336336336336336,2333,9.72996142306044
"2284",2024,"UAB",14,4,28.6,322,769,362,256,0,448,2,363,298,661,185,416,1137,401,736,0,0,0,98,0.304347826086957,2373,7.7960387694901
"2285",2023,"Northern Kentucky",32,9,28.1,346,853,485,320,0,487,4,421,391,812,193,385,996,318,678,0,0,0,110,0.317919075144509,2445,7.89366053169734
"2286",2022,"James Madison",25,7,28,405,791,393,264,0,471,5,340,305,645,172,457,1042,302,740,0,0,0,118,0.291358024691358,2384,7.21476510067114
"2287",2022,"Western Carolina",25,7,28,408,674,250,151,1,490,0,233,231,464,207,539,1051,331,720,0,0,0,119,0.291666666666667,2239,9.24519874944171
"2288",2024,"California Baptist",25,7,28,379,990,445,303,0,578,4,471,431,902,294,442,1160,389,771,0,0,0,128,0.337730870712401,2796,10.5150214592275
"2289",2024,"Northern Iowa",25,7,28,357,841,366,242,0,542,0,413,301,714,239,405,1273,457,816,0,0,0,117,0.327731092436975,2568,9.30685358255452
"2290",2021,"Purdue",18,5,27.8,322,552,276,176,0,375,0,271,192,463,168,397,890,289,601,0,0,0,109,0.338509316770186,1903,8.82816605359958
"2291",2021,"Saint Joseph's",18,5,27.8,247,432,157,102,0,331,0,173,154,327,118,242,683,223,460,0,0,0,88,0.356275303643725,1353,8.72135994087214
"2292",2021,"Wyoming",18,5,27.8,243,619,212,135,0,305,0,254,213,467,135,282,885,294,591,0,0,0,94,0.386831275720165,1751,7.70988006853227
"2293",2022,"Central Connecticut",18,5,27.8,315,600,238,149,0,436,4,233,280,513,162,417,1002,318,684,0,0,0,100,0.317460317460317,1943,8.33762223365929
"2294",2022,"North Dakota",18,5,27.8,364,806,331,238,0,473,2,281,266,547,196,428,1212,422,790,0,0,0,125,0.343406593406593,2372,8.26306913996627
"2295",2022,"Northwestern State",18,5,27.8,333,633,330,218,0,390,3,252,238,490,211,442,920,278,642,0,0,0,107,0.321321321321321,2017,10.4610808130887
"2296",2022,"San Diego State",18,5,27.8,368,839,293,185,0,521,4,307,272,579,224,399,1298,427,871,0,0,0,100,0.271739130434783,2410,9.29460580912863
"2297",2022,"Stony Brook",18,5,27.8,388,788,345,239,1,412,1,380,376,756,212,433,948,325,623,0,0,0,127,0.327319587628866,2400,8.83333333333333
"2298",2022,"Tulsa",18,5,27.8,280,644,252,174,0,445,3,323,268,591,232,330,1057,366,691,0,0,0,77,0.275,2012,11.5308151093439
"2299",2023,"Abilene Christian",18,5,27.8,404,740,335,215,0,498,0,434,307,741,235,452,1035,348,687,0,0,0,136,0.336633663366337,2458,9.56061838893409
"2300",2023,"Arkansas State",18,5,27.8,478,845,392,268,0,595,5,324,310,634,267,494,1440,471,969,0,0,0,158,0.330543933054393,2700,9.88888888888889
"2301",2023,"Central Michigan",18,5,27.8,429,681,288,185,1,550,4,334,360,694,214,508,1083,367,716,0,0,0,135,0.314685314685315,2387,8.96522832006703
"2302",2023,"Charleston",18,5,27.8,480,639,361,224,0,450,3,255,206,461,253,381,1386,410,976,0,0,0,147,0.30625,2247,11.2594570538496
"2303",2023,"Long Beach State",18,5,27.8,327,698,284,200,0,532,2,343,231,574,377,454,1236,429,807,0,0,0,114,0.348623853211009,2329,16.1872048089309
"2304",2023,"Oakland",18,5,27.8,536,706,427,256,0,561,4,346,340,686,250,424,1260,352,908,0,0,0,160,0.298507462686567,2451,10.1999184006528
"2305",2024,"Hawai'i",18,5,27.8,331,816,339,230,0,458,2,302,312,614,201,457,997,323,674,0,0,0,108,0.326283987915408,2301,8.73533246414602
"2306",2024,"Pennsylvania",18,5,27.8,337,688,273,191,1,408,5,303,282,585,161,410,982,340,642,0,0,0,116,0.344213649851632,2157,7.46407046824293
"2307",2024,"Southern",18,5,27.8,388,660,387,233,0,580,2,233,259,492,305,469,1164,408,756,0,0,0,122,0.314432989690722,2248,13.567615658363
"2308",2023,"Michigan State",29,8,27.6,490,773,470,292,0,553,3,444,320,764,327,432,1200,393,807,0,0,0,184,0.375510204081633,2656,12.3117469879518
"2309",2024,"UC Irvine",29,8,27.6,462,722,369,244,0,515,2,390,308,698,321,457,1119,330,789,0,0,0,132,0.285714285714286,2451,13.0966952264382
"2310",2021,"Sacred Heart",11,3,27.3,205,425,223,149,0,287,3,203,262,465,111,298,504,158,346,0,0,0,50,0.24390243902439,1338,8.29596412556054
"2311",2021,"Texas A&M-Corpus Christi",11,3,27.3,266,482,281,168,0,355,0,253,205,458,200,398,564,156,408,0,0,0,97,0.364661654135338,1612,12.4069478908189
"2312",2022,"Eastern Kentucky",22,6,27.3,440,790,461,313,0,539,5,325,290,615,283,548,1251,396,855,0,0,0,129,0.293181818181818,2620,10.8015267175573
"2313",2022,"Eastern Michigan",11,3,27.3,330,670,330,211,0,430,3,340,314,654,227,366,977,297,680,0,0,0,99,0.3,2085,10.8872901678657
"2314",2022,"Long Island University",22,6,27.3,410,621,251,139,0,505,1,236,271,507,230,477,1094,330,764,0,0,0,91,0.221951219512195,2128,10.8082706766917
"2315",2022,"San José State",11,3,27.3,354,698,318,211,0,456,9,300,320,620,213,435,1162,346,816,0,0,0,107,0.30225988700565,2208,9.64673913043478
"2316",2022,"Yale",22,6,27.3,327,732,277,174,0,449,1,279,307,586,190,501,931,301,630,0,0,0,82,0.250764525993884,2221,8.55470508779829
"2317",2023,"Davidson",22,6,27.3,311,626,261,176,0,498,1,315,263,578,176,430,1012,360,652,0,0,0,102,0.327974276527331,2112,8.33333333333333
"2318",2023,"Duquesne",22,6,27.3,406,932,386,237,0,453,4,330,291,621,180,420,1228,429,799,0,0,0,142,0.349753694581281,2617,6.87810470003821
"2319",2023,"Hofstra",22,6,27.3,415,793,327,211,0,604,2,300,292,592,223,628,1158,383,775,0,0,0,124,0.298795180722892,2596,8.59013867488444
"2320",2023,"Pennsylvania",11,3,27.3,395,773,275,168,0,362,0,296,267,563,199,434,1130,385,745,0,0,0,124,0.313924050632911,2342,8.49701110162255
"2321",2024,"Arkansas-Pine Bluff",11,3,27.3,516,814,494,292,0,596,7,377,310,687,308,486,1150,392,758,0,0,0,183,0.354651162790698,2691,11.4455592716462
"2322",2024,"Drake",11,3,27.3,429,1024,451,319,0,488,0,676,395,1071,313,621,1040,354,686,0,0,0,178,0.414918414918415,3225,9.70542635658915
"2323",2024,"Holy Cross",22,6,27.3,443,927,326,214,0,519,0,357,376,733,174,422,1215,411,804,0,0,0,142,0.320541760722348,2646,6.57596371882086
"2324",2024,"LSU",11,3,27.3,607,1059,676,465,1,585,4,637,451,1088,386,548,1279,456,823,0,0,0,189,0.311367380560132,3490,11.0601719197708
"2325",2024,"Northern Illinois",11,3,27.3,353,918,336,214,0,484,0,364,359,723,177,483,1126,367,759,0,0,0,116,0.328611898016997,2570,6.88715953307393
"2326",2024,"Old Dominion",11,3,27.3,549,799,451,267,0,645,9,385,373,758,341,534,1224,355,869,0,0,0,192,0.349726775956284,2735,12.4680073126143
"2327",2024,"UTSA",33,9,27.3,571,920,359,218,3,618,3,394,330,724,207,545,1287,407,880,0,0,0,187,0.327495621716287,2939,7.04321197686288
"2328",2024,"Utah",11,3,27.3,405,913,317,217,0,507,2,543,354,897,274,468,1158,428,730,0,0,0,150,0.37037037037037,2838,9.65468639887245
"2329",2021,"La Salle",26,7,26.9,307,570,270,192,0,440,1,219,222,441,216,346,1044,332,712,0,0,0,102,0.332247557003257,1840,11.7391304347826
"2330",2023,"Georgia Southern",26,7,26.9,588,942,513,316,0,596,3,461,332,793,282,530,1275,425,850,0,0,0,236,0.401360544217687,3071,9.18267665255617
"2331",2023,"Indiana State",26,7,26.9,397,759,375,242,0,577,0,291,243,534,235,487,1199,407,792,0,0,0,142,0.357682619647355,2425,9.69072164948454
"2332",2023,"Kennesaw State",26,7,26.9,504,783,472,300,0,553,1,395,347,742,232,443,1155,364,791,0,0,0,179,0.35515873015873,2620,8.85496183206107
"2333",2023,"North Carolina",26,7,26.9,401,865,406,253,0,581,5,408,266,674,312,480,1349,434,915,0,0,0,127,0.316708229426434,2694,11.5812917594655
"2334",2023,"Villanova",26,7,26.9,467,934,373,260,0,586,1,395,291,686,243,377,1547,584,963,0,0,0,175,0.374732334047109,2851,8.5233251490705
"2335",2024,"Duke",26,7,26.9,442,884,335,236,0,599,1,460,291,751,286,581,1216,406,810,0,0,0,157,0.355203619909502,2879,9.93400486279958
"2336",2021,"Jacksonville",15,4,26.7,296,518,238,132,0,353,0,163,220,383,167,309,822,246,576,0,0,0,75,0.253378378378378,1584,10.5429292929293
"2337",2021,"Western Michigan",15,4,26.7,249,562,285,168,0,353,0,257,236,493,136,372,704,232,472,0,0,0,100,0.401606425702811,1733,7.84766301211771
"2338",2021,"Wichita State",15,4,26.7,207,387,173,109,0,262,3,163,144,307,93,241,514,166,348,0,0,0,80,0.386473429951691,1204,7.72425249169435
"2339",2022,"Merrimack",15,4,26.7,318,639,272,159,0,416,1,302,266,568,172,446,977,327,650,0,0,0,100,0.314465408805031,2082,8.26128722382325
"2340",2022,"Mount St. Mary's",15,4,26.7,278,717,296,197,0,479,0,277,273,550,206,465,1001,376,625,0,0,0,90,0.323741007194245,2176,9.46691176470588
"2341",2022,"Saint Louis",15,4,26.7,340,751,255,165,0,345,0,288,227,515,187,400,1098,338,760,0,0,0,117,0.344117647058824,2184,8.56227106227106
"2342",2022,"South Carolina Upstate",15,4,26.7,245,654,284,180,0,428,0,379,282,661,222,404,821,311,510,0,0,0,85,0.346938775510204,2079,10.6782106782107
"2343",2022,"Texas State",15,4,26.7,342,717,359,228,0,467,2,370,305,675,227,475,964,335,629,0,0,0,118,0.345029239766082,2334,9.72579263067695
"2344",2022,"Virginia Tech",15,4,26.7,359,925,368,253,0,470,1,329,235,564,143,422,1299,498,801,0,0,0,131,0.364902506963788,2626,5.44554455445545
"2345",2022,"Youngstown State",15,4,26.7,336,799,334,222,0,448,1,307,224,531,197,430,1149,369,780,0,0,0,74,0.220238095238095,2311,8.52444829078321
"2346",2023,"Eastern Washington",15,4,26.7,323,716,325,225,0,440,2,330,276,606,255,351,1087,374,713,0,0,0,110,0.340557275541796,2184,11.6758241758242
"2347",2023,"UIC",30,8,26.7,535,813,553,339,0,629,0,370,339,709,239,546,1106,341,765,0,0,0,200,0.373831775700935,2751,8.68774990912395
"2348",2023,"William & Mary",15,4,26.7,336,713,321,231,0,529,3,330,311,641,237,421,1223,401,822,0,0,0,108,0.321428571428571,2278,10.4038630377524
"2349",2024,"Oregon",15,4,26.7,415,903,388,243,0,374,1,331,332,663,170,448,1157,382,775,0,0,0,146,0.351807228915663,2575,6.60194174757282
"2350",2024,"Saint Joseph's",15,4,26.7,374,867,311,230,0,438,0,405,316,721,185,444,1155,417,738,0,0,0,126,0.336898395721925,2592,7.13734567901235
"2351",2024,"Seattle U",15,4,26.7,401,680,327,215,0,551,1,349,384,733,246,519,1007,311,696,0,0,0,131,0.326683291770574,2345,10.4904051172708
"2352",2024,"Villanova",30,8,26.7,457,819,277,188,0,502,0,368,317,685,237,384,1454,502,952,0,0,0,150,0.328227571115974,2600,9.11538461538461
"2353",2022,"Arizona",19,5,26.3,327,629,328,212,0,485,3,372,243,615,290,359,1000,327,673,0,0,0,114,0.348623853211009,2101,13.8029509757258
"2354",2022,"Houston Christian",19,5,26.3,311,667,294,211,0,399,0,217,277,494,207,417,939,282,657,0,0,0,94,0.302250803858521,1952,10.6045081967213
"2355",2022,"Kansas City",19,5,26.3,409,847,356,254,1,505,1,396,326,722,211,460,1204,431,773,0,0,0,126,0.308068459657702,2625,8.03809523809524
"2356",2022,"New Mexico",19,5,26.3,333,929,313,220,0,433,2,488,258,746,272,437,1319,447,872,0,0,0,119,0.357357357357357,2708,10.0443131462334
"2357",2022,"Tennessee",19,5,26.3,610,1074,504,305,0,524,1,475,355,830,210,581,1320,413,907,0,0,0,213,0.349180327868852,3298,6.36749545178896
"2358",2023,"Rider",19,5,26.3,267,732,293,198,0,491,1,324,289,613,194,545,1012,336,676,0,0,0,79,0.295880149812734,2281,8.50504164839982
"2359",2023,"Washington State",19,5,26.3,414,878,360,238,1,539,3,455,348,803,241,508,1147,388,759,0,0,0,142,0.342995169082126,2739,8.79883169039796
"2360",2024,"Florida International",19,5,26.3,510,835,465,301,0,610,6,457,427,884,278,577,1014,320,694,0,0,0,192,0.376470588235294,2826,9.83722576079264
"2361",2024,"Purdue",19,5,26.3,425,848,362,264,0,531,2,410,292,702,259,494,1327,432,895,0,0,0,139,0.327058823529412,2703,9.58194598594155
"2362",2021,"UC San Diego",23,6,26.1,152,375,146,96,0,230,0,114,123,237,84,209,641,205,436,0,0,0,38,0.25,1089,7.71349862258953
"2363",2022,"Marshall",23,6,26.1,387,692,338,220,0,523,0,295,247,542,215,356,1124,329,795,0,0,0,114,0.294573643410853,2124,10.1224105461394
"2364",2022,"Quinnipiac",23,6,26.1,443,879,376,248,0,531,0,425,378,803,269,516,1197,401,796,0,0,0,155,0.349887133182844,2756,9.76052249637155
"2365",2022,"St. Thomas - Minnesota",23,6,26.1,273,656,245,147,0,424,0,260,208,468,143,408,911,287,624,0,0,0,86,0.315018315018315,1951,7.32957457713993
"2366",2023,"Eastern Illinois",23,6,26.1,354,791,363,243,0,455,1,393,307,700,215,445,974,336,638,0,0,0,117,0.330508474576271,2421,8.88062783973565
"2367",2023,"Stony Brook",23,6,26.1,442,719,348,234,0,395,1,358,336,694,223,430,1153,383,770,0,0,0,158,0.357466063348416,2419,9.21868540719306
"2368",2023,"Tarleton",23,6,26.1,312,671,395,259,0,514,3,279,290,569,229,461,1004,318,686,0,0,0,100,0.320512820512821,2126,10.7714016933208
"2369",2024,"Robert Morris",23,6,26.1,350,701,260,166,0,599,0,240,254,494,209,488,1240,387,853,0,0,0,105,0.3,2230,9.37219730941704
"2370",2022,"Saint Mary's",27,7,25.9,432,808,367,240,0,527,2,368,361,729,168,531,966,339,627,0,0,0,138,0.319444444444444,2555,6.57534246575342
"2371",2022,"Seattle U",27,7,25.9,378,793,337,211,0,518,5,346,315,661,266,465,1122,341,781,0,0,0,106,0.28042328042328,2405,11.0602910602911
"2372",2023,"Old Dominion",27,7,25.9,541,815,467,272,0,627,10,396,318,714,322,515,1336,417,919,0,0,0,181,0.33456561922366,2800,11.5
"2373",2024,"Wichita State",27,7,25.9,490,790,458,280,0,554,2,400,373,773,221,511,1118,318,800,0,0,0,185,0.377551020408163,2626,8.41584158415842
"2374",2022,"Georgia Southern",31,8,25.8,479,769,427,271,0,493,3,400,321,721,274,498,1046,335,711,0,0,0,177,0.369519832985386,2587,10.5914186316196
"2375",2023,"Marshall",31,8,25.8,381,811,344,210,0,474,4,351,266,617,219,403,1193,378,815,0,0,0,126,0.330708661417323,2417,9.06081919735209
"2376",2023,"UTEP",35,9,25.7,460,744,489,315,0,565,4,393,282,675,222,448,1171,377,794,0,0,0,153,0.332608695652174,2543,8.72984663782934
"2377",2021,"Alabama State",8,2,25,274,463,302,195,0,331,0,240,174,414,129,301,567,178,389,0,0,0,100,0.364963503649635,1522,8.47568988173456
"2378",2021,"Central Arkansas",8,2,25,477,645,405,245,0,558,0,292,287,579,174,535,837,235,602,0,0,0,158,0.331236897274633,2277,7.64163372859025
"2379",2021,"Delaware State",12,3,25,203,335,140,89,0,261,2,142,134,276,108,245,601,164,437,0,0,0,55,0.270935960591133,1126,9.59147424511545
"2380",2021,"Iona",8,2,25,152,312,112,66,0,241,0,135,130,265,128,261,476,149,327,0,0,0,38,0.25,1032,12.4031007751938
"2381",2021,"Iowa",12,3,25,288,802,344,253,0,465,0,472,255,727,208,439,1114,471,643,0,0,0,115,0.399305555555556,2576,8.07453416149068
"2382",2021,"Long Beach State",16,4,25,255,472,263,166,0,329,0,221,189,410,225,256,751,239,512,0,0,0,87,0.341176470588235,1502,14.9800266311585
"2383",2021,"Memphis",12,3,25,316,519,230,145,1,299,1,234,221,455,124,402,666,202,464,0,0,0,128,0.40506329113924,1739,7.13053479010926
"2384",2021,"Morgan State",12,3,25,234,363,243,165,0,305,1,160,181,341,174,291,607,191,416,0,0,0,60,0.256410256410256,1295,13.4362934362934
"2385",2021,"New Mexico State",4,1,25,291,530,255,142,1,399,4,237,236,473,180,359,725,246,479,0,0,0,93,0.319587628865979,1730,10.4046242774566
"2386",2021,"Northwestern State",4,1,25,279,395,222,124,0,374,0,125,171,296,129,429,785,205,580,0,0,0,75,0.268817204301075,1483,8.69858395144976
"2387",2021,"Oklahoma",16,4,25,209,579,271,187,1,413,1,283,199,482,190,377,905,346,559,0,0,0,75,0.358851674641148,1854,10.2481121898598
"2388",2021,"San Francisco",4,1,25,234,567,265,171,0,404,0,318,181,499,195,338,858,282,576,0,0,0,87,0.371794871794872,1796,10.8574610244989
"2389",2021,"Stanford",8,2,25,456,988,310,204,2,466,0,465,312,777,271,425,1330,509,821,0,0,0,165,0.361842105263158,2943,9.20829085966701
"2390",2021,"UCF",4,1,25,271,480,262,155,0,308,6,221,187,408,174,351,565,176,389,0,0,0,81,0.298892988929889,1559,11.1610006414368
"2391",2021,"UL Monroe",4,1,25,290,602,255,145,0,436,4,221,186,407,110,455,765,224,541,0,0,0,96,0.331034482758621,1844,5.96529284164859
"2392",2021,"UT Martin",12,3,25,245,723,345,239,0,427,1,251,152,403,203,401,1090,437,653,0,0,0,84,0.342857142857143,2150,9.44186046511628
"2393",2021,"Utah State",4,1,25,256,643,240,154,0,367,0,278,321,599,129,337,809,229,580,0,0,0,72,0.28125,1808,7.13495575221239
"2394",2021,"Weber State",12,3,25,278,563,303,215,0,389,0,288,336,624,131,425,635,179,456,0,0,0,88,0.316546762589928,1809,7.24156992813709
"2395",2022,"Arkansas-Pine Bluff",4,1,25,404,702,380,246,2,440,2,282,237,519,204,398,1037,334,703,0,0,0,147,0.363861386138614,2218,9.19747520288548
"2396",2022,"CSU Dominguez Hills",4,1,25,23,28,24,15,0,18,0,7,10,17,4,15,36,11,25,0,0,0,10,0.434782608695652,90,4.44444444444444
"2397",2022,"Cincinnati",16,4,25,386,685,342,225,0,547,2,296,315,611,228,493,986,303,683,0,0,0,111,0.287564766839378,2239,10.1831174631532
"2398",2022,"Cumberland College",4,1,25,25,42,34,19,0,51,2,28,18,46,15,28,78,17,61,0,0,0,9,0.36,144,10.4166666666667
"2399",2022,"Florida Gulf Coast",4,1,25,320,802,354,220,1,480,0,464,291,755,315,345,1217,399,818,0,0,0,106,0.33125,2439,12.9151291512915
"2400",2022,"Fordham",20,5,25,372,665,253,165,0,443,1,266,232,498,217,385,1245,406,839,0,0,0,101,0.271505376344086,2154,10.0742804085422
"2401",2022,"Iona",20,5,25,255,608,209,121,0,399,0,349,278,627,201,461,756,223,533,0,0,0,84,0.329411764705882,1952,10.297131147541
"2402",2022,"Kansas State",8,2,25,330,878,393,272,0,508,2,376,323,699,245,450,1210,400,810,0,0,0,101,0.306060606060606,2529,9.68762356662713
"2403",2022,"Longwood",12,3,25,465,836,411,285,2,613,1,445,309,754,338,575,1355,428,927,0,0,0,145,0.311827956989247,2848,11.8679775280899
"2404",2022,"Memphis",16,4,25,409,696,364,239,1,419,6,314,339,653,185,430,880,275,605,0,0,0,123,0.300733496332518,2214,8.35591689250226
"2405",2022,"Mont St Billings",4,1,25,18,36,14,10,0,24,0,8,12,20,9,16,53,18,35,0,0,0,6,0.333333333333333,98,9.18367346938776
"2406",2022,"Montana",16,4,25,388,904,385,255,0,418,0,346,292,638,161,421,1105,392,713,0,0,0,140,0.360824742268041,2544,6.32861635220126
"2407",2022,"NJIT",24,6,25,324,786,334,209,0,498,0,313,317,630,152,534,922,310,612,0,0,0,114,0.351851851851852,2347,6.47635279079676
"2408",2022,"Pittsburgh",12,3,25,515,832,407,241,1,501,2,338,362,700,197,537,1067,321,746,0,0,0,168,0.32621359223301,2627,7.49904834411877
"2409",2022,"Sam Houston",12,3,25,519,719,514,326,0,623,1,377,404,781,296,609,1022,340,682,0,0,0,166,0.319845857418112,2670,11.0861423220974
"2410",2022,"Tarleton",12,3,25,359,737,320,200,0,417,7,341,298,639,235,473,910,290,620,0,0,0,127,0.353760445682451,2277,10.320597277119
"2411",2022,"UMass",12,3,25,494,879,390,248,0,485,1,517,397,914,258,440,1130,383,747,0,0,0,186,0.376518218623482,2820,9.14893617021277
"2412",2022,"West Virginia",16,4,25,409,710,343,226,0,563,3,351,295,646,262,476,1096,350,746,0,0,0,140,0.342298288508557,2384,10.989932885906
"2413",2022,"Western Michigan",4,1,25,294,754,364,231,0,487,2,383,377,760,268,454,950,310,640,0,0,0,109,0.370748299319728,2285,11.7286652078775
"2414",2022,"Winthrop",4,1,25,389,779,365,196,0,483,0,342,331,673,210,659,877,235,642,0,0,0,126,0.323907455012853,2488,8.44051446945338
"2415",2022,"Wyoming",16,4,25,408,876,326,223,0,356,1,374,365,739,156,403,1006,324,682,0,0,0,147,0.360294117647059,2472,6.31067961165049
"2416",2023,"Brown",8,2,25,287,593,270,149,0,360,1,300,303,603,237,416,790,259,531,0,0,0,89,0.310104529616725,1930,12.279792746114
"2417",2023,"Central Connecticut",20,5,25,366,665,286,195,0,505,2,259,258,517,220,494,1103,341,762,0,0,0,109,0.297814207650273,2202,9.99091734786558
"2418",2023,"Clemson",16,4,25,407,851,346,222,0,545,3,400,294,694,303,563,1265,418,847,0,0,0,135,0.331695331695332,2730,11.0989010989011
"2419",2023,"Georgetown",8,2,25,419,773,356,207,0,538,2,316,307,623,267,456,1202,387,815,0,0,0,149,0.355608591885442,2447,10.9113199836535
"2420",2023,"Hampton",16,4,25,339,555,389,247,0,555,6,332,366,698,332,453,973,291,682,0,0,0,100,0.294985250737463,2056,16.147859922179
"2421",2023,"Miami University Hamilton",4,1,25,14,26,15,11,0,34,0,8,8,16,3,21,46,17,29,0,0,0,2,0.142857142857143,88,3.40909090909091
"2422",2023,"Morehead State",8,2,25,437,685,342,195,0,568,5,383,341,724,281,552,1065,289,776,0,0,0,138,0.31578947368421,2424,11.5924092409241
"2423",2023,"North Dakota State",20,5,25,451,755,427,267,0,603,1,437,364,801,233,474,1034,340,694,0,0,0,157,0.348115299334812,2551,9.13367306938455
"2424",2023,"North Florida",12,3,25,321,702,266,152,0,462,1,301,254,555,204,509,1031,301,730,0,0,0,86,0.26791277258567,2190,9.31506849315068
"2425",2023,"Pittsburgh",16,4,25,382,746,322,212,1,479,2,351,335,686,242,480,1102,347,755,0,0,0,115,0.301047120418848,2391,10.1212881639481
"2426",2023,"Purdue Fort Wayne",16,4,25,311,742,324,218,0,577,1,350,349,699,302,493,1183,376,807,0,0,0,94,0.302250803858521,2350,12.8510638297872
"2427",2023,"South Alabama",16,4,25,405,765,363,214,0,504,4,273,322,595,211,506,1130,308,822,0,0,0,117,0.288888888888889,2345,8.99786780383795
"2428",2023,"St. Thomas - Minnesota",20,5,25,332,715,327,210,0,524,1,318,259,577,200,487,1021,351,670,0,0,0,102,0.307228915662651,2283,8.76040297853701
"2429",2024,"Air Force",20,5,25,422,669,309,211,0,604,3,296,302,598,347,473,1362,453,909,0,0,0,147,0.348341232227488,2390,14.5188284518828
"2430",2024,"Alabama",4,1,25,428,805,423,275,0,489,2,440,369,809,261,465,1074,377,697,0,0,0,123,0.287383177570093,2615,9.98087954110899
"2431",2024,"Cal State LA",4,1,25,17,32,4,1,0,19,0,7,14,21,4,17,53,21,32,0,0,0,4,0.235294117647059,94,4.25531914893617
"2432",2024,"Eastern Washington",16,4,25,461,888,305,209,0,467,3,412,404,816,300,392,1336,464,872,0,0,0,170,0.368763557483731,2693,11.1399925733383
"2433",2024,"Furman",12,3,25,453,776,376,244,0,474,7,366,309,675,190,472,1043,320,723,0,0,0,159,0.350993377483444,2473,7.68297614233724
"2434",2024,"Iowa",20,5,25,419,1194,538,386,0,561,2,705,366,1071,290,538,1457,546,911,0,0,0,147,0.350835322195704,3582,8.09603573422669
"2435",2024,"Kansas",12,3,25,324,841,466,305,0,558,4,451,356,807,235,443,1027,354,673,0,0,0,112,0.345679012345679,2528,9.29588607594937
"2436",2024,"Kansas City",16,4,25,515,804,421,247,0,691,0,286,239,525,237,514,1409,513,896,0,0,0,191,0.370873786407767,2737,8.65911582024114
"2437",2024,"McNeese",4,1,25,325,781,465,307,0,525,3,390,385,775,241,573,977,283,694,0,0,0,100,0.307692307692308,2452,9.82871125611745
"2438",2024,"Oklahoma State",12,3,25,256,793,308,208,0,469,2,378,248,626,213,428,1105,383,722,0,0,0,92,0.359375,2305,9.24078091106291
"2439",2024,"San Diego",16,4,25,474,729,413,266,0,544,0,364,316,680,244,530,1095,367,728,0,0,0,171,0.360759493670886,2575,9.47572815533981
"2440",2024,"Stanford",20,5,25,516,1113,382,273,0,530,1,530,367,897,186,448,1367,516,851,0,0,0,181,0.35077519379845,3229,5.76029730566739
"2441",2024,"Tarleton State",12,3,25,369,836,350,235,0,514,2,301,307,608,186,473,1168,382,786,0,0,0,118,0.319783197831978,2442,7.61670761670762
"2442",2024,"Temple",32,8,25,542,760,353,227,0,602,4,349,289,638,287,435,1420,462,958,0,0,0,162,0.298892988929889,2625,10.9333333333333
"2443",2024,"Towson",24,6,25,473,840,366,239,0,528,2,340,321,661,227,431,1330,413,917,0,0,0,158,0.334038054968288,2584,8.78482972136223
"2444",2024,"UIC",12,3,25,509,874,576,355,0,626,3,540,422,962,299,586,998,299,699,0,0,0,184,0.361493123772102,2943,10.1597009853891
"2445",2024,"UT Martin",16,4,25,306,813,368,262,0,443,1,302,237,539,268,554,1165,437,728,0,0,0,106,0.34640522875817,2512,10.6687898089172
"2446",2023,"Hawai'i",33,8,24.2,350,828,395,260,0,554,2,393,363,756,230,508,994,298,696,0,0,0,117,0.334285714285714,2484,9.25925925925926
"2447",2024,"Troy",29,7,24.1,674,1058,488,316,1,607,3,471,359,830,317,482,1691,585,1106,0,0,0,275,0.408011869436202,3411,9.29346232776312
"2448",2021,"Illinois",25,6,24,287,618,275,171,0,404,1,192,155,347,173,412,1022,309,713,0,0,0,98,0.341463414634146,1890,9.15343915343915
"2449",2022,"Tulane",25,6,24,489,864,432,296,0,429,5,367,286,653,193,443,1191,384,807,0,0,0,160,0.32719836400818,2658,7.26109857035365
"2450",2023,"Army",25,6,24,416,739,331,205,0,544,1,296,258,554,178,468,1189,367,822,0,0,0,128,0.307692307692308,2367,7.52006759611322
"2451",2023,"Columbia",25,6,24,533,965,499,308,1,568,1,497,345,842,291,536,1329,453,876,0,0,0,167,0.313320825515947,3117,9.33589990375361
"2452",2023,"UC Santa Barbara",25,6,24,412,860,447,319,1,539,2,407,296,703,210,532,1065,355,710,0,0,0,145,0.351941747572816,2680,7.83582089552239
"2453",2024,"New Mexico State",25,6,24,435,726,364,230,0,594,4,312,307,619,225,527,1119,385,734,0,0,0,148,0.340229885057471,2467,9.12038913660316
"2454",2024,"Winthrop",25,6,24,405,718,362,232,0,522,1,301,282,583,275,574,1072,307,765,0,0,0,109,0.269135802469136,2392,11.4966555183947
"2455",2021,"Virginia Tech",21,5,23.8,260,688,258,178,0,453,0,216,153,369,115,357,1131,421,710,0,0,0,99,0.380769230769231,2003,5.74138791812282
"2456",2022,"Oregon",21,5,23.8,427,815,350,227,0,497,3,360,259,619,242,403,1205,424,781,0,0,0,129,0.302107728337237,2513,9.62992439315559
"2457",2023,"Chattanooga",21,5,23.8,309,845,361,251,0,471,0,324,287,611,190,466,1073,368,705,0,0,0,106,0.343042071197411,2407,7.89364353967595
"2458",2023,"Georgia State",21,5,23.8,431,851,434,286,0,490,2,420,326,746,215,535,987,289,698,0,0,0,148,0.34338747099768,2625,8.19047619047619
"2459",2023,"Northern Iowa",21,5,23.8,346,866,426,278,0,543,1,400,276,676,229,394,1250,457,793,0,0,0,132,0.38150289017341,2580,8.87596899224806
"2460",2024,"Morehead State",21,5,23.8,440,715,376,218,0,481,3,333,316,649,224,464,966,287,679,0,0,0,144,0.327272727272727,2324,9.63855421686747
"2461",2024,"Sacred Heart",21,5,23.8,509,767,427,271,0,528,2,373,343,716,298,428,1272,426,846,0,0,0,161,0.316306483300589,2614,11.4001530221882
"2462",2021,"Louisiana",17,4,23.5,290,572,279,188,0,350,2,233,178,411,156,315,886,271,615,0,0,0,113,0.389655172413793,1739,8.97067280046003
"2463",2021,"North Florida",17,4,23.5,231,724,286,178,0,393,3,246,205,451,162,399,1040,401,639,0,0,0,85,0.367965367965368,2073,7.81476121562952
"2464",2022,"Richmond",17,4,23.5,327,845,317,209,0,480,0,419,329,748,203,497,961,339,622,0,0,0,112,0.342507645259939,2504,8.10702875399361
"2465",2023,"Cincinnati",17,4,23.5,457,701,402,252,0,583,2,338,382,720,232,530,1004,301,703,0,0,0,137,0.299781181619256,2433,9.53555281545417
"2466",2023,"Colgate",34,8,23.5,322,714,269,184,0,439,1,293,238,531,201,385,1177,388,789,0,0,0,91,0.282608695652174,2170,9.26267281105991
"2467",2023,"South Carolina Upstate",17,4,23.5,349,863,357,228,0,508,0,258,279,537,206,694,1032,322,710,0,0,0,102,0.292263610315186,2571,8.01244651886426
"2468",2023,"USC",34,8,23.5,492,805,411,265,0,473,2,325,328,653,272,478,1164,366,798,0,0,0,147,0.298780487804878,2555,10.6457925636008
"2469",2024,"Arkansas State",17,4,23.5,387,735,362,247,0,440,2,316,286,602,219,403,1067,349,718,0,0,0,138,0.356589147286822,2286,9.58005249343832
"2470",2024,"Colorado State",17,4,23.5,147,881,232,167,0,366,1,286,180,466,169,268,1280,486,794,0,0,0,57,0.387755102040816,2130,7.93427230046948
"2471",2024,"Kennesaw State",17,4,23.5,509,715,388,239,0,544,2,368,412,780,252,529,948,288,660,0,0,0,157,0.308447937131631,2500,10.08
"2472",2024,"Merrimack",17,4,23.5,471,762,345,224,0,578,1,307,364,671,233,533,1059,323,736,0,0,0,134,0.284501061571125,2466,9.448499594485
"2473",2024,"Stetson",17,4,23.5,449,795,428,261,1,520,0,348,363,711,218,497,1024,309,715,0,0,0,154,0.342984409799555,2504,8.70607028753994
"2474",2023,"Montana",30,7,23.3,328,851,335,236,0,404,1,289,242,531,165,406,1259,462,797,0,0,0,109,0.332317073170732,2419,6.82100041339396
"2475",2021,"Arizona State",13,3,23.1,343,463,267,170,0,343,1,214,261,475,186,351,745,202,543,0,0,0,80,0.233236151603499,1634,11.3831089351285
"2476",2021,"Binghamton",13,3,23.1,193,405,136,77,0,254,1,128,109,237,116,276,655,217,438,0,0,0,65,0.336787564766839,1250,9.28
"2477",2021,"Bradley",26,6,23.1,328,812,342,235,0,503,0,322,206,528,186,370,1216,417,799,0,0,0,110,0.335365853658537,2341,7.94532251174712
"2478",2021,"Georgia Tech",26,6,23.1,321,642,256,160,0,353,1,284,207,491,153,318,960,331,629,0,0,0,97,0.302180685358255,1961,7.80214176440592
"2479",2022,"Baylor",13,3,23.1,444,1012,471,316,0,511,6,430,258,688,230,445,1432,543,889,0,0,0,163,0.367117117117117,3008,7.64627659574468
"2480",2022,"California Baptist",26,6,23.1,302,957,343,214,0,553,7,503,349,852,295,466,1116,374,742,0,0,0,102,0.337748344370861,2689,10.970621048717
"2481",2022,"Campbell",13,3,23.1,394,703,312,197,0,440,1,367,243,610,253,473,1035,329,706,0,0,0,131,0.33248730964467,2339,10.8165882855921
"2482",2022,"Central Arkansas",13,3,23.1,370,706,331,213,0,478,1,273,278,551,182,507,941,289,652,0,0,0,108,0.291891891891892,2222,8.19081908190819
"2483",2022,"Tennessee Tech",13,3,23.1,478,786,468,308,0,466,0,368,309,677,217,488,1037,360,677,0,0,0,170,0.355648535564854,2594,8.36545875096376
"2484",2023,"South Carolina",13,3,23.1,670,1154,608,387,2,538,4,679,476,1155,248,468,1223,415,808,0,0,0,225,0.335820895522388,3567,6.95262125035043
"2485",2023,"Texas State",26,6,23.1,352,844,406,275,0,554,2,355,284,639,269,467,1223,442,781,0,0,0,136,0.386363636363636,2554,10.5324980422866
"2486",2024,"Boise State",13,3,23.1,477,1009,411,258,0,526,1,385,356,741,232,528,1290,422,868,0,0,0,149,0.312368972746331,2911,7.96976983854346
"2487",2024,"Coppin State",13,3,23.1,454,716,411,238,0,431,2,219,263,482,238,495,1185,361,824,0,0,0,143,0.314977973568282,2350,10.1276595744681
"2488",2024,"DePaul",13,3,23.1,433,805,302,210,1,559,2,409,325,734,302,465,1298,415,883,0,0,0,135,0.311778290993072,2594,11.6422513492675
"2489",2024,"Houston Christian",13,3,23.1,280,751,269,180,0,463,1,241,266,507,208,518,1042,328,714,0,0,0,89,0.317857142857143,2183,9.52817224003665
"2490",2024,"Iowa State",13,3,23.1,381,1036,378,250,0,462,0,418,240,658,158,541,1281,488,793,0,0,0,145,0.380577427821522,2956,5.34506089309878
"2491",2024,"Saint Peter's",13,3,23.1,346,670,338,218,0,496,1,253,326,579,269,631,836,232,604,0,0,0,105,0.303468208092486,2220,12.1171171171171
"2492",2021,"Old Dominion",44,10,22.7,338,577,307,176,0,352,3,272,205,477,157,284,970,324,646,0,0,0,107,0.316568047337278,1878,8.35995740149095
"2493",2022,"Maine",22,5,22.7,332,756,235,147,0,501,0,404,321,725,281,437,1074,323,751,0,0,0,105,0.316265060240964,2314,12.1434745030251
"2494",2022,"Weber State",22,5,22.7,398,846,456,316,0,583,2,408,360,768,249,540,941,274,667,0,0,0,157,0.394472361809045,2570,9.68871595330739
"2495",2023,"Cal State Bakersfield",22,5,22.7,358,756,340,205,0,613,0,270,296,566,246,544,1086,307,779,0,0,0,109,0.304469273743017,2314,10.6309420916162
"2496",2023,"Saint Joseph's",22,5,22.7,313,782,337,237,0,422,5,412,311,723,185,403,1011,340,671,0,0,0,104,0.332268370607029,2332,7.93310463121784
"2497",2023,"Wofford",22,5,22.7,342,709,346,233,0,426,1,319,275,594,236,310,1249,429,820,0,0,0,126,0.368421052631579,2206,10.6980961015413
"2498",2024,"Delaware",22,5,22.7,384,851,366,240,0,551,2,413,378,791,241,545,1066,353,713,0,0,0,117,0.3046875,2627,9.17396269508946
"2499",2021,"Appalachian State",9,2,22.2,229,329,191,116,0,239,1,136,164,300,120,216,550,179,371,0,0,0,64,0.279475982532751,1133,10.5913503971756
"2500",2021,"George Washington",18,4,22.2,310,541,219,132,0,329,3,248,219,467,201,328,861,256,605,0,0,0,89,0.287096774193548,1734,11.5916955017301
"2501",2021,"Michigan State",18,4,22.2,372,599,346,216,3,437,1,341,249,590,205,344,907,328,579,0,0,0,150,0.403225806451613,2085,9.83213429256595
"2502",2021,"North Carolina Central",9,2,22.2,247,443,259,151,0,342,5,180,174,354,160,389,618,174,444,0,0,0,77,0.311740890688259,1490,10.738255033557
"2503",2021,"Santa Clara",18,4,22.2,290,556,285,196,0,400,0,295,249,544,218,407,774,257,517,0,0,0,93,0.320689655172414,1874,11.632870864461
"2504",2022,"Alabama State",9,2,22.2,483,762,417,272,0,605,4,346,320,666,207,594,1042,315,727,0,0,0,153,0.316770186335404,2597,7.97073546399692
"2505",2022,"Bethune-Cookman",9,2,22.2,336,602,365,217,1,448,6,263,240,503,213,506,939,278,661,0,0,0,106,0.31547619047619,2072,10.2799227799228
"2506",2022,"East Tennessee State",9,2,22.2,302,660,231,141,0,455,1,232,284,516,204,398,1055,319,736,0,0,0,103,0.341059602649007,1953,10.4454685099846
"2507",2022,"Florida International",18,4,22.2,439,681,369,244,0,598,1,329,345,674,286,511,1074,351,723,0,0,0,142,0.323462414578588,2400,11.9166666666667
"2508",2022,"Texas A&M",9,2,22.2,381,782,368,244,0,525,2,330,277,607,170,437,1164,392,772,0,0,0,127,0.333333333333333,2414,7.04225352112676
"2509",2022,"Toledo",18,4,22.2,431,1020,437,296,1,524,1,496,350,846,210,435,1174,395,779,0,0,0,160,0.37122969837587,2885,7.2790294627383
"2510",2023,"Arkansas",18,4,22.2,468,982,589,368,0,583,6,444,318,762,221,455,1347,399,948,0,0,0,166,0.354700854700855,2904,7.61019283746556
"2511",2023,"Baylor",27,6,22.2,441,888,390,247,0,546,3,404,250,654,256,503,1413,478,935,0,0,0,145,0.328798185941043,2808,9.11680911680912
"2512",2023,"Belmont",18,4,22.2,401,904,458,297,0,586,1,437,293,730,199,451,1295,449,846,0,0,0,132,0.329177057356608,2765,7.19710669077758
"2513",2023,"Holy Cross",18,4,22.2,340,866,336,230,0,466,0,388,348,736,209,493,1052,369,683,0,0,0,106,0.311764705882353,2538,8.23483057525611
"2514",2023,"Incarnate Word",18,4,22.2,327,630,299,188,0,463,0,274,278,552,236,391,933,309,624,0,0,0,109,0.333333333333333,2001,11.7941029485257
"2515",2023,"Portland",9,2,22.2,358,685,364,244,0,480,4,438,311,749,280,475,918,320,598,0,0,0,123,0.343575418994413,2367,11.8293198141107
"2516",2023,"Rutgers",9,2,22.2,393,786,426,296,0,527,8,416,362,778,240,623,1004,299,705,0,0,0,130,0.330788804071247,2622,9.1533180778032
"2517",2023,"Wake Forest",18,4,22.2,405,830,375,226,0,574,2,395,316,711,221,509,1168,337,831,0,0,0,117,0.288888888888889,2558,8.63956215793589
"2518",2023,"Xavier",9,2,22.2,371,692,296,181,0,527,3,347,378,725,240,526,959,279,680,0,0,0,110,0.296495956873315,2280,10.5263157894737
"2519",2024,"Auburn",18,4,22.2,479,789,441,285,0,590,4,437,362,799,334,498,1147,350,797,0,0,0,160,0.334029227557411,2663,12.5422455876831
"2520",2024,"Loyola Marymount",9,2,22.2,412,657,305,197,0,500,1,345,319,664,206,475,1054,322,732,0,0,0,123,0.298543689320388,2296,8.97212543554007
"2521",2024,"North Carolina A&T",18,4,22.2,524,954,477,323,0,528,3,422,360,782,248,567,1173,341,832,0,0,0,177,0.337786259541985,2918,8.49897189856066
"2522",2024,"Radford",18,4,22.2,412,779,360,228,0,505,1,329,360,689,213,551,1102,338,764,0,0,0,122,0.296116504854369,2502,8.51318944844125
"2523",2024,"Tennessee Tech",27,6,22.2,436,704,383,275,0,595,1,359,307,666,307,489,1171,401,770,0,0,0,159,0.364678899082569,2497,12.2947537044453
"2524",2024,"South Florida",32,7,21.9,441,827,326,219,1,507,2,300,251,551,156,405,1308,433,875,0,0,0,137,0.310657596371882,2477,6.29794105773113
"2525",2022,"Delaware",23,5,21.7,608,847,427,281,0,497,2,382,331,713,240,429,1379,436,943,0,0,0,190,0.3125,2797,8.58062209510189
"2526",2022,"Minnesota",23,5,21.7,422,811,345,243,0,526,1,294,281,575,209,459,1377,499,878,0,0,0,143,0.338862559241706,2563,8.15450643776824
"2527",2023,"Kansas",23,5,21.7,454,1087,463,323,0,550,2,578,452,1030,283,548,1152,373,779,0,0,0,164,0.361233480176211,3160,8.95569620253165
"2528",2023,"Northeastern",23,5,21.7,376,768,295,186,0,512,2,405,286,691,266,550,983,346,637,0,0,0,122,0.324468085106383,2505,10.6187624750499
"2529",2023,"Northern Colorado",23,5,21.7,333,774,363,267,1,442,2,339,339,678,225,504,916,293,623,0,0,0,105,0.315315315315315,2339,9.6194955109021
"2530",2024,"San Diego State",23,5,21.7,396,942,416,288,0,514,2,334,288,622,278,470,1421,506,915,0,0,0,153,0.386363636363636,2764,10.0578871201158
"2531",2021,"Austin Peay",14,3,21.4,295,523,270,167,1,415,3,248,221,469,182,355,781,239,542,0,0,0,91,0.308474576271186,1724,10.5568445475638
"2532",2021,"Cincinnati",14,3,21.4,273,562,280,182,0,423,0,272,200,472,180,419,786,240,546,0,0,0,83,0.304029304029304,1834,9.81461286804798
"2533",2021,"Presbyterian",14,3,21.4,307,548,302,199,0,323,0,274,236,510,179,362,627,172,455,0,0,0,96,0.312703583061889,1732,10.3348729792148
"2534",2021,"UMass",14,3,21.4,276,536,285,178,0,342,1,339,247,586,167,291,677,211,466,0,0,0,102,0.369565217391304,1723,9.69239698200813
"2535",2022,"Alabama A&M",14,3,21.4,349,637,320,207,0,404,2,280,292,572,145,392,811,228,583,0,0,0,101,0.289398280802292,1965,7.37913486005089
"2536",2022,"Cal State Bakersfield",14,3,21.4,300,596,287,201,0,459,2,276,246,522,180,365,907,266,641,0,0,0,86,0.286666666666667,1878,9.58466453674121
"2537",2022,"Florida State",14,3,21.4,334,744,358,231,0,461,2,339,233,572,182,454,1079,374,705,0,0,0,106,0.317365269461078,2347,7.75458031529612
"2538",2022,"San Francisco",28,6,21.4,289,853,352,238,0,525,4,361,302,663,225,443,1204,423,781,0,0,0,102,0.352941176470588,2471,9.10562525293404
"2539",2022,"Villanova",14,3,21.4,367,799,317,223,0,474,0,330,242,572,244,406,1302,422,880,0,0,0,136,0.370572207084469,2403,10.153974198918
"2540",2023,"Bellarmine",14,3,21.4,420,824,417,258,0,586,6,366,304,670,205,606,1013,294,719,0,0,0,161,0.383333333333333,2605,7.86948176583493
"2541",2023,"Duke",14,3,21.4,411,861,357,232,0,549,0,379,287,666,295,507,1220,404,816,0,0,0,136,0.330900243309002,2658,11.0985703536494
"2542",2023,"IUPUI",14,3,21.4,327,784,377,245,0,455,1,281,237,518,165,442,1227,474,753,0,0,0,120,0.36697247706422,2389,6.90665550439514
"2543",2023,"Montana State",14,3,21.4,401,823,397,284,0,544,2,367,282,649,275,424,1214,390,824,0,0,0,133,0.331670822942643,2500,11
"2544",2023,"Washington",28,6,21.4,556,886,302,200,0,469,3,469,348,817,267,554,1186,334,852,0,0,0,179,0.321942446043165,2878,9.27727588603197
"2545",2024,"Wofford",14,3,21.4,330,784,278,194,0,440,0,266,275,541,213,349,1268,427,841,0,0,0,86,0.260606060606061,2222,9.58595859585959
"2546",2021,"Kent State",19,4,21.1,283,495,294,182,0,333,2,206,235,441,107,308,679,234,445,0,0,0,90,0.318021201413428,1598,6.69586983729662
"2547",2022,"Murray State",19,4,21.1,374,910,413,305,1,351,1,465,300,765,161,464,924,332,592,0,0,0,147,0.393048128342246,2644,6.089258698941
"2548",2022,"New Mexico State",38,8,21.1,490,696,367,227,1,565,2,368,374,742,239,446,1003,316,687,0,0,0,181,0.369387755102041,2409,9.92112909921129
"2549",2023,"Florida International",19,4,21.1,527,782,473,323,0,692,2,420,367,787,308,644,1208,374,834,0,0,0,159,0.301707779886148,2881,10.6907323845887
"2550",2024,"Rice",19,4,21.1,450,860,403,277,0,619,3,392,337,729,278,517,1335,431,904,0,0,0,154,0.342222222222222,2750,10.1090909090909
"2551",2021,"Rhode Island",24,5,20.8,231,434,149,88,0,248,0,244,159,403,127,262,615,205,410,0,0,0,82,0.354978354978355,1411,9.00070871722183
"2552",2022,"Notre Dame",24,5,20.8,415,932,358,236,0,439,1,550,349,899,292,498,1175,394,781,0,0,0,145,0.349397590361446,2881,10.1353696633113
"2553",2023,"Oregon State",29,6,20.7,373,890,338,230,0,403,3,317,194,511,155,442,1230,413,817,0,0,0,120,0.32171581769437,2526,6.13618368962787
"2554",2021,"Buffalo",15,3,20,368,567,298,193,0,380,1,287,245,532,165,295,844,270,574,0,0,0,119,0.323369565217391,1852,8.90928725701944
"2555",2021,"Butler",5,1,20,229,436,203,137,0,301,1,184,192,376,143,351,717,211,506,0,0,0,73,0.318777292576419,1471,9.7212780421482
"2556",2021,"California",5,1,20,193,328,168,105,1,182,0,145,166,311,81,278,415,107,308,0,0,0,51,0.264248704663212,1096,7.39051094890511
"2557",2021,"Colgate",5,1,20,93,198,71,45,1,178,2,85,102,187,43,134,317,103,214,0,0,0,29,0.311827956989247,636,6.76100628930818
"2558",2021,"Incarnate Word",5,1,20,177,355,204,121,0,240,0,153,149,302,122,232,468,149,319,0,0,0,57,0.322033898305085,1120,10.8928571428571
"2559",2021,"Louisiana Tech",20,4,20,304,623,321,222,0,367,0,274,222,496,167,353,888,278,610,0,0,0,98,0.322368421052632,1911,8.7388801674516
"2560",2021,"Loyola Marymount",15,3,20,271,581,278,187,0,387,3,273,256,529,211,420,852,279,573,0,0,0,86,0.317343173431734,1893,11.1463285789752
"2561",2021,"South Florida",15,3,20,371,564,291,192,0,348,4,189,194,383,136,289,856,261,595,0,0,0,116,0.31266846361186,1743,7.80263912794033
"2562",2022,"Appalachian State",15,3,20,342,677,348,205,0,445,2,347,263,610,234,491,905,270,635,0,0,0,112,0.327485380116959,2207,10.6026280018124
"2563",2022,"Creighton",25,5,20,383,845,290,196,0,513,1,424,263,687,231,421,1316,485,831,0,0,0,148,0.386422976501305,2642,8.74337623012869
"2564",2022,"Fairfield",15,3,20,311,786,318,217,3,404,1,276,236,512,255,374,1305,489,816,0,0,0,115,0.369774919614148,2308,11.0485268630849
"2565",2022,"Idaho",20,4,20,330,913,318,223,0,450,0,265,259,524,193,412,1511,517,994,0,0,0,117,0.354545454545455,2513,7.68006366892161
"2566",2022,"Lafayette",25,5,20,371,788,235,148,0,421,3,245,279,524,165,497,1136,407,729,0,0,0,123,0.331536388140162,2358,6.99745547073791
"2567",2022,"Lehigh",10,2,20,329,884,240,162,0,369,0,305,318,623,212,414,1241,459,782,0,0,0,110,0.33434650455927,2440,8.68852459016393
"2568",2022,"Loyola Maryland",30,6,20,316,650,261,175,0,457,1,246,242,488,192,473,1007,334,673,0,0,0,88,0.278481012658228,2077,9.24410207029369
"2569",2022,"New Orleans",5,1,20,266,519,281,174,0,477,0,190,222,412,212,438,868,245,623,0,0,0,72,0.270676691729323,1725,12.2898550724638
"2570",2022,"North Dakota State",15,3,20,349,720,367,248,0,500,3,277,253,530,189,433,1046,361,685,0,0,0,120,0.343839541547278,2226,8.49056603773585
"2571",2022,"Northeastern",15,3,20,353,697,281,184,0,511,1,325,272,597,224,506,991,321,670,0,0,0,97,0.274787535410765,2266,9.88526037069726
"2572",2022,"Northern Illinois",20,4,20,368,853,282,186,0,375,3,346,321,667,184,438,1097,361,736,0,0,0,117,0.317934782608696,2443,7.53172329103561
"2573",2022,"San Diego",20,4,20,487,688,457,285,0,650,3,420,309,729,398,560,1132,329,803,0,0,0,171,0.351129363449692,2592,15.3549382716049
"2574",2022,"UTSA",20,4,20,531,765,383,229,0,617,3,251,313,564,233,585,1141,313,828,0,0,0,159,0.299435028248588,2536,9.18769716088328
"2575",2023,"Boston College",5,1,20,427,736,394,246,1,502,4,463,376,839,249,594,930,260,670,0,0,0,139,0.325526932084309,2587,9.62504831851566
"2576",2023,"East Tennessee State",10,2,20,508,799,338,225,0,494,0,398,344,742,225,443,1115,364,751,0,0,0,170,0.334645669291339,2598,8.66050808314088
"2577",2023,"Kansas State",5,1,20,331,911,496,350,0,628,1,423,333,756,327,526,1263,388,875,0,0,0,106,0.3202416918429,2701,12.1066271751203
"2578",2023,"Maine",20,4,20,331,710,227,151,0,436,0,390,336,726,179,448,902,293,609,0,0,0,100,0.302114803625378,2229,8.03050695379094
"2579",2023,"Miami",25,5,20,485,896,453,297,0,591,3,478,308,786,301,557,1311,428,883,0,0,0,165,0.34020618556701,2974,10.1210490921318
"2580",2023,"New Hampshire",15,3,20,301,657,303,199,0,394,0,234,291,525,177,431,937,272,665,0,0,0,73,0.242524916943522,1962,9.02140672782875
"2581",2023,"Penn State",20,4,20,376,729,399,255,1,553,2,447,337,784,346,520,1121,363,758,0,0,0,122,0.324468085106383,2550,13.5686274509804
"2582",2023,"Stonehill",25,5,20,313,651,284,187,0,404,0,279,266,545,108,403,946,303,643,0,0,0,94,0.300319488817891,2017,5.35448686167576
"2583",2023,"UL Monroe",10,2,20,514,836,485,296,0,531,4,397,375,772,216,518,1088,327,761,0,0,0,200,0.389105058365759,2710,7.97047970479705
"2584",2023,"Valparaiso",15,3,20,237,677,348,226,0,572,4,332,301,633,173,533,795,263,532,0,0,0,80,0.337552742616034,2135,8.10304449648712
"2585",2023,"West Virginia",10,2,20,383,742,353,228,0,507,1,353,295,648,288,396,1203,368,835,0,0,0,119,0.310704960835509,2319,12.4191461836999
"2586",2024,"Brown",15,3,20,351,647,299,186,0,428,0,335,350,685,227,413,899,285,614,0,0,0,100,0.284900284900285,2098,10.8198284080076
"2587",2024,"Little Rock",20,4,20,321,639,344,203,0,547,1,292,240,532,223,428,1008,321,687,0,0,0,118,0.367601246105919,2097,10.6342393896042
"2588",2024,"Loyola Maryland",20,4,20,306,702,300,195,0,522,1,343,300,643,210,425,968,326,642,0,0,0,98,0.320261437908497,2179,9.6374483708123
"2589",2024,"Purdue Fort Wayne",20,4,20,440,888,379,257,0,587,2,318,340,658,303,475,1489,566,923,0,0,0,147,0.334090909090909,2774,10.9228550829128
"2590",2024,"Southeast Missouri State",10,2,20,413,675,386,253,0,579,2,318,292,610,267,483,1102,331,771,0,0,0,131,0.317191283292978,2317,11.5235217954251
"2591",2024,"Texas A&M",10,2,20,541,893,381,240,0,526,4,475,353,828,273,456,1227,363,864,0,0,0,168,0.310536044362292,2838,9.61945031712474
"2592",2024,"Toledo",10,2,20,387,864,409,276,0,479,1,450,341,791,228,416,1125,398,727,0,0,0,132,0.341085271317829,2610,8.73563218390805
"2593",2024,"UC Davis",15,3,20,328,935,276,180,0,544,1,395,313,708,244,557,1176,383,793,0,0,0,112,0.341463414634146,2664,9.15915915915916
"2594",2024,"UC Santa Barbara",30,6,20,345,809,308,208,0,462,2,314,262,576,139,479,1097,375,722,0,0,0,102,0.295652173913043,2396,5.80133555926544
"2595",2024,"Sam Houston",31,6,19.4,529,672,484,309,0,560,6,281,365,646,244,530,1163,362,801,0,0,0,175,0.330812854442344,2480,9.83870967741936
"2596",2022,"Houston",26,5,19.2,532,798,390,238,0,589,2,369,345,714,339,528,1364,431,933,0,0,0,174,0.327067669172932,2752,12.3183139534884
"2597",2022,"Georgia Tech",21,4,19,422,889,333,205,0,423,1,350,243,593,189,446,1205,380,825,0,0,0,143,0.338862559241706,2576,7.33695652173913
"2598",2022,"Seton Hall",21,4,19,332,960,325,230,0,465,4,371,282,653,271,458,1548,570,978,0,0,0,121,0.364457831325301,2785,9.73070017953321
"2599",2023,"Boise State",21,4,19,483,951,433,271,1,565,5,376,299,675,152,563,1202,392,810,0,0,0,163,0.337474120082816,2884,5.27045769764216
"2600",2023,"George Mason",21,4,19,518,819,457,269,0,504,4,330,329,659,203,489,1134,342,792,0,0,0,168,0.324324324324324,2599,7.81069642170065
"2601",2024,"UC San Diego",21,4,19,375,769,311,205,0,443,0,279,307,586,222,481,1046,318,728,0,0,0,110,0.293333333333333,2296,9.66898954703833
"2602",2024,"UCF",21,4,19,420,724,393,267,0,516,8,385,405,790,212,537,838,268,570,0,0,0,135,0.321428571428571,2421,8.75671210243701
"2603",2021,"Dayton",16,3,18.8,300,521,205,129,0,317,0,207,156,363,92,271,720,248,472,0,0,0,105,0.35,1592,5.77889447236181
"2604",2021,"Ole Miss",16,3,18.8,351,727,404,262,0,526,1,353,270,623,241,440,1007,338,669,0,0,0,111,0.316239316239316,2315,10.4103671706263
"2605",2021,"Sacramento State",16,3,18.8,322,564,283,181,0,366,0,261,300,561,188,340,914,267,647,0,0,0,96,0.298136645962733,1821,10.3239978034047
"2606",2022,"Bryant",16,3,18.8,388,793,301,198,0,491,1,358,398,756,214,617,977,311,666,0,0,0,112,0.288659793814433,2542,8.41856805664831
"2607",2022,"Evansville",16,3,18.8,340,733,458,301,0,581,2,353,365,718,241,484,1073,329,744,0,0,0,108,0.317647058823529,2349,10.2596849723286
"2608",2022,"George Mason",16,3,18.8,356,750,379,237,0,463,1,273,256,529,166,458,1117,328,789,0,0,0,100,0.280898876404494,2250,7.37777777777778
"2609",2022,"Iowa",16,3,18.8,300,960,382,299,0,496,2,568,292,860,230,463,1108,420,688,0,0,0,124,0.413333333333333,2818,8.16181689141235
"2610",2022,"UC Davis",16,3,18.8,279,798,277,177,0,386,0,276,189,465,152,438,972,315,657,0,0,0,94,0.336917562724014,2169,7.0078377132319
"2611",2023,"Georgia Tech",16,3,18.8,412,739,343,233,0,480,2,304,266,570,207,452,1179,356,823,0,0,0,119,0.288834951456311,2344,8.83105802047782
"2612",2023,"Rhode Island",16,3,18.8,461,861,336,215,1,491,0,346,302,648,247,495,1186,413,773,0,0,0,153,0.331887201735358,2656,9.29969879518072
"2613",2023,"Sacramento State",16,3,18.8,378,869,338,222,0,540,0,392,256,648,172,486,1086,412,674,0,0,0,145,0.383597883597884,2623,6.55737704918033
"2614",2023,"UNC Greensboro",16,3,18.8,477,705,358,220,0,491,1,401,345,746,221,432,1083,332,751,0,0,0,167,0.350104821802935,2411,9.16632102861883
"2615",2022,"Arizona State",27,5,18.5,366,617,304,207,0,457,4,260,237,497,188,383,1007,322,685,0,0,0,112,0.306010928961749,2032,9.25196850393701
"2616",2023,"New Mexico State",49,9,18.4,513,801,399,246,1,693,4,386,312,698,313,487,1375,452,923,0,0,0,166,0.323586744639376,2737,11.4358786993058
"2617",2024,"Tulane",38,7,18.4,395,790,304,210,1,470,2,347,236,583,231,537,1208,400,808,0,0,0,123,0.311392405063291,2538,9.1016548463357
"2618",2021,"Boise State",11,2,18.2,304,610,213,132,0,324,2,264,163,427,149,316,921,287,634,0,0,0,116,0.381578947368421,1833,8.12875068194217
"2619",2021,"Charleston",11,2,18.2,224,326,198,120,0,286,2,142,150,292,130,213,665,181,484,0,0,0,60,0.267857142857143,1125,11.5555555555556
"2620",2021,"East Tennessee State",11,2,18.2,253,441,232,139,0,321,0,183,200,383,167,338,671,186,485,0,0,0,70,0.276679841897233,1463,11.4149008885851
"2621",2021,"Middle Tennessee",22,4,18.2,345,654,391,237,0,416,2,343,254,597,179,290,1003,297,706,0,0,0,114,0.330434782608696,2025,8.83950617283951
"2622",2021,"Northern Kentucky",11,2,18.2,225,471,238,152,0,274,1,184,149,333,83,275,713,239,474,0,0,0,80,0.355555555555556,1463,5.67327409432673
"2623",2022,"Abilene Christian",11,2,18.2,377,688,367,254,0,475,5,353,289,642,230,430,1119,407,712,0,0,0,103,0.273209549071618,2344,9.8122866894198
"2624",2022,"Elon",11,2,18.2,385,667,328,226,0,500,0,332,289,621,210,491,994,311,683,0,0,0,113,0.293506493506493,2272,9.24295774647887
"2625",2022,"North Alabama",11,2,18.2,311,767,312,217,1,490,3,355,340,695,198,465,981,334,647,0,0,0,98,0.315112540192926,2311,8.56771960190394
"2626",2022,"Northern Kentucky",11,2,18.2,360,775,338,213,0,411,0,343,280,623,241,430,1084,359,725,0,0,0,121,0.336111111111111,2349,10.2596849723286
"2627",2022,"Sacred Heart",11,2,18.2,289,623,275,176,0,506,1,249,317,566,163,414,828,277,551,0,0,0,69,0.238754325259516,1910,8.53403141361257
"2628",2023,"East Carolina",11,2,18.2,589,720,505,296,0,593,6,470,439,909,420,548,1026,255,771,0,0,0,186,0.31578947368421,2700,15.5555555555556
"2629",2023,"Eastern Michigan",11,2,18.2,336,806,354,229,0,470,4,454,366,820,230,521,902,256,646,0,0,0,111,0.330357142857143,2470,9.31174089068826
"2630",2023,"Evansville",11,2,18.2,343,731,491,323,0,529,4,331,356,687,169,507,957,286,671,0,0,0,101,0.294460641399417,2310,7.31601731601732
"2631",2023,"Jacksonville",11,2,18.2,322,626,267,179,0,470,1,307,256,563,203,378,948,309,639,0,0,0,116,0.360248447204969,2016,10.0694444444444
"2632",2023,"Southern Indiana",22,4,18.2,360,739,358,253,0,500,3,348,283,631,230,584,946,285,661,0,0,0,111,0.308333333333333,2397,9.59532749269921
"2633",2023,"Stetson",11,2,18.2,422,705,443,272,0,497,0,393,408,801,257,500,892,274,618,0,0,0,136,0.322274881516588,2407,10.6771915247196
"2634",2023,"UNC Asheville",11,2,18.2,415,770,361,221,0,539,2,238,258,496,231,540,1281,407,874,0,0,0,128,0.308433734939759,2446,9.44399018806214
"2635",2021,"Drexel",17,3,17.6,278,453,171,118,0,352,1,211,193,404,198,245,879,297,582,0,0,0,87,0.31294964028777,1531,12.9327237099935
"2636",2021,"VCU",34,6,17.6,361,631,296,201,1,369,2,275,302,577,193,328,904,285,619,0,0,0,108,0.299168975069252,1961,9.8419173890872
"2637",2022,"Kennesaw State",17,3,17.6,383,627,336,204,0,470,2,309,276,585,205,434,950,296,654,0,0,0,141,0.368146214099217,2131,9.61989676208353
"2638",2023,"DePaul",17,3,17.6,568,868,420,269,0,488,0,475,389,864,293,462,1383,463,920,0,0,0,193,0.339788732394366,2962,9.89196488858879
"2639",2023,"Houston",34,6,17.6,496,686,361,225,0,610,7,354,358,712,389,493,1166,335,831,0,0,0,167,0.336693548387097,2448,15.890522875817
"2640",2023,"South Florida",17,3,17.6,466,967,422,284,1,488,6,453,310,763,178,517,1164,397,767,0,0,0,149,0.319742489270386,2916,6.1042524005487
"2641",2024,"Princeton",17,3,17.6,425,681,305,195,0,465,0,381,265,646,240,396,1156,438,718,0,0,0,152,0.357647058823529,2399,10.0041684035015
"2642",2022,"UAB",23,4,17.4,367,792,384,264,0,479,1,352,229,581,147,457,993,305,688,0,0,0,144,0.392370572207084,2387,6.158357771261
"2643",2024,"Baylor",23,4,17.4,480,944,384,251,0,576,3,460,274,734,313,534,1414,492,922,0,0,0,168,0.35,3019,10.3676714143756
"2644",2023,"Northern Arizona",41,7,17.1,466,907,395,260,0,585,1,447,439,886,257,454,1263,425,838,0,0,0,154,0.330472103004292,2801,9.17529453766512
"2645",2021,"Florida Atlantic",12,2,16.7,390,614,284,167,0,489,5,265,189,454,167,410,965,319,646,0,0,0,136,0.348717948717949,2067,8.07934204160619
"2646",2021,"Grand Canyon",12,2,16.7,341,559,299,184,0,493,3,415,331,746,317,355,815,255,560,0,0,0,115,0.337243401759531,1990,15.929648241206
"2647",2021,"Indiana",12,2,16.7,298,710,353,237,1,390,0,385,267,652,167,276,889,305,584,0,0,0,115,0.385906040268456,2072,8.05984555984556
"2648",2021,"Notre Dame",18,3,16.7,211,522,227,150,0,324,0,285,185,470,163,342,688,243,445,0,0,0,66,0.312796208530806,1657,9.83705491852746
"2649",2021,"Stephen F. Austin",6,1,16.7,413,694,358,222,0,508,1,448,300,748,357,425,917,355,562,0,0,0,154,0.372881355932203,2425,14.7216494845361
"2650",2022,"Central Michigan",18,3,16.7,311,711,267,174,0,485,0,310,296,606,163,465,1020,293,727,0,0,0,91,0.292604501607717,2149,7.58492322010237
"2651",2022,"East Carolina",6,1,16.7,515,633,400,222,1,519,7,341,323,664,308,480,1057,291,766,0,0,0,152,0.295145631067961,2355,13.0785562632696
"2652",2022,"La Salle",24,4,16.7,358,654,301,204,0,461,2,201,207,408,261,404,1258,437,821,0,0,0,127,0.354748603351955,2120,12.311320754717
"2653",2022,"Lipscomb",18,3,16.7,299,816,274,180,0,522,4,278,266,544,151,465,1140,377,763,0,0,0,95,0.317725752508361,2302,6.55951346655083
"2654",2022,"Milwaukee",18,3,16.7,343,710,250,182,0,477,1,291,241,532,213,489,1051,344,707,0,0,0,98,0.285714285714286,2238,9.51742627345844
"2655",2023,"California Baptist",24,4,16.7,453,1029,533,335,0,745,4,539,461,1000,334,534,1245,365,880,0,0,0,173,0.381898454746137,3055,10.9328968903437
"2656",2023,"Campbell",12,2,16.7,466,861,332,184,0,479,0,363,287,650,196,593,993,301,692,0,0,0,159,0.341201716738197,2663,7.36012016522719
"2657",2024,"Cal State Fullerton",12,2,16.7,343,730,286,198,0,460,1,325,295,620,253,520,1122,360,762,0,0,0,105,0.306122448979592,2348,10.7751277683135
"2658",2024,"Marquette",24,4,16.7,352,845,307,215,0,492,0,416,311,727,219,470,1154,423,731,0,0,0,125,0.355113636363636,2586,8.46867749419954
"2659",2024,"Wisconsin",12,2,16.7,405,838,372,252,0,508,2,388,308,696,232,591,1079,326,753,0,0,0,138,0.340740740740741,2641,8.78455130632336
"2660",2023,"SMU",25,4,16,394,810,340,220,0,443,5,397,343,740,250,479,1005,319,686,0,0,0,112,0.284263959390863,2486,10.0563153660499
"2661",2024,"North Carolina",25,4,16,422,886,450,274,0,556,2,401,284,685,241,430,1322,424,898,0,0,0,140,0.33175355450237,2683,8.98248229593738
"2662",2022,"Gonzaga",19,3,15.8,521,908,395,279,0,526,3,412,355,767,263,507,1176,430,746,0,0,0,183,0.351247600767754,2876,9.14464534075104
"2663",2022,"Akron",13,2,15.4,344,748,358,232,0,447,3,423,366,789,212,441,890,291,599,0,0,0,113,0.328488372093023,2334,9.08311910882605
"2664",2022,"Chicago State",13,2,15.4,356,553,322,190,0,524,1,254,289,543,198,453,833,232,601,0,0,0,86,0.241573033707865,1920,10.3125
"2665",2022,"Prairie View A&M",13,2,15.4,378,699,329,209,0,543,0,259,269,528,265,522,1090,336,754,0,0,0,127,0.335978835978836,2273,11.6586009678839
"2666",2022,"UNC Greensboro",13,2,15.4,406,662,296,166,0,391,0,268,259,527,175,443,907,279,628,0,0,0,151,0.37192118226601,2145,8.15850815850816
"2667",2022,"USC",13,2,15.4,362,716,330,222,2,431,2,299,269,568,187,416,935,301,634,0,0,0,120,0.331491712707182,2176,8.59375
"2668",2023,"California",13,2,15.4,366,737,327,213,0,524,2,345,331,676,165,422,1130,410,720,0,0,0,119,0.325136612021858,2362,6.98560541913632
"2669",2023,"Texas A&M-Corpus Christi",13,2,15.4,397,796,424,268,0,549,1,346,325,671,274,505,1019,322,697,0,0,0,112,0.282115869017632,2454,11.1654441727791
"2670",2022,"Texas A&M-Corpus Christi",20,3,15,430,772,440,286,0,505,0,374,295,669,297,520,976,286,690,0,0,0,132,0.306976744186047,2485,11.9517102615694
"2671",2024,"Elon",20,3,15,443,736,274,162,0,523,5,319,374,693,243,522,1100,301,799,0,0,0,141,0.318284424379232,2389,10.1716199246547
"2672",2021,"Arizona",7,1,14.3,244,600,277,175,0,354,0,263,217,480,252,278,877,279,598,0,0,0,75,0.307377049180328,1739,14.4910868315124
"2673",2021,"Houston Christian",14,2,14.3,334,561,316,210,0,390,0,259,298,557,213,330,770,247,523,0,0,0,115,0.344311377245509,1794,11.8729096989967
"2674",2021,"North Texas",14,2,14.3,284,471,243,151,0,327,0,238,142,380,162,262,820,239,581,0,0,0,95,0.334507042253521,1549,10.458360232408
"2675",2021,"Sam Houston",7,1,14.3,420,563,456,285,1,521,1,333,265,598,259,459,849,283,566,0,0,0,152,0.361904761904762,2162,11.9796484736355
"2676",2021,"Siena",7,1,14.3,173,291,127,76,0,200,2,138,144,282,100,212,455,142,313,0,0,0,43,0.248554913294798,976,10.2459016393443
"2677",2021,"Towson",7,1,14.3,381,569,305,193,0,367,4,324,234,558,137,351,792,255,537,0,0,0,131,0.343832020997375,1958,6.99693564862104
"2678",2022,"Nebraska",7,1,14.3,485,949,436,293,0,540,3,502,368,870,242,464,1217,427,790,0,0,0,179,0.369072164948454,2950,8.20338983050847
"2679",2022,"Old Dominion",14,2,14.3,559,777,464,271,0,602,6,411,336,747,350,498,1224,376,848,0,0,0,184,0.329159212880143,2737,12.7877237851662
"2680",2022,"Purdue Fort Wayne",14,2,14.3,301,647,192,144,0,448,0,201,205,406,189,452,1195,410,785,0,0,0,98,0.325581395348837,2054,9.20155793573515
"2681",2022,"St. Francis Brooklyn",14,2,14.3,298,641,281,188,0,385,0,324,297,621,212,389,941,306,635,0,0,0,92,0.308724832214765,2028,10.4536489151874
"2682",2022,"UL Monroe",7,1,14.3,425,608,365,224,0,494,4,269,240,509,224,466,1024,290,734,0,0,0,134,0.315294117647059,2143,10.4526364909006
"2683",2022,"William & Mary",14,2,14.3,249,630,216,150,0,423,0,280,252,532,203,526,894,279,615,0,0,0,69,0.27710843373494,2018,10.0594648166501
"2684",2023,"Cornell",7,1,14.3,413,617,320,203,1,474,0,278,296,574,252,490,1007,311,696,0,0,0,131,0.317191283292978,2187,11.522633744856
"2685",2023,"Fairleigh Dickinson",7,1,14.3,422,823,347,226,0,523,2,320,297,617,212,453,1193,435,758,0,0,0,144,0.341232227488152,2530,8.3794466403162
"2686",2023,"LSU",7,1,14.3,704,1054,622,399,0,565,8,625,417,1042,342,494,1288,455,833,0,0,0,274,0.389204545454545,3508,9.74914481185861
"2687",2023,"Manhattan",21,3,14.3,593,855,427,278,0,541,1,378,417,795,310,594,1208,344,864,0,0,0,196,0.330522765598651,2884,10.748959778086
"2688",2023,"New Mexico",14,2,14.3,344,915,356,250,0,435,4,469,317,786,264,460,1227,415,812,0,0,0,123,0.357558139534884,2699,9.78140051871063
"2689",2023,"UCF",14,2,14.3,537,803,442,276,0,486,6,320,392,712,223,523,1020,276,744,0,0,0,175,0.325884543761639,2553,8.73482177830004
"2690",2024,"Maryland-Eastern Shore",7,1,14.3,430,616,318,196,0,421,2,285,275,560,212,411,937,295,642,0,0,0,151,0.351162790697674,2114,10.0283822138127
"2691",2024,"Northwestern",7,1,14.3,364,722,292,210,0,519,0,333,283,616,176,490,1191,412,779,0,0,0,121,0.332417582417582,2396,7.34557595993322
"2692",2024,"South Alabama",7,1,14.3,457,786,395,261,0,600,8,295,326,621,209,599,1154,355,799,0,0,0,159,0.347921225382932,2585,8.08510638297872
"2693",2024,"Utah Tech",7,1,14.3,293,994,306,208,0,416,1,338,285,623,201,421,1317,514,803,0,0,0,126,0.430034129692833,2651,7.58204451150509
"2694",2023,"UCLA",29,4,13.8,618,955,422,299,0,712,1,400,352,752,299,489,1609,530,1079,0,0,0,197,0.318770226537217,3110,9.61414790996785
"2695",2024,"Nebraska",22,3,13.6,488,958,410,275,0,561,4,401,283,684,219,483,1402,469,933,0,0,0,153,0.313524590163934,2904,7.54132231404959
"2696",2021,"Long Island University",15,2,13.3,294,412,228,132,0,358,3,195,236,431,195,309,651,184,467,0,0,0,74,0.251700680272109,1446,13.4854771784232
"2697",2022,"Utah Valley",15,2,13.3,363,867,293,212,0,473,3,382,322,704,179,470,1016,344,672,0,0,0,135,0.371900826446281,2495,7.17434869739479
"2698",2023,"Akron",15,2,13.3,286,848,381,270,0,377,0,363,277,640,217,445,989,340,649,0,0,0,95,0.332167832167832,2376,9.13299663299663
"2699",2023,"Furman",15,2,13.3,547,741,393,263,0,453,2,342,383,725,188,528,988,297,691,0,0,0,183,0.3345521023766,2549,7.37544134954884
"2700",2023,"Grand Canyon",15,2,13.3,455,748,438,275,0,577,6,485,398,883,391,523,1008,334,674,0,0,0,159,0.349450549450549,2661,14.6937241638482
"2701",2023,"Navy",15,2,13.3,354,776,222,128,0,568,0,212,233,445,129,527,1275,408,867,0,0,0,114,0.322033898305085,2330,5.53648068669528
"2702",2023,"Wichita State",15,2,13.3,460,905,450,304,0,510,7,439,404,843,246,530,1103,354,749,0,0,0,144,0.31304347826087,2792,8.810888252149
"2703",2024,"Campbell",15,2,13.3,358,822,288,172,0,411,0,377,300,677,177,501,917,298,619,0,0,0,114,0.318435754189944,2420,7.31404958677686
"2704",2024,"NC State",15,2,13.3,403,1088,469,321,0,429,2,445,325,770,227,410,1416,471,945,0,0,0,133,0.330024813895782,2943,7.71321780496092
"2705",2024,"Northwestern State",15,2,13.3,355,823,382,229,0,500,4,321,332,653,177,517,1027,309,718,0,0,0,103,0.290140845070423,2412,7.33830845771144
"2706",2023,"Missouri State",23,3,13,548,806,452,276,0,560,0,430,273,703,255,496,1315,384,931,0,0,0,168,0.306569343065693,2782,9.16606757728253
"2707",2023,"Saint Mary's",23,3,13,390,826,308,201,0,519,2,381,384,765,194,536,1007,339,668,0,0,0,123,0.315384615384615,2537,7.64682696097753
"2708",2021,"Kansas State",16,2,12.5,287,731,320,217,0,416,2,298,200,498,161,470,955,298,657,0,0,0,88,0.306620209059233,2158,7.46061167747915
"2709",2021,"Missouri",8,1,12.5,190,461,187,112,0,313,5,232,152,384,103,236,593,225,368,0,0,0,81,0.426315789473684,1395,7.38351254480287
"2710",2021,"Pittsburgh",16,2,12.5,308,488,233,141,0,381,5,218,190,408,130,342,787,238,549,0,0,0,87,0.282467532467532,1646,7.89793438639125
"2711",2023,"UC Davis",8,1,12.5,328,781,286,180,0,484,2,350,312,662,186,436,980,322,658,0,0,0,113,0.344512195121951,2295,8.10457516339869
"2712",2023,"Virginia",8,1,12.5,490,814,373,245,0,549,6,406,363,769,259,480,1130,365,765,0,0,0,176,0.359183673469388,2656,9.75150602409639
"2713",2024,"Florida",24,3,12.5,396,778,401,269,0,585,6,478,352,830,282,460,1153,380,773,0,0,0,120,0.303030303030303,2600,10.8461538461538
"2714",2024,"Prairie View A&M",8,1,12.5,418,565,347,229,0,526,4,293,250,543,257,483,946,293,653,0,0,0,147,0.351674641148325,2132,12.0544090056285
"2715",2024,"Xavier",8,1,12.5,262,583,206,129,0,462,0,252,241,493,189,533,969,276,693,0,0,0,72,0.274809160305344,1951,9.68733982573039
"2716",2023,"Idaho State",17,2,11.8,350,657,266,160,0,461,4,239,246,485,158,417,952,292,660,0,0,0,96,0.274285714285714,2020,7.82178217821782
"2717",2023,"Texas Southern",17,2,11.8,378,653,400,248,0,574,2,226,263,489,197,536,1025,292,733,0,0,0,104,0.275132275132275,2176,9.05330882352941
"2718",2024,"Mount St. Mary's",17,2,11.8,349,747,270,174,0,487,2,247,241,488,267,478,1259,389,870,0,0,0,108,0.30945558739255,2283,11.6951379763469
"2719",2024,"UNC Greensboro",17,2,11.8,546,824,389,236,0,512,0,434,343,777,233,434,1185,364,821,0,0,0,195,0.357142857142857,2708,8.60413589364845
"2720",2024,"Wright State",17,2,11.8,329,840,370,266,0,539,0,344,328,672,263,455,1297,472,825,0,0,0,106,0.322188449848024,2526,10.4117181314331
"2721",2021,"Delaware",9,1,11.1,566,662,369,249,0,456,0,306,264,570,243,367,1162,341,821,0,0,0,185,0.326855123674912,2329,10.4336625161013
"2722",2021,"Furman",9,1,11.1,287,561,240,147,0,345,0,269,206,475,131,408,715,214,501,0,0,0,82,0.285714285714286,1808,7.24557522123894
"2723",2021,"Georgetown",9,1,11.1,245,402,140,80,0,263,1,151,140,291,123,300,609,164,445,0,0,0,77,0.314285714285714,1300,9.46153846153846
"2724",2021,"Mississippi Valley State",9,1,11.1,205,326,166,100,0,201,0,123,118,241,67,203,509,149,360,0,0,0,73,0.35609756097561,1040,6.44230769230769
"2725",2021,"St. John's",9,1,11.1,260,541,206,139,0,297,0,306,218,524,155,395,793,256,537,0,0,0,90,0.346153846153846,1818,8.52585258525852
"2726",2021,"Youngstown State",9,1,11.1,164,471,197,131,0,291,0,186,109,295,104,279,665,242,423,0,0,0,53,0.323170731707317,1387,7.49819754866619
"2727",2022,"Liberty",9,1,11.1,490,920,363,222,0,532,0,482,349,831,182,508,963,321,642,0,0,0,171,0.348979591836735,2804,6.490727532097
"2728",2022,"Michigan",9,1,11.1,431,854,445,303,0,481,3,498,347,845,213,489,931,302,629,0,0,0,163,0.378190255220418,2698,7.89473684210526
"2729",2022,"North Texas",18,2,11.1,369,710,399,246,0,428,1,293,196,489,174,390,1094,363,731,0,0,0,121,0.327913279132791,2220,7.83783783783784
"2730",2023,"Jacksonville State",27,3,11.1,411,781,375,242,0,470,1,340,344,684,201,370,1106,328,778,0,0,0,125,0.304136253041363,2315,8.68250539956803
"2731",2023,"UC San Diego",9,1,11.1,270,747,270,193,0,443,0,252,243,495,165,457,1008,328,680,0,0,0,69,0.255555555555556,2129,7.75011742602161
"2732",2022,"Lamar",19,2,10.5,332,682,367,230,0,454,2,304,263,567,201,447,948,312,636,0,0,0,108,0.325301204819277,2162,9.29694727104533
"2733",2021,"Alabama",10,1,10,309,699,372,257,0,358,1,358,272,630,140,351,923,314,609,0,0,0,112,0.362459546925566,2145,6.52680652680653
"2734",2021,"Central Connecticut",10,1,10,196,445,206,141,0,262,1,189,193,382,123,302,679,200,479,0,0,0,55,0.280612244897959,1380,8.91304347826087
"2735",2021,"South Carolina Upstate",10,1,10,239,592,254,151,0,326,2,203,233,436,113,378,725,229,496,0,0,0,71,0.297071129707113,1704,6.63145539906103
"2736",2022,"Loyola Chicago",10,1,10,320,829,285,185,0,462,3,300,287,587,189,428,1080,363,717,0,0,0,99,0.309375,2305,8.19956616052061
"2737",2022,"Wake Forest",10,1,10,463,824,379,242,0,522,1,381,354,735,215,486,1176,373,803,0,0,0,143,0.308855291576674,2616,8.21865443425076
"2738",2023,"Youngstown State",10,1,10,305,808,336,206,0,494,0,402,251,653,191,425,1050,336,714,0,0,0,98,0.321311475409836,2352,8.12074829931973
"2739",2024,"Butler",10,1,10,364,762,251,164,0,404,0,337,330,667,194,465,1099,404,695,0,0,0,110,0.302197802197802,2402,8.07660283097419
"2740",2024,"Weber State",10,1,10,387,797,346,225,0,489,0,339,362,701,238,500,1067,327,740,0,0,0,127,0.328165374677003,2440,9.75409836065574
"2741",2024,"Western Carolina",10,1,10,322,726,318,197,2,500,2,373,335,708,153,533,888,277,611,0,0,0,94,0.291925465838509,2312,6.61764705882353
"2742",2023,"Sacred Heart",22,2,9.1,463,805,397,238,0,590,0,313,317,630,308,499,1286,418,868,0,0,0,139,0.300215982721382,2582,11.9287374128582
"2743",2024,"Middle Tennessee",11,1,9.1,400,963,411,286,0,524,4,403,282,685,243,414,1323,470,853,0,0,0,140,0.35,2755,8.82032667876588
"2744",2021,"Pepperdine",12,1,8.3,303,536,284,180,0,350,0,216,240,456,162,380,735,246,489,0,0,0,106,0.34983498349835,1742,9.29965556831228
"2745",2022,"South Carolina",12,1,8.3,647,1145,557,350,0,490,0,550,426,976,239,535,1262,391,871,0,0,0,171,0.264296754250386,3439,6.94969467868566
"2746",2022,"Southern Illinois",12,1,8.3,407,716,373,242,0,451,1,417,342,759,249,407,978,310,668,0,0,0,149,0.366093366093366,2340,10.6410256410256
"2747",2022,"UNC Wilmington",12,1,8.3,331,552,245,164,0,466,1,256,249,505,190,471,959,280,679,0,0,0,106,0.3202416918429,1952,9.73360655737705
"2748",2023,"Green Bay",12,1,8.3,384,919,302,218,0,423,0,270,223,493,211,372,1403,547,856,0,0,0,139,0.361979166666667,2564,8.22932917316693
"2749",2023,"Seton Hall",12,1,8.3,346,775,315,227,0,469,5,405,298,703,255,420,1189,423,766,0,0,0,117,0.338150289017341,2442,10.4422604422604
"2750",2023,"UMass Lowell",12,1,8.3,275,563,279,187,0,406,6,224,290,514,173,448,796,243,553,0,0,0,63,0.229090909090909,1820,9.5054945054945
"2751",2024,"Arkansas",12,1,8.3,396,942,459,302,0,471,6,366,380,746,204,419,1334,413,921,0,0,0,144,0.363636363636364,2653,7.6894082171127
"2752",2024,"Evansville",12,1,8.3,394,781,451,297,0,575,3,424,479,903,181,571,948,247,701,0,0,0,139,0.352791878172589,2523,7.17399920729291
"2753",2023,"Norfolk State",14,1,7.1,567,862,458,280,1,587,5,406,366,772,398,575,1141,333,808,0,0,0,181,0.319223985890653,2849,13.969813969814
"2754",2023,"Tulane",14,1,7.1,456,877,351,230,0,452,5,405,300,705,241,528,1157,373,784,0,0,0,155,0.339912280701754,2728,8.83431085043988
"2755",2021,"Maine",15,1,6.7,210,497,176,116,0,318,0,236,168,404,196,249,764,264,500,0,0,0,64,0.304761904761905,1500,13.0666666666667
"2756",2021,"South Carolina",15,1,6.7,513,954,472,299,0,459,2,515,375,890,224,436,1092,350,742,0,0,0,166,0.323586744639376,2909,7.70024063251977
"2757",2023,"Pacific",15,1,6.7,460,842,366,252,0,569,2,466,433,899,267,538,1045,320,725,0,0,0,137,0.297826086956522,2711,9.84876429361859
"2758",2024,"Utah Valley",15,1,6.7,386,653,367,210,0,562,1,361,357,718,316,467,906,247,659,0,0,0,126,0.326424870466321,2204,14.3375680580762
"2759",2022,"Texas Southern",21,1,4.8,343,637,376,243,0,452,4,331,307,638,235,547,873,264,609,0,0,0,97,0.282798833819242,2211,10.6286748077793
"2760",2021,"Alcorn State",3,0,0,145,225,132,79,0,205,0,113,111,224,133,210,400,102,298,0,0,0,42,0.289655172413793,822,16.1800486618005
"2761",2021,"Army",2,0,0,250,517,241,156,3,296,1,215,261,476,121,325,578,190,388,0,0,0,81,0.324,1552,7.79639175257732
"2762",2021,"Baylor",10,0,0,535,987,445,293,0,496,1,425,222,647,293,495,1397,564,833,0,0,0,221,0.413084112149533,3131,9.35803257745129
"2763",2021,"Belmont Abbey",1,0,0,8,28,9,6,0,19,0,11,4,15,5,20,34,13,21,0,0,0,1,0.125,81,6.17283950617284
"2764",2021,"Boston University",1,0,0,181,366,99,63,0,205,0,183,105,288,124,213,518,183,335,0,0,0,69,0.38121546961326,1143,10.8486439195101
"2765",2021,"California Baptist",1,0,0,254,800,289,189,0,420,0,381,298,679,229,372,847,281,566,0,0,0,80,0.31496062992126,2163,10.5871474803514
"2766",2021,"Chicago State",1,0,0,163,290,171,96,0,237,0,135,166,301,83,273,387,106,281,0,0,0,55,0.337423312883436,1008,8.23412698412698
"2767",2021,"Coppin State",4,0,0,203,381,175,97,0,271,0,117,156,273,75,321,546,148,398,0,0,0,50,0.246305418719212,1204,6.22923588039867
"2768",2021,"East Texas Baptist",1,0,0,15,28,12,6,0,23,0,12,12,24,10,25,41,13,28,0,0,0,8,0.533333333333333,94,10.6382978723404
"2769",2021,"Florida Gulf Coast",2,0,0,207,728,279,186,1,425,0,355,224,579,250,277,1038,384,654,0,0,0,78,0.376811594202899,2028,12.32741617357
"2770",2021,"Florida State",8,0,0,210,445,207,139,0,301,2,192,151,343,129,276,727,240,487,0,0,0,66,0.314285714285714,1420,9.08450704225352
"2771",2021,"Houston",6,0,0,379,591,299,181,0,406,3,310,285,595,246,428,843,247,596,0,0,0,129,0.340369393139842,2030,12.1182266009852
"2772",2021,"Lafayette",4,0,0,145,385,105,69,0,176,0,148,115,263,83,219,473,158,315,0,0,0,48,0.331034482758621,1081,7.67807585568918
"2773",2021,"Loyola Maryland",2,0,0,127,290,115,76,0,224,1,87,115,202,81,186,521,151,370,0,0,0,37,0.291338582677165,872,9.28899082568807
"2774",2021,"Mississippi State",12,0,0,214,461,218,126,0,305,5,208,130,338,97,249,718,246,472,0,0,0,63,0.294392523364486,1444,6.71745152354571
"2775",2021,"Monmouth",2,0,0,238,454,191,107,0,252,0,133,155,288,94,356,608,166,442,0,0,0,54,0.226890756302521,1386,6.78210678210678
"2776",2021,"NC Pembroke",1,0,0,12,37,16,12,0,39,0,25,12,37,17,46,64,19,45,0,0,0,6,0.5,147,11.5646258503401
"2777",2021,"New Mexico",6,0,0,194,521,171,115,0,288,1,264,145,409,149,221,781,275,506,0,0,0,84,0.43298969072165,1515,9.83498349834984
"2778",2021,"Pacific",6,0,0,284,541,260,181,0,352,0,244,230,474,207,369,776,266,510,0,0,0,96,0.338028169014085,1765,11.728045325779
"2779",2021,"Purdue Fort Wayne",4,0,0,278,435,212,135,0,417,1,94,119,213,173,371,1022,327,695,0,0,0,90,0.323741007194245,1552,11.1469072164948
"2780",2021,"SMU",9,0,0,103,152,59,34,0,127,0,32,57,89,52,131,288,94,194,0,0,0,24,0.233009708737864,530,9.81132075471698
"2781",2021,"San José State",2,0,0,46,87,51,28,0,48,0,36,43,79,19,43,124,37,87,0,0,0,12,0.260869565217391,261,7.27969348659004
"2782",2021,"Tennessee State",4,0,0,191,404,152,98,1,311,2,210,164,374,138,356,717,166,551,0,0,0,48,0.25130890052356,1373,10.0509832483613
"2783",2021,"UMBC",4,0,0,138,168,110,68,0,119,0,81,100,181,57,114,225,60,165,0,0,0,44,0.318840579710145,592,9.62837837837838
"2784",2021,"UMass Lowell",4,0,0,251,441,250,157,0,297,1,214,178,392,165,325,592,168,424,0,0,0,89,0.354581673306773,1464,11.2704918032787
"2785",2021,"UNC Wilmington",6,0,0,266,460,263,161,0,261,3,178,168,346,126,326,592,160,432,0,0,0,95,0.357142857142857,1448,8.70165745856354
"2786",2021,"Utah",2,0,0,269,467,240,154,0,326,1,204,215,419,155,354,681,209,472,0,0,0,69,0.256505576208178,1562,9.92317541613316
"2787",2021,"Vanderbilt",1,0,0,124,206,107,68,0,156,1,124,105,229,64,130,315,98,217,0,0,0,42,0.338709677419355,712,8.98876404494382
"2788",2021,"Vermont",1,0,0,56,110,39,24,0,67,0,38,35,73,23,51,172,67,105,0,0,0,22,0.392857142857143,335,6.86567164179105
"2789",2022,"Carroll (MT)",6,0,0,26,52,22,16,0,30,0,11,21,32,9,27,81,29,52,0,0,0,8,0.307692307692308,148,6.08108108108108
"2790",2022,"Coppin State",9,0,0,343,751,399,257,1,419,2,241,257,498,194,395,1038,301,737,0,0,0,127,0.370262390670554,2121,9.14662894860915
"2791",2022,"Emory & Henry",3,0,0,23,48,16,10,0,31,0,13,15,28,18,43,86,20,66,0,0,0,8,0.347826086956522,153,11.7647058823529
"2792",2022,"Florida Memorial",1,0,0,34,80,39,23,0,63,1,31,48,79,28,66,91,31,60,0,0,0,14,0.411764705882353,252,11.1111111111111
"2793",2022,"Illinois",1,0,0,335,675,339,207,1,413,2,275,198,473,181,454,1134,364,770,0,0,0,103,0.307462686567164,2174,8.32566697332107
"2794",2022,"Ole Miss",2,0,0,483,746,424,266,0,513,6,345,267,612,278,428,1216,418,798,0,0,0,173,0.358178053830228,2534,10.9707971586425
"2795",2022,"Wright State",2,0,0,271,599,221,136,0,351,4,226,242,468,182,326,973,302,671,0,0,0,94,0.346863468634686,1787,10.1846670397314
"2796",2023,"Champion Christian College",3,0,0,23,81,30,19,0,27,0,17,18,35,12,47,134,38,96,0,0,0,7,0.304347826086957,214,5.60747663551402
"2797",2023,"Eastern Kentucky",4,0,0,395,818,413,289,0,539,3,412,352,764,292,475,1288,450,838,0,0,0,131,0.331645569620253,2653,11.0064078401809
"2798",2023,"Hartford",3,0,0,292,554,233,140,0,414,2,161,257,418,171,411,1035,260,775,0,0,0,70,0.23972602739726,1729,9.89010989010989
"2799",2023,"Park University Gilbert",1,0,0,21,37,18,10,0,24,0,12,16,28,17,50,79,25,54,0,0,0,8,0.380952380952381,149,11.4093959731544
"2800",2023,"San José State",9,0,0,447,683,382,238,0,653,10,364,376,740,294,563,988,284,704,0,0,0,151,0.337807606263982,2431,12.0937885643768
"2801",2023,"South Dakota State",5,0,0,472,1039,560,374,1,518,0,587,400,987,261,473,1056,379,677,0,0,0,203,0.430084745762712,3104,8.40850515463918
"2802",2023,"Stanford",14,0,0,519,1119,438,297,0,530,1,535,387,922,205,470,1216,438,778,0,0,0,169,0.325626204238921,3194,6.41828428303068
"2803",2023,"Texas A&M-Texarkana",2,0,0,46,87,31,19,0,82,1,45,47,92,51,78,157,44,113,0,0,0,17,0.369565217391304,306,16.6666666666667
"2804",2023,"Texas Lutheran",2,0,0,19,54,17,12,0,49,0,10,12,22,12,36,87,17,70,0,0,0,4,0.210526315789474,141,8.51063829787234
"2805",2023,"Trevecca Nazarene",1,0,0,17,28,15,11,0,21,0,15,10,25,7,23,37,13,24,0,0,0,9,0.529411764705882,100,7
"2806",2023,"Tuskegee",3,0,0,24,24,21,12,0,18,0,14,12,26,14,23,43,14,29,0,0,0,13,0.541666666666667,106,13.2075471698113
"2807",2023,"Western Michigan",4,0,0,307,619,327,200,0,447,1,341,263,604,265,451,990,278,712,0,0,0,81,0.263843648208469,2060,12.8640776699029
"2808",2023,"Wright State",4,0,0,195,711,261,170,0,518,0,314,283,597,186,410,1246,452,794,0,0,0,68,0.348717948717949,2147,8.66325104797392
"2809",2024,"Creighton",5,0,0,320,844,276,213,0,473,0,335,182,517,208,344,1400,520,880,0,0,0,109,0.340625,2443,8.51412198117069
"2810",2024,"Davidson",5,0,0,286,582,254,171,0,418,2,301,246,547,175,348,824,294,530,0,0,0,99,0.346153846153846,1879,9.31346460883449
"2811",2024,"Fisk",1,0,0,33,48,26,19,0,30,0,27,28,55,15,38,66,15,51,0,0,0,11,0.333333333333333,165,9.09090909090909
"2812",2024,"Florida Gulf Coast",3,0,0,497,820,465,304,0,522,1,518,362,880,329,450,1127,364,763,0,0,0,158,0.317907444668008,2764,11.9030390738061
"2813",2024,"Jackson State",1,0,0,623,890,548,360,0,558,4,402,308,710,249,486,1228,375,853,0,0,0,220,0.353130016051364,2898,8.59213250517598
"2814",2024,"Mayville St",1,0,0,14,53,33,26,0,27,0,28,22,50,25,31,71,16,55,0,0,0,8,0.571428571428571,148,16.8918918918919
"2815",2024,"North Dakota State",5,0,0,517,831,482,332,0,654,0,388,287,675,243,523,1349,511,838,0,0,0,183,0.353965183752418,2886,8.41995841995842
"2816",2024,"Pepperdine",2,0,0,356,643,268,165,0,485,1,295,263,558,199,568,968,285,683,0,0,0,109,0.306179775280899,2223,8.95186684660369
"2817",2024,"Sacramento State",9,0,0,338,726,304,192,0,492,5,300,350,650,207,540,1017,331,686,0,0,0,105,0.310650887573964,2307,8.97269180754226
"2818",2024,"St. Edward's",1,0,0,16,25,19,12,0,19,0,3,7,10,11,19,40,12,28,0,0,0,7,0.4375,81,13.5802469135802
"2819",2024,"St. Francis (PA)",5,0,0,357,688,276,171,0,510,1,264,256,520,185,503,1135,314,821,0,0,0,97,0.271708683473389,2183,8.47457627118644
"2820",2024,"Stonehill",4,0,0,368,705,281,176,0,433,0,256,260,516,130,577,1146,311,835,0,0,0,111,0.301630434782609,2279,5.70425625274243
"2821",2024,"Tennessee Southern",1,0,0,36,47,26,16,0,49,0,21,16,37,19,59,86,26,60,0,0,0,12,0.333333333333333,196,9.69387755102041
"2822",2024,"Wheeling",1,0,0,16,25,10,7,0,22,0,14,13,27,4,18,25,4,21,0,0,0,3,0.1875,80,5
"2823",2004,"Arizona",NA,NA,NA,8,23,17,10,0,16,0,0,0,0,0,0,39,15,24,13,5,8,0,0,52,0
"2824",2004,"Auburn",NA,NA,NA,18,47,20,11,0,19,0,16,3,19,0,0,56,19,37,32,14,18,5,0.277777777777778,119,0
"2825",2004,"Austin Peay",NA,NA,NA,6,29,8,5,0,14,0,0,0,0,0,0,29,13,16,24,11,13,1,0.166666666666667,60,0
"2826",2004,"Baylor",NA,NA,NA,30,93,49,34,0,46,0,10,10,20,0,0,119,52,67,36,19,17,7,0.233333333333333,220,0
"2827",2004,"Boston College",NA,NA,NA,26,87,30,20,0,50,0,20,10,30,0,0,93,35,58,37,14,23,8,0.307692307692308,193,0
"2828",2004,"Chattanooga",NA,NA,NA,28,50,33,22,0,16,0,5,12,17,0,0,68,26,42,35,7,28,5,0.178571428571429,124,0
"2829",2004,"Clemson",NA,NA,NA,17,24,22,11,0,15,0,3,2,5,0,0,36,10,26,8,2,6,4,0.235294117647059,62,0
"2830",2004,"Colgate",NA,NA,NA,14,28,11,8,0,13,0,0,0,0,0,0,62,18,44,9,1,8,2,0.142857142857143,67,0
"2831",2004,"Colorado",NA,NA,NA,7,32,22,14,0,24,0,6,5,11,0,0,23,4,19,9,2,7,1,0.142857142857143,58,0
"2832",2004,"DePaul",NA,NA,NA,17,51,25,17,0,31,0,14,13,27,0,0,56,29,27,39,10,29,5,0.294117647058824,130,0
"2833",2004,"Duke",NA,NA,NA,60,157,81,56,0,92,0,47,18,65,0,0,155,71,84,94,33,61,24,0.4,399,0
"2834",2004,"Eastern Michigan",NA,NA,NA,12,31,7,5,0,13,0,12,1,13,0,0,28,3,25,19,6,13,2,0.166666666666667,66,0
"2835",2004,"Florida",NA,NA,NA,19,51,40,26,0,28,0,0,0,0,0,0,80,35,45,30,14,16,5,0.263157894736842,127,0
"2836",2004,"George Washington",NA,NA,NA,9,24,11,8,0,15,0,7,2,9,0,0,32,9,23,11,1,10,2,0.222222222222222,53,0
"2837",2004,"Georgia",NA,NA,NA,43,126,48,32,0,62,0,13,5,18,0,0,184,82,102,51,18,33,11,0.255813953488372,301,0
"2838",2004,"Green Bay",NA,NA,NA,9,34,7,4,0,10,0,7,3,10,0,0,32,7,25,21,5,16,2,0.222222222222222,65,0
"2839",2004,"Hampton",NA,NA,NA,11,13,8,6,0,17,0,0,0,0,0,0,42,16,26,10,1,9,3,0.272727272727273,45,0
"2840",2004,"Houston",NA,NA,NA,15,69,22,13,0,30,0,12,2,14,0,0,68,22,46,38,9,29,3,0.2,133,0
"2841",2004,"Iowa",NA,NA,NA,12,18,11,9,0,15,0,2,2,4,0,0,42,17,25,15,7,8,4,0.333333333333333,59,0
"2842",2004,"Kansas State",NA,NA,NA,13,48,31,22,0,39,0,17,12,29,0,0,41,19,22,29,9,20,4,0.307692307692308,117,0
"2843",2004,"LSU",NA,NA,NA,44,147,59,39,0,69,0,34,21,55,0,0,217,94,123,27,9,18,14,0.318181818181818,349,0
"2844",2004,"Liberty",NA,NA,NA,22,24,11,5,0,12,0,11,8,19,0,0,30,6,24,15,4,11,5,0.227272727272727,70,0
"2845",2004,"Lipscomb",NA,NA,NA,9,30,9,6,0,18,0,4,6,10,0,0,27,8,19,17,4,13,3,0.333333333333333,61,0
"2846",2004,"Louisiana Tech",NA,NA,NA,39,98,40,28,0,52,0,5,1,6,0,0,152,57,95,29,13,16,9,0.230769230769231,221,0
"2847",2004,"Loyola Marymount",NA,NA,NA,6,35,14,8,0,17,0,0,0,0,0,0,32,11,21,23,9,14,3,0.5,66,0
"2848",2004,"Maine",NA,NA,NA,10,28,14,8,0,20,0,0,0,0,0,0,48,17,31,7,2,5,3,0.3,63,0
"2849",2004,"Marist",NA,NA,NA,13,17,9,6,0,18,0,6,4,10,0,0,29,6,23,20,4,16,2,0.153846153846154,49,0
"2850",2004,"Marquette",NA,NA,NA,18,46,29,18,0,34,0,29,14,43,0,0,49,12,37,30,8,22,6,0.333333333333333,118,0
"2851",2004,"Maryland",NA,NA,NA,14,54,34,23,0,30,0,8,12,20,0,0,62,35,27,25,8,17,2,0.142857142857143,131,0
"2852",2004,"Miami",NA,NA,NA,15,25,18,10,0,22,0,0,0,0,0,0,53,27,26,13,6,7,5,0.333333333333333,76,0
"2853",2004,"Michigan State",NA,NA,NA,21,53,23,15,0,36,0,0,0,0,0,0,84,41,43,32,9,23,7,0.333333333333333,128,0
"2854",2004,"Middle Tennessee",NA,NA,NA,19,44,18,13,0,21,0,1,0,1,0,0,78,34,44,34,7,27,3,0.157894736842105,108,0
"2855",2004,"Minnesota",NA,NA,NA,42,131,93,66,0,85,0,19,11,30,0,0,153,75,78,76,33,43,13,0.30952380952381,327,0
"2856",2004,"Missouri",NA,NA,NA,1,0,4,4,0,1,0,10,0,10,0,0,6,5,1,2,2,0,0,0,21,0
"2857",2004,"Missouri State",NA,NA,NA,4,35,10,8,0,19,0,0,0,0,0,0,36,15,21,21,6,15,1,0.25,62,0
"2858",2004,"Montana",NA,NA,NA,10,29,21,12,0,21,0,2,0,2,0,0,49,17,32,12,7,5,2,0.2,69,0
"2859",2004,"NC State",NA,NA,NA,4,20,7,5,0,13,0,7,5,12,0,0,18,5,13,19,9,10,0,0,49,0
"2860",2004,"New Mexico",NA,NA,NA,9,29,15,10,0,16,0,0,0,0,0,0,35,13,22,21,5,16,2,0.222222222222222,60,0
"2861",2004,"North Carolina",NA,NA,NA,17,29,6,5,0,16,0,0,2,2,0,0,58,27,31,13,0,13,7,0.411764705882353,78,0
"2862",2004,"Northwestern State",NA,NA,NA,10,25,15,10,0,16,0,5,7,12,0,0,41,9,32,7,3,4,2,0.2,59,0
"2863",2004,"Notre Dame",NA,NA,NA,31,91,29,19,0,46,0,0,0,0,0,0,130,59,71,40,10,30,11,0.354838709677419,199,0
"2864",2004,"Ohio State",NA,NA,NA,18,54,31,17,0,26,0,18,10,28,0,0,56,23,33,21,5,16,6,0.333333333333333,124,0
"2865",2004,"Oklahoma",NA,NA,NA,14,55,26,19,0,36,0,18,12,30,0,0,29,9,20,27,5,22,2,0.142857142857143,108,0
"2866",2004,"Old Dominion",NA,NA,NA,11,28,17,11,0,14,0,7,2,9,0,0,36,15,21,7,2,5,5,0.454545454545455,70,0
"2867",2004,"Ole Miss",NA,NA,NA,3,25,8,5,0,17,0,3,0,3,0,0,41,17,24,10,5,5,1,0.333333333333333,54,0
"2868",2004,"Penn State",NA,NA,NA,35,102,45,36,0,56,0,6,4,10,0,0,130,58,72,72,20,52,6,0.171428571428571,235,0
"2869",2004,"Pennsylvania",NA,NA,NA,10,23,6,4,0,20,0,2,3,5,0,0,40,12,28,17,7,10,4,0.4,55,0
"2870",2004,"Purdue",NA,NA,NA,20,89,43,26,0,49,0,18,8,26,0,0,116,50,66,22,11,11,8,0.4,206,0
"2871",2004,"Rutgers",NA,NA,NA,10,28,5,4,0,21,0,0,0,0,0,0,52,23,29,11,6,5,4,0.4,69,0
"2872",2004,"Southern",NA,NA,NA,8,21,5,4,0,20,0,0,0,0,0,0,42,16,26,11,6,5,3,0.375,51,0
"2873",2004,"St. Francis (PA)",NA,NA,NA,10,26,9,5,0,16,0,11,1,12,0,0,32,10,22,15,3,12,5,0.5,62,0
"2874",2004,"Stanford",NA,NA,NA,24,84,30,22,0,43,0,26,11,37,0,0,75,40,35,66,29,37,7,0.291666666666667,214,0
"2875",2004,"TCU",NA,NA,NA,19,62,30,21,0,33,0,18,6,24,0,0,56,24,32,33,7,26,7,0.368421052631579,139,0
"2876",2004,"Temple",NA,NA,NA,16,28,13,8,0,21,0,10,11,21,0,0,37,11,26,10,1,9,4,0.25,70,0
"2877",2004,"Tennessee",NA,NA,NA,82,186,66,44,0,88,0,42,38,80,0,0,209,88,121,73,24,49,24,0.292682926829268,445,0
"2878",2004,"Texas",NA,NA,NA,25,90,56,34,0,33,0,1,0,1,0,0,115,57,58,40,21,19,9,0.36,210,0
"2879",2004,"Texas Tech",NA,NA,NA,24,53,32,23,0,30,0,0,0,0,0,0,94,40,54,20,4,16,8,0.333333333333333,131,0
"2880",2004,"UC Santa Barbara",NA,NA,NA,19,88,44,31,0,55,0,16,7,23,0,0,84,31,53,46,15,31,4,0.210526315789474,182,0
"2881",2004,"UCLA",NA,NA,NA,6,25,18,12,0,24,0,0,0,0,0,0,40,23,17,18,5,13,3,0.5,63,0
"2882",2004,"UConn",NA,NA,NA,50,171,83,56,0,68,0,43,11,54,0,0,144,66,78,111,43,68,13,0.26,399,0
"2883",2004,"Valparaiso",NA,NA,NA,8,24,17,13,0,17,0,1,0,1,0,0,35,10,25,16,7,9,0,0,54,0
"2884",2004,"Vanderbilt",NA,NA,NA,27,92,33,19,0,36,0,35,20,55,0,0,74,30,44,40,10,30,5,0.185185185185185,205,0
"2885",2004,"Villanova",NA,NA,NA,13,46,18,11,0,21,0,9,1,10,0,0,53,19,34,36,12,24,3,0.230769230769231,106,0
"2886",2004,"Virginia Tech",NA,NA,NA,11,57,21,13,0,27,0,3,0,3,0,0,86,40,46,14,11,3,2,0.181818181818182,129,0
"2887",2004,"West Virginia",NA,NA,NA,10,28,10,7,0,22,0,4,0,4,0,0,31,9,22,25,10,15,2,0.2,64,0
"2888",2005,"Alcorn State",NA,NA,NA,9,23,11,5,0,8,0,4,8,12,0,0,37,8,29,11,3,8,2,0.222222222222222,48,0
"2889",2005,"Arizona",NA,NA,NA,24,57,28,17,0,26,0,17,25,42,0,0,53,13,40,28,10,18,8,0.333333333333333,126,0
"2890",2005,"Arizona State",NA,NA,NA,47,98,41,27,0,80,0,41,39,80,0,0,107,45,62,54,19,35,12,0.25531914893617,263,0
"2891",2005,"Arkansas",NA,NA,NA,9,16,12,9,0,23,0,5,11,16,0,0,25,4,21,21,10,11,0,0,46,0
"2892",2005,"Auburn",NA,NA,NA,6,35,11,7,0,21,0,4,6,10,0,0,36,11,25,10,4,6,2,0.333333333333333,61,0
"2893",2005,"Baylor",NA,NA,NA,88,234,136,83,0,114,0,99,49,148,0,0,215,79,136,92,33,59,30,0.340909090909091,572,0
"2894",2005,"Boston College",NA,NA,NA,34,154,47,30,0,74,0,36,32,68,0,0,121,44,77,63,24,39,8,0.235294117647059,306,0
"2895",2005,"Bowling Green",NA,NA,NA,12,33,17,9,0,14,0,9,11,20,0,0,31,8,23,20,5,15,4,0.333333333333333,74,0
"2896",2005,"Canisius",NA,NA,NA,9,21,13,7,0,18,0,7,15,22,0,0,15,4,11,24,5,19,5,0.555555555555556,48,0
"2897",2005,"Coppin State",NA,NA,NA,7,21,16,10,0,16,0,15,11,26,0,0,21,5,16,10,3,7,1,0.142857142857143,58,0
"2898",2005,"Dartmouth",NA,NA,NA,6,23,8,6,0,9,0,4,5,9,0,0,30,6,24,13,6,7,1,0.166666666666667,48,0
"2899",2005,"DePaul",NA,NA,NA,54,82,46,29,0,53,0,44,27,71,0,0,74,20,54,65,24,41,20,0.37037037037037,240,0
"2900",2005,"Duke",NA,NA,NA,117,341,156,104,0,185,0,135,95,230,0,0,252,76,176,141,46,95,36,0.307692307692308,755,0
"2901",2005,"Eastern Kentucky",NA,NA,NA,6,21,14,11,0,18,0,10,10,20,0,0,21,5,16,7,6,1,0,0,52,0
"2902",2005,"Florida",NA,NA,NA,12,21,15,11,0,18,0,6,10,16,0,0,17,5,12,14,5,9,2,0.166666666666667,55,0
"2903",2005,"Florida State",NA,NA,NA,25,67,30,22,0,42,0,36,22,58,0,0,60,26,34,44,17,27,8,0.32,184,0
"2904",2005,"George Washington",NA,NA,NA,22,53,35,18,0,35,0,22,21,43,0,0,51,12,39,23,4,19,4,0.181818181818182,120,0
"2905",2005,"Georgia",NA,NA,NA,58,172,76,51,0,110,0,47,42,89,0,0,148,60,88,108,33,75,15,0.258620689655172,387,0
"2906",2005,"Georgia Tech",NA,NA,NA,16,25,18,12,0,19,0,5,16,21,0,0,19,7,12,15,3,12,2,0.125,59,0
"2907",2005,"Green Bay",NA,NA,NA,8,32,13,7,0,21,0,12,13,25,0,0,26,9,17,11,1,10,2,0.25,64,0
"2908",2005,"Hartford",NA,NA,NA,4,23,15,10,0,12,0,6,4,10,0,0,21,4,17,9,0,9,1,0.25,39,0
"2909",2005,"Holy Cross",NA,NA,NA,7,27,15,8,0,16,0,4,12,16,0,0,24,8,16,14,4,10,1,0.142857142857143,55,0
"2910",2005,"Houston",NA,NA,NA,15,22,11,8,0,15,0,5,9,14,0,0,37,7,30,15,2,13,3,0.2,52,0
"2911",2005,"Illinois State",NA,NA,NA,7,24,12,10,0,20,0,7,4,11,0,0,23,10,13,24,6,18,2,0.285714285714286,57,0
"2912",2005,"Iowa State",NA,NA,NA,5,30,3,2,0,17,0,8,5,13,0,0,21,9,12,20,8,12,3,0.6,62,0
"2913",2005,"Kansas State",NA,NA,NA,40,153,43,32,0,85,0,35,17,52,0,0,124,52,72,91,30,61,12,0.3,323,0
"2914",2005,"Kentucky",NA,NA,NA,8,24,15,10,0,15,0,11,4,15,0,0,27,8,19,7,2,5,5,0.625,57,0
"2915",2005,"LSU",NA,NA,NA,130,359,171,114,0,166,0,161,93,254,0,0,341,130,211,104,38,66,32,0.246153846153846,871,0
"2916",2005,"Liberty",NA,NA,NA,34,88,47,34,0,42,0,34,21,55,0,0,75,30,45,32,11,21,11,0.323529411764706,207,0
"2917",2005,"Louisiana Tech",NA,NA,NA,13,25,10,6,0,16,0,13,12,25,0,0,26,9,17,10,3,7,2,0.153846153846154,67,0
"2918",2005,"Louisville",NA,NA,NA,4,31,4,2,0,11,0,7,7,14,0,0,19,4,15,20,8,12,2,0.5,55,0
"2919",2005,"Maryland",NA,NA,NA,41,117,46,26,0,68,0,40,35,75,0,0,124,36,88,47,12,35,13,0.317073170731707,257,0
"2920",2005,"Michigan State",NA,NA,NA,74,257,98,69,0,109,0,114,66,180,0,0,209,73,136,127,47,80,31,0.418918918918919,599,0
"2921",2005,"Middle Tennessee",NA,NA,NA,19,32,18,12,0,32,0,27,12,39,0,0,49,15,34,24,9,15,6,0.31578947368421,106,0
"2922",2005,"Minnesota",NA,NA,NA,60,228,100,73,0,123,0,71,58,129,0,0,185,72,113,91,35,56,18,0.3,501,0
"2923",2005,"Montana",NA,NA,NA,4,25,3,2,0,9,0,6,7,13,0,0,19,8,11,12,4,8,1,0.25,48,0
"2924",2005,"NC State",NA,NA,NA,24,58,20,11,0,35,0,22,23,45,0,0,41,19,22,33,11,22,8,0.333333333333333,140,0
"2925",2005,"New Mexico",NA,NA,NA,10,26,1,1,0,16,0,10,8,18,0,0,28,8,20,20,6,14,3,0.3,60,0
"2926",2005,"North Carolina",NA,NA,NA,121,304,161,105,0,175,0,122,103,225,0,0,193,62,131,156,52,104,35,0.289256198347107,700,0
"2927",2005,"Notre Dame",NA,NA,NA,53,188,110,76,0,102,0,81,62,143,0,0,156,49,107,50,23,27,16,0.30188679245283,421,0
"2928",2005,"Ohio State",NA,NA,NA,46,167,71,45,0,78,0,73,34,107,0,0,143,60,83,79,27,52,9,0.195652173913043,394,0
"2929",2005,"Oklahoma",NA,NA,NA,14,55,26,18,0,28,0,18,16,34,0,0,38,15,23,37,17,20,4,0.285714285714286,129,0
"2930",2005,"Old Dominion",NA,NA,NA,17,22,10,5,0,21,0,12,8,20,0,0,49,13,36,3,0,3,5,0.294117647058824,65,0
"2931",2005,"Ole Miss",NA,NA,NA,11,31,5,3,0,19,0,11,9,20,0,0,13,7,6,19,5,14,3,0.272727272727273,66,0
"2932",2005,"Oral Roberts",NA,NA,NA,10,19,8,5,0,15,0,8,6,14,0,0,23,8,15,7,3,4,3,0.3,50,0
"2933",2005,"Oregon",NA,NA,NA,13,66,32,18,0,35,0,18,18,36,0,0,27,8,19,30,8,22,1,0.0769230769230769,120,0
"2934",2005,"Penn State",NA,NA,NA,23,61,43,34,0,70,0,23,8,31,0,0,75,36,39,50,18,32,6,0.260869565217391,173,0
"2935",2005,"Pittsburgh",NA,NA,NA,14,42,18,12,0,34,0,17,18,35,0,0,45,12,33,29,9,20,5,0.357142857142857,99,0
"2936",2005,"Providence",NA,NA,NA,10,18,3,2,0,16,0,1,5,6,0,0,30,5,25,14,3,11,0,0,37,0
"2937",2005,"Purdue",NA,NA,NA,30,102,46,36,0,57,0,41,21,62,0,0,92,28,64,51,15,36,12,0.4,235,0
"2938",2005,"Rice",NA,NA,NA,12,28,12,5,0,15,0,14,10,24,0,0,21,3,18,10,3,7,1,0.0833333333333333,62,0
"2939",2005,"Richmond",NA,NA,NA,5,16,10,7,0,12,0,5,6,11,0,0,16,6,10,16,7,9,1,0.2,43,0
"2940",2005,"Rutgers",NA,NA,NA,78,210,115,80,0,166,0,74,61,135,0,0,232,91,141,99,23,76,20,0.256410256410256,508,0
"2941",2005,"Santa Clara",NA,NA,NA,7,23,15,9,0,24,0,6,15,21,0,0,18,4,14,19,9,10,0,0,57,0
"2942",2005,"South Carolina",NA,NA,NA,6,26,7,4,0,16,0,7,5,12,0,0,26,9,17,8,2,6,1,0.166666666666667,51,0
"2943",2005,"St. Francis (PA)",NA,NA,NA,4,21,11,7,0,11,0,7,2,9,0,0,24,2,22,10,2,8,1,0.25,39,0
"2944",2005,"Stanford",NA,NA,NA,57,213,92,70,0,95,0,94,54,148,0,0,116,42,74,129,50,79,16,0.280701754385965,483,0
"2945",2005,"Stetson",NA,NA,NA,3,30,8,5,0,18,0,6,2,8,0,0,26,6,20,14,2,12,2,0.666666666666667,49,0
"2946",2005,"Syracuse",NA,NA,NA,5,28,2,1,0,8,0,4,3,7,0,0,35,8,27,21,8,13,2,0.4,53,0
"2947",2005,"TCU",NA,NA,NA,18,61,29,16,0,40,0,33,25,58,0,0,41,13,28,28,7,21,6,0.333333333333333,139,0
"2948",2005,"Temple",NA,NA,NA,13,48,31,21,0,33,0,19,18,37,0,0,40,13,27,20,8,12,5,0.384615384615385,109,0
"2949",2005,"Tennessee",NA,NA,NA,152,316,158,98,0,179,0,117,95,212,0,0,319,121,198,141,53,88,41,0.269736842105263,803,0
"2950",2005,"Texas",NA,NA,NA,52,103,54,37,0,52,0,36,30,66,0,0,121,40,81,50,17,33,12,0.230769230769231,258,0
"2951",2005,"Texas Tech",NA,NA,NA,60,138,67,39,0,78,0,61,42,103,0,0,123,43,80,50,11,39,19,0.316666666666667,333,0
"2952",2005,"UC Santa Barbara",NA,NA,NA,10,25,10,8,0,18,0,7,2,9,0,0,28,7,21,17,3,14,1,0.1,54,0
"2953",2005,"UCLA",NA,NA,NA,11,35,22,15,0,24,0,13,11,24,0,0,25,8,17,16,2,14,2,0.181818181818182,75,0
"2954",2005,"UConn",NA,NA,NA,169,476,190,128,0,217,0,194,112,306,0,0,318,108,210,252,92,160,55,0.325443786982249,1097,0
"2955",2005,"USC",NA,NA,NA,40,75,12,10,0,42,0,27,18,45,0,0,95,37,58,56,16,40,14,0.35,199,0
"2956",2005,"UT Arlington",NA,NA,NA,12,19,7,5,0,15,0,9,9,18,0,0,28,9,19,14,2,12,4,0.333333333333333,53,0
"2957",2005,"Utah",NA,NA,NA,12,51,23,12,0,26,0,17,14,31,0,0,41,23,18,43,12,31,4,0.333333333333333,119,0
"2958",2005,"Vanderbilt",NA,NA,NA,31,152,52,34,0,81,0,75,41,116,0,0,115,37,78,97,40,57,11,0.354838709677419,350,0
"2959",2005,"Villanova",NA,NA,NA,0,17,3,2,0,15,0,6,2,8,0,0,16,6,10,13,10,3,0,NA,39,0
"2960",2005,"Virginia",NA,NA,NA,19,98,39,27,0,58,0,32,21,53,0,0,61,24,37,37,16,21,2,0.105263157894737,203,0
"2961",2005,"Virginia Tech",NA,NA,NA,10,23,20,14,0,19,0,17,7,24,0,0,33,10,23,6,1,5,6,0.6,67,0
"2962",2005,"West Virginia",NA,NA,NA,10,20,13,8,0,17,0,3,6,9,0,0,21,5,16,20,5,15,2,0.2,48,0
"2963",2005,"Western Carolina",NA,NA,NA,13,21,13,7,0,19,0,5,6,11,0,0,30,9,21,15,2,13,3,0.230769230769231,54,0
"2964",2006,"Air Force",NA,NA,NA,4,21,5,5,0,8,0,6,6,12,0,0,20,11,9,7,1,6,0,0,43,0
"2965",2006,"Alabama",NA,NA,NA,27,74,42,23,0,48,0,42,22,64,0,0,40,10,30,43,14,29,7,0.259259259259259,174,0
"2966",2006,"Alabama State",NA,NA,NA,9,26,13,8,0,26,0,12,9,21,0,0,22,5,17,8,4,4,2,0.222222222222222,60,0
"2967",2006,"Albany",NA,NA,NA,14,28,7,5,0,20,0,1,3,4,0,0,35,10,25,19,5,14,4,0.285714285714286,61,0
"2968",2006,"Arizona State",NA,NA,NA,35,123,41,29,0,64,0,63,38,101,0,0,92,27,65,40,13,27,14,0.4,273,0
"2969",2006,"Arkansas",NA,NA,NA,4,23,3,2,0,23,0,1,7,8,0,0,22,7,15,22,6,16,1,0.25,42,0
"2970",2006,"Arkansas State",NA,NA,NA,12,22,11,7,0,18,0,15,9,24,0,0,17,5,12,16,5,11,6,0.5,62,0
"2971",2006,"Army",NA,NA,NA,24,67,24,15,0,42,0,24,16,40,0,0,78,33,45,39,11,28,7,0.291666666666667,164,0
"2972",2006,"Auburn",NA,NA,NA,14,67,34,21,0,38,0,24,19,43,0,0,70,23,47,32,5,27,5,0.357142857142857,143,0
"2973",2006,"BYU",NA,NA,NA,41,94,34,19,0,71,0,42,38,80,0,0,60,26,34,93,32,61,11,0.268292682926829,241,0
"2974",2006,"Baylor",NA,NA,NA,171,397,184,119,0,236,0,150,121,271,0,0,424,153,271,189,56,133,49,0.286549707602339,982,0
"2975",2006,"Boston College",NA,NA,NA,73,270,120,86,0,153,0,99,83,182,0,0,183,75,108,94,32,62,21,0.287671232876712,581,0
"2976",2006,"Boston University",NA,NA,NA,11,25,10,8,0,15,0,6,3,9,0,0,39,12,27,13,3,10,6,0.545454545454545,61,0
"2977",2006,"Bowling Green",NA,NA,NA,21,96,44,28,0,31,0,35,25,60,0,0,49,20,29,46,14,32,2,0.0952380952380952,197,0
"2978",2006,"California",NA,NA,NA,19,51,25,17,0,35,0,34,16,50,0,0,45,14,31,16,8,8,11,0.578947368421053,134,0
"2979",2006,"Chattanooga",NA,NA,NA,16,52,25,16,0,32,0,18,14,32,0,0,32,16,16,51,18,33,6,0.375,126,0
"2980",2006,"Cincinnati",NA,NA,NA,9,28,17,9,0,16,0,11,14,25,0,0,26,8,18,12,7,5,4,0.444444444444444,68,0
"2981",2006,"Clemson",NA,NA,NA,6,26,13,7,0,17,0,12,3,15,0,0,23,5,18,18,6,12,3,0.5,56,0
"2982",2006,"Cleveland State",NA,NA,NA,8,14,8,4,0,19,0,4,8,12,0,0,18,8,10,22,7,15,2,0.25,42,0
"2983",2006,"Coppin State",NA,NA,NA,17,53,18,11,0,37,0,14,13,27,0,0,56,20,36,17,5,12,6,0.352941176470588,113,0
"2984",2006,"Dartmouth",NA,NA,NA,5,30,5,4,0,13,0,8,11,19,0,0,14,5,9,23,9,14,0,0,60,0
"2985",2006,"DePaul",NA,NA,NA,111,298,91,59,0,185,0,117,89,206,0,0,186,68,118,224,72,152,28,0.252252252252252,692,0
"2986",2006,"Delaware State",NA,NA,NA,9,25,14,7,0,9,0,9,14,23,0,0,18,3,15,5,0,5,1,0.111111111111111,48,0
"2987",2006,"Duke",NA,NA,NA,140,399,191,127,0,191,0,178,119,297,0,0,279,113,166,174,55,119,43,0.307142857142857,932,0
"2988",2006,"Eastern Michigan",NA,NA,NA,5,24,4,3,0,17,0,9,9,18,0,0,21,8,13,16,6,10,3,0.6,54,0
"2989",2006,"Florida",NA,NA,NA,26,46,21,12,0,38,0,23,19,42,0,0,45,14,31,45,12,33,7,0.269230769230769,124,0
"2990",2006,"Florida Atlantic",NA,NA,NA,21,72,34,20,0,40,0,16,26,42,0,0,40,8,32,29,14,15,4,0.19047619047619,136,0
"2991",2006,"Florida International",NA,NA,NA,14,30,14,9,0,23,0,10,5,15,0,0,31,11,20,10,1,9,3,0.214285714285714,69,0
"2992",2006,"Florida State",NA,NA,NA,39,119,75,48,0,69,0,44,42,86,0,0,117,42,75,51,12,39,13,0.333333333333333,279,0
"2993",2006,"Gardner-Webb",NA,NA,NA,14,28,23,15,0,20,0,6,12,18,0,0,22,7,15,17,5,12,6,0.428571428571429,67,0
"2994",2006,"George Washington",NA,NA,NA,27,85,37,23,0,57,0,42,25,67,0,0,80,28,52,28,7,21,8,0.296296296296296,200,0
"2995",2006,"Georgia",NA,NA,NA,129,342,130,93,0,194,0,130,89,219,0,0,273,107,166,241,87,154,47,0.364341085271318,836,0
"2996",2006,"Georgia Tech",NA,NA,NA,18,57,25,17,0,39,0,20,22,42,0,0,49,17,32,31,11,20,6,0.333333333333333,130,0
"2997",2006,"Gonzaga",NA,NA,NA,11,24,8,4,0,24,0,7,3,10,0,0,38,9,29,12,5,7,3,0.272727272727273,59,0
"2998",2006,"Hartford",NA,NA,NA,37,112,40,21,0,47,0,44,40,84,0,0,94,35,59,57,17,40,17,0.45945945945946,255,0
"2999",2006,"Hofstra",NA,NA,NA,8,35,22,12,0,18,0,4,9,13,0,0,18,4,14,18,6,12,0,0,62,0
"3000",2006,"Holy Cross",NA,NA,NA,8,20,4,3,0,15,0,10,15,25,0,0,17,11,6,17,7,10,2,0.25,56,0
"3001",2006,"Illinois",NA,NA,NA,12,28,8,6,0,13,0,10,6,16,0,0,23,8,15,13,4,9,3,0.25,66,0
"3002",2006,"Indiana",NA,NA,NA,21,86,36,20,0,51,0,25,43,68,0,0,52,18,34,34,16,18,6,0.285714285714286,178,0
"3003",2006,"Indiana State",NA,NA,NA,18,45,20,14,0,43,0,14,10,24,0,0,58,14,44,30,6,24,6,0.333333333333333,100,0
"3004",2006,"Iowa",NA,NA,NA,22,74,42,28,0,40,0,21,17,38,0,0,67,30,37,55,16,39,6,0.272727272727273,176,0
"3005",2006,"Iowa State",NA,NA,NA,8,28,5,5,0,16,0,7,5,12,0,0,33,14,19,23,8,15,4,0.5,66,0
"3006",2006,"James Madison",NA,NA,NA,9,29,17,13,0,15,0,12,16,28,0,0,18,4,14,11,0,11,3,0.333333333333333,60,0
"3007",2006,"Kansas",NA,NA,NA,18,42,24,14,0,29,0,13,13,26,0,0,49,17,32,28,10,18,4,0.222222222222222,104,0
"3008",2006,"Kansas State",NA,NA,NA,8,36,10,7,0,22,0,11,10,21,0,0,24,7,17,28,9,19,4,0.5,75,0
"3009",2006,"Kent State",NA,NA,NA,13,47,14,13,0,27,0,20,17,37,0,0,46,14,32,19,5,14,3,0.230769230769231,102,0
"3010",2006,"Kentucky",NA,NA,NA,26,88,44,30,0,50,0,37,24,61,0,0,59,22,37,39,11,28,8,0.307692307692308,197,0
"3011",2006,"LSU",NA,NA,NA,188,599,266,162,0,216,0,273,148,421,0,0,498,174,324,136,41,95,66,0.351063829787234,1344,0
"3012",2006,"La Salle",NA,NA,NA,9,31,15,11,0,12,0,12,14,26,0,0,24,10,14,6,2,4,2,0.222222222222222,71,0
"3013",2006,"Liberty",NA,NA,NA,10,21,10,7,0,20,0,10,11,21,0,0,20,3,17,13,3,10,0,0,53,0
"3014",2006,"Louisiana Tech",NA,NA,NA,31,110,52,32,0,62,0,25,20,45,0,0,99,29,70,31,12,19,4,0.129032258064516,220,0
"3015",2006,"Louisville",NA,NA,NA,31,80,23,15,0,47,0,29,22,51,0,0,52,16,36,69,21,48,7,0.225806451612903,187,0
"3016",2006,"Loyola Maryland",NA,NA,NA,6,30,12,9,0,24,0,6,12,18,0,0,28,10,18,10,4,6,1,0.166666666666667,61,0
"3017",2006,"Marist",NA,NA,NA,17,65,32,21,0,33,0,12,21,33,0,0,34,8,26,44,19,25,4,0.235294117647059,129,0
"3018",2006,"Marquette",NA,NA,NA,4,25,7,4,0,19,0,9,5,14,0,0,23,7,16,21,7,14,2,0.5,53,0
"3019",2006,"Maryland",NA,NA,NA,159,471,235,155,0,239,0,208,120,328,0,0,300,108,192,209,79,130,42,0.264150943396226,1087,0
"3020",2006,"Miami",NA,NA,NA,17,56,25,14,0,42,0,18,19,37,0,0,38,13,25,43,11,32,5,0.294117647058824,122,0
"3021",2006,"Michigan",NA,NA,NA,21,103,26,18,0,53,0,28,26,54,0,0,73,24,49,69,23,46,8,0.380952380952381,205,0
"3022",2006,"Michigan State",NA,NA,NA,204,486,167,112,0,251,0,215,164,379,0,0,423,142,281,249,84,165,61,0.299019607843137,1183,0
"3023",2006,"Middle Tennessee",NA,NA,NA,25,73,38,26,0,50,0,32,10,42,0,0,79,35,44,53,23,30,8,0.32,200,0
"3024",2006,"Milwaukee",NA,NA,NA,14,51,26,16,0,25,0,17,9,26,0,0,38,17,21,26,8,18,2,0.142857142857143,111,0
"3025",2006,"Minnesota",NA,NA,NA,99,241,90,54,0,158,0,84,87,171,0,0,187,59,128,151,51,100,28,0.282828282828283,560,0
"3026",2006,"Mississippi State",NA,NA,NA,45,116,48,26,0,63,0,29,33,62,0,0,96,29,67,65,20,45,12,0.266666666666667,250,0
"3027",2006,"Missouri",NA,NA,NA,20,46,26,18,0,30,0,27,27,54,0,0,31,9,22,22,10,12,6,0.3,114,0
"3028",2006,"Missouri State",NA,NA,NA,29,92,44,34,0,62,0,28,29,57,0,0,86,32,54,66,18,48,5,0.172413793103448,208,0
"3029",2006,"NC State",NA,NA,NA,32,77,39,24,0,58,0,35,28,63,0,0,79,33,46,44,13,31,9,0.28125,203,0
"3030",2006,"Nebraska",NA,NA,NA,14,50,22,13,0,32,0,11,21,32,0,0,58,25,33,28,6,22,2,0.142857142857143,111,0
"3031",2006,"New Mexico",NA,NA,NA,42,145,64,48,0,82,0,43,22,65,0,0,113,42,71,91,31,60,12,0.285714285714286,321,0
"3032",2006,"New Mexico State",NA,NA,NA,13,30,16,7,0,18,0,1,11,12,0,0,20,7,13,28,5,23,0,0,56,0
"3033",2006,"North Carolina",NA,NA,NA,195,469,242,161,0,266,0,268,185,453,0,0,258,98,160,291,99,192,51,0.261538461538462,1196,0
"3034",2006,"Northern Arizona",NA,NA,NA,8,35,19,13,0,16,0,12,12,24,0,0,25,2,23,11,2,9,2,0.25,64,0
"3035",2006,"Northern Iowa",NA,NA,NA,11,20,6,5,0,18,0,7,2,9,0,0,18,5,13,22,9,13,4,0.363636363636364,55,0
"3036",2006,"Notre Dame",NA,NA,NA,81,212,118,68,0,134,0,67,66,133,0,0,213,65,148,96,37,59,28,0.345679012345679,488,0
"3037",2006,"Oakland",NA,NA,NA,18,71,28,16,0,32,0,16,15,31,0,0,45,15,30,39,9,30,5,0.277777777777778,138,0
"3038",2006,"Ohio State",NA,NA,NA,119,402,139,86,0,179,0,206,113,319,0,0,312,107,205,206,83,123,46,0.38655462184874,959,0
"3039",2006,"Oklahoma",NA,NA,NA,152,423,208,120,0,189,0,183,113,296,0,0,209,81,128,202,59,143,48,0.31578947368421,955,0
"3040",2006,"Old Dominion",NA,NA,NA,17,59,31,18,0,41,0,21,12,33,0,0,54,22,32,28,6,22,3,0.176470588235294,132,0
"3041",2006,"Ole Miss",NA,NA,NA,24,50,21,15,0,43,0,18,20,38,0,0,66,19,47,40,11,29,6,0.25,128,0
"3042",2006,"Oregon",NA,NA,NA,11,28,6,5,0,20,0,11,5,16,0,0,18,8,10,24,5,19,3,0.272727272727273,63,0
"3043",2006,"Penn State",NA,NA,NA,18,72,31,22,0,52,0,38,19,57,0,0,49,12,37,27,10,17,9,0.5,159,0
"3044",2006,"Pepperdine",NA,NA,NA,33,84,45,33,0,53,0,24,24,48,0,0,84,24,60,52,17,35,6,0.181818181818182,191,0
"3045",2006,"Pittsburgh",NA,NA,NA,14,57,40,24,0,25,0,18,21,39,0,0,47,15,32,20,7,13,5,0.357142857142857,120,0
"3046",2006,"Purdue",NA,NA,NA,124,348,163,114,0,187,0,123,92,215,0,0,328,118,210,179,63,116,27,0.217741935483871,824,0
"3047",2006,"Quinnipiac",NA,NA,NA,7,32,15,11,0,21,0,10,9,19,0,0,18,5,13,22,6,16,4,0.571428571428571,65,0
"3048",2006,"Rice",NA,NA,NA,9,33,13,9,0,18,0,4,2,6,0,0,31,11,20,14,4,10,2,0.222222222222222,66,0
"3049",2006,"Rutgers",NA,NA,NA,88,289,113,73,0,159,0,80,76,156,0,0,286,100,186,112,44,68,27,0.306818181818182,633,0
"3050",2006,"Sacramento State",NA,NA,NA,8,23,10,5,0,21,0,11,10,21,0,0,18,5,13,16,5,11,4,0.5,53,0
"3051",2006,"Sacred Heart",NA,NA,NA,23,57,29,22,0,31,0,19,33,52,0,0,36,8,28,36,12,24,8,0.347826086956522,128,0
"3052",2006,"Saint Joseph's",NA,NA,NA,13,25,11,8,0,16,0,11,19,30,0,0,17,5,12,7,3,4,3,0.230769230769231,60,0
"3053",2006,"Sam Houston",NA,NA,NA,5,20,4,2,0,26,0,4,9,13,0,0,19,2,17,21,6,15,1,0.2,38,0
"3054",2006,"Santa Clara",NA,NA,NA,3,29,12,9,0,13,0,11,6,17,0,0,26,11,15,14,3,11,0,0,61,0
"3055",2006,"Seton Hall",NA,NA,NA,12,26,11,4,0,17,0,4,7,11,0,0,36,16,20,19,3,16,4,0.333333333333333,63,0
"3056",2006,"South Carolina",NA,NA,NA,10,20,9,6,0,19,0,8,9,17,0,0,19,8,11,15,3,12,5,0.5,53,0
"3057",2006,"South Florida",NA,NA,NA,23,77,31,20,0,48,0,20,21,41,0,0,87,28,59,42,10,32,3,0.130434782608696,167,0
"3058",2006,"Southeast Missouri State",NA,NA,NA,25,62,34,20,0,28,0,23,26,49,0,0,25,5,20,44,11,33,8,0.32,138,0
"3059",2006,"Southern",NA,NA,NA,17,48,26,19,0,36,0,19,19,38,0,0,50,8,42,18,1,17,1,0.0588235294117647,101,0
"3060",2006,"St. John's",NA,NA,NA,38,77,43,27,0,54,0,34,30,64,0,0,74,30,44,45,13,32,10,0.263157894736842,208,0
"3061",2006,"Stanford",NA,NA,NA,108,362,140,93,0,170,0,131,99,230,0,0,233,101,132,221,82,139,33,0.305555555555556,823,0
"3062",2006,"Stephen F. Austin",NA,NA,NA,7,20,7,5,0,13,0,22,19,41,0,0,15,3,12,9,1,8,2,0.285714285714286,55,0
"3063",2006,"TCU",NA,NA,NA,41,117,64,44,0,80,0,38,37,75,0,0,82,20,62,61,21,40,6,0.146341463414634,255,0
"3064",2006,"Temple",NA,NA,NA,62,160,69,43,0,87,0,60,52,112,0,0,176,73,103,39,9,30,20,0.32258064516129,387,0
"3065",2006,"Tennessee",NA,NA,NA,284,687,386,259,2,402,0,295,143,438,0,0,591,220,371,366,145,221,100,0.352112676056338,1738,0
"3066",2006,"Tennessee Tech",NA,NA,NA,7,21,9,5,0,17,0,10,3,13,0,0,24,6,18,14,4,10,4,0.571428571428571,51,0
"3067",2006,"Texas",NA,NA,NA,70,181,81,47,0,117,0,57,36,93,0,0,214,75,139,56,13,43,17,0.242857142857143,413,0
"3068",2006,"Texas A&M",NA,NA,NA,29,51,32,19,0,40,0,20,16,36,0,0,53,18,35,31,11,20,7,0.241379310344828,135,0
"3069",2006,"Texas Tech",NA,NA,NA,41,138,69,44,0,81,0,59,47,106,0,0,112,47,65,57,16,41,6,0.146341463414634,317,0
"3070",2006,"Toledo",NA,NA,NA,10,26,6,3,0,21,0,8,15,23,0,0,22,6,16,18,4,14,3,0.3,54,0
"3071",2006,"Tulane",NA,NA,NA,9,25,12,8,0,19,0,8,8,16,0,0,21,10,11,17,3,14,5,0.555555555555556,59,0
"3072",2006,"Tulsa",NA,NA,NA,30,91,40,28,0,44,0,36,36,72,0,0,73,24,49,26,10,16,6,0.2,202,0
"3073",2006,"UC Riverside",NA,NA,NA,6,57,13,6,0,23,0,18,19,37,0,0,34,12,22,35,14,21,2,0.333333333333333,110,0
"3074",2006,"UC Santa Barbara",NA,NA,NA,8,33,12,7,0,16,0,8,9,17,0,0,15,6,9,22,7,15,3,0.375,65,0
"3075",2006,"UCLA",NA,NA,NA,79,240,98,57,0,147,0,87,45,132,0,0,259,93,166,131,51,80,31,0.392405063291139,570,0
"3076",2006,"UConn",NA,NA,NA,282,843,366,232,0,463,0,399,194,593,0,0,561,216,345,492,185,307,90,0.319148936170213,2031,0
"3077",2006,"UIC",NA,NA,NA,11,27,13,7,0,19,0,11,18,29,0,0,15,9,6,18,4,14,2,0.181818181818182,65,0
"3078",2006,"UNC Greensboro",NA,NA,NA,11,25,9,7,0,24,0,13,8,21,0,0,25,10,15,23,7,16,3,0.272727272727273,69,0
"3079",2006,"UNLV",NA,NA,NA,10,26,7,5,0,11,0,11,7,18,0,0,24,10,14,7,2,5,1,0.1,61,0
"3080",2006,"USC",NA,NA,NA,66,151,60,39,0,104,0,50,57,107,0,0,129,47,82,136,32,104,11,0.166666666666667,360,0
"3081",2006,"Utah",NA,NA,NA,71,217,93,63,0,101,0,83,62,145,0,0,153,51,102,160,58,102,19,0.267605633802817,507,0
"3082",2006,"Vanderbilt",NA,NA,NA,42,142,44,33,0,94,0,81,59,140,0,0,91,42,49,96,37,59,14,0.333333333333333,358,0
"3083",2006,"Villanova",NA,NA,NA,9,18,8,6,0,16,0,5,9,14,0,0,23,11,12,19,5,14,4,0.444444444444444,49,0
"3084",2006,"Virginia",NA,NA,NA,55,155,65,42,0,117,0,58,57,115,0,0,194,66,128,74,22,52,20,0.363636363636364,375,0
"3085",2006,"Virginia Tech",NA,NA,NA,63,168,89,56,0,101,0,90,74,164,0,0,134,43,91,45,14,31,19,0.301587301587302,397,0
"3086",2006,"Wake Forest",NA,NA,NA,2,27,19,12,0,17,0,7,7,14,0,0,16,4,12,19,6,13,1,0.5,51,0
"3087",2006,"Washington",NA,NA,NA,32,97,31,17,0,60,0,34,40,74,0,0,78,27,51,31,8,23,9,0.28125,201,0
"3088",2006,"West Virginia",NA,NA,NA,12,74,36,19,0,31,0,17,20,37,0,0,31,9,22,23,6,17,2,0.166666666666667,128,0
"3089",2006,"Western Illinois",NA,NA,NA,16,28,13,9,0,17,0,6,10,16,0,0,36,12,24,17,1,16,5,0.3125,64,0
"3090",2006,"Western Kentucky",NA,NA,NA,22,50,35,21,0,42,0,28,14,42,0,0,64,20,44,16,4,12,6,0.272727272727273,133,0
"3091",2006,"Wyoming",NA,NA,NA,14,24,14,10,0,13,0,10,11,21,0,0,23,3,20,18,4,14,3,0.214285714285714,58,0
"3092",2006,"Xavier",NA,NA,NA,9,21,14,10,0,10,0,11,16,27,0,0,10,4,6,13,5,8,0,0,54,0
"3093",2007,"Air Force",NA,NA,NA,22,39,15,11,0,35,0,12,12,24,0,0,56,17,39,16,4,12,3,0.136363636363636,99,0
"3094",2007,"Akron",NA,NA,NA,27,52,28,18,0,39,0,15,12,27,6,0,52,14,38,29,7,22,7,0.259259259259259,125,4.8
"3095",2007,"Alabama",NA,NA,NA,34,65,33,24,0,61,0,23,21,44,4,0,57,22,35,47,11,36,10,0.294117647058824,165,2.42424242424242
"3096",2007,"Albany",NA,NA,NA,10,23,18,10,0,28,0,9,4,13,5,0,28,13,15,11,5,6,4,0.4,64,7.8125
"3097",2007,"American University",NA,NA,NA,8,22,6,3,0,13,0,7,7,14,0,0,21,6,15,20,6,14,2,0.25,49,0
"3098",2007,"Arizona",NA,NA,NA,72,124,74,49,0,112,0,73,50,123,23,0,133,45,88,111,29,82,15,0.208333333333333,363,6.33608815426997
"3099",2007,"Arizona State",NA,NA,NA,81,254,143,103,0,184,0,94,97,191,0,0,261,96,165,115,35,80,16,0.197530864197531,607,0
"3100",2007,"Arkansas",NA,NA,NA,28,44,18,13,0,34,0,20,17,37,7,0,71,17,54,28,6,22,8,0.285714285714286,123,5.6910569105691
"3101",2007,"Arkansas State",NA,NA,NA,9,22,8,3,0,19,0,9,9,18,0,0,18,10,8,20,6,14,2,0.222222222222222,59,0
"3102",2007,"Army",NA,NA,NA,7,17,7,5,0,11,0,4,9,13,0,0,25,9,16,14,3,11,3,0.428571428571429,44,0
"3103",2007,"Auburn",NA,NA,NA,54,113,77,53,0,78,0,61,27,88,31,0,144,46,98,49,14,35,12,0.222222222222222,310,10
"3104",2007,"BYU",NA,NA,NA,59,117,59,34,0,80,0,53,25,78,19,0,108,38,70,81,21,60,10,0.169491525423729,303,6.27062706270627
"3105",2007,"Ball State",NA,NA,NA,54,107,64,48,0,82,0,49,45,94,37,0,111,37,74,79,29,50,15,0.277777777777778,298,12.4161073825503
"3106",2007,"Baylor",NA,NA,NA,107,228,116,74,0,183,0,101,79,180,7,0,255,88,167,96,40,56,25,0.233644859813084,591,1.1844331641286
"3107",2007,"Belmont",NA,NA,NA,30,62,38,25,0,37,0,8,10,18,0,0,36,16,20,47,6,41,7,0.233333333333333,130,0
"3108",2007,"Boise State",NA,NA,NA,126,191,103,64,0,118,0,78,45,123,33,0,230,72,158,119,30,89,39,0.30952380952381,520,6.34615384615385
"3109",2007,"Bowling Green",NA,NA,NA,86,236,147,94,0,139,0,102,69,171,43,0,181,80,101,182,61,121,25,0.290697674418605,606,7.0957095709571
"3110",2007,"Bucknell",NA,NA,NA,16,18,9,5,0,12,0,7,8,15,0,0,31,12,19,15,6,9,6,0.375,60,0
"3111",2007,"Buffalo",NA,NA,NA,25,53,19,7,0,38,0,26,19,45,0,0,46,17,29,31,13,18,9,0.36,136,0
"3112",2007,"Butler",NA,NA,NA,63,121,69,38,0,81,0,55,20,75,32,0,94,22,72,133,55,78,13,0.206349206349206,338,9.46745562130178
"3113",2007,"California",NA,NA,NA,52,163,81,52,0,97,0,71,58,129,11,0,110,41,69,62,15,47,12,0.230769230769231,362,3.03867403314917
"3114",2007,"Central Michigan",NA,NA,NA,41,68,21,17,0,48,0,26,37,63,15,0,96,33,63,41,12,29,12,0.292682926829268,189,7.93650793650794
"3115",2007,"Charlotte",NA,NA,NA,103,136,89,52,0,122,0,70,38,108,31,0,185,56,129,115,35,80,20,0.194174757281553,420,7.38095238095238
"3116",2007,"Chattanooga",NA,NA,NA,30,73,41,28,0,39,0,37,29,66,4,0,36,15,21,66,22,44,4,0.133333333333333,187,2.13903743315508
"3117",2007,"Cincinnati",NA,NA,NA,150,220,124,79,0,136,0,85,64,149,21,0,233,84,149,149,39,110,39,0.26,613,3.4257748776509
"3118",2007,"Clemson",NA,NA,NA,35,50,23,12,0,49,0,26,25,51,0,0,56,21,35,34,11,23,7,0.2,147,0
"3119",2007,"Cleveland State",NA,NA,NA,64,126,64,41,0,82,0,37,30,67,23,0,124,44,80,86,22,64,16,0.25,310,7.41935483870968
"3120",2007,"Colgate",NA,NA,NA,11,25,4,2,0,20,0,2,10,12,0,0,24,6,18,28,6,22,1,0.0909090909090909,51,0
"3121",2007,"Colorado",NA,NA,NA,145,290,185,117,0,204,0,95,67,162,66,0,316,112,204,147,47,100,41,0.282758620689655,746,8.84718498659517
"3122",2007,"Colorado State",NA,NA,NA,26,84,58,39,0,79,0,26,26,52,14,0,69,22,47,65,28,37,5,0.192307692307692,199,7.03517587939699
"3123",2007,"Columbia",NA,NA,NA,9,12,10,7,0,19,0,11,6,17,7,0,19,7,12,21,8,13,3,0.333333333333333,50,14
"3124",2007,"Cornell",NA,NA,NA,10,25,19,13,0,13,0,18,6,24,6,0,17,12,5,12,2,10,5,0.5,73,8.21917808219178
"3125",2007,"Creighton",NA,NA,NA,35,68,31,22,0,47,0,34,31,65,0,0,61,17,44,40,10,30,9,0.257142857142857,175,0
"3126",2007,"Davidson",NA,NA,NA,26,40,16,10,0,34,0,24,24,48,15,0,45,18,27,34,7,27,7,0.269230769230769,121,12.396694214876
"3127",2007,"Dayton",NA,NA,NA,50,119,38,26,0,53,0,31,14,45,9,0,119,43,76,64,19,45,14,0.28,271,3.3210332103321
"3128",2007,"DePaul",NA,NA,NA,89,190,85,57,0,156,0,76,75,151,9,0,159,64,95,160,48,112,20,0.224719101123595,496,1.81451612903226
"3129",2007,"Delaware",NA,NA,NA,89,145,93,64,0,107,0,48,37,85,43,0,204,69,135,78,20,58,22,0.247191011235955,402,10.6965174129353
"3130",2007,"Delaware State",NA,NA,NA,21,42,17,12,0,30,0,7,8,15,0,0,67,27,40,25,5,20,8,0.380952380952381,108,0
"3131",2007,"Denver",NA,NA,NA,8,21,11,5,0,12,0,9,11,20,0,0,12,4,8,14,6,8,3,0.375,51,0
"3132",2007,"Detroit Mercy",NA,NA,NA,33,43,31,20,0,41,0,21,14,35,21,0,62,19,43,32,6,26,11,0.333333333333333,131,16.030534351145
"3133",2007,"Drake",NA,NA,NA,40,69,29,16,0,42,0,23,11,34,0,0,101,22,79,35,15,20,8,0.2,173,0
"3134",2007,"Drexel",NA,NA,NA,22,38,17,12,0,34,0,11,10,21,15,0,43,12,31,37,7,30,6,0.272727272727273,93,16.1290322580645
"3135",2007,"Duke",NA,NA,NA,181,430,211,138,0,235,0,214,150,364,0,0,310,116,194,202,73,129,50,0.276243093922652,1072,0
"3136",2007,"Duquesne",NA,NA,NA,38,85,49,33,0,61,0,41,35,76,13,0,88,32,56,42,7,35,9,0.236842105263158,218,5.96330275229358
"3137",2007,"East Carolina",NA,NA,NA,82,135,88,55,0,96,0,50,39,89,18,0,168,55,113,47,8,39,16,0.195121951219512,355,5.07042253521127
"3138",2007,"East Tennessee State",NA,NA,NA,14,21,18,10,0,25,0,7,5,12,0,0,35,9,26,17,3,14,4,0.285714285714286,58,0
"3139",2007,"Eastern Michigan",NA,NA,NA,55,137,68,42,0,83,0,58,39,97,23,0,71,29,42,110,32,78,11,0.2,328,7.01219512195122
"3140",2007,"Elon",NA,NA,NA,18,18,16,10,0,18,0,6,14,20,0,0,20,3,17,12,2,10,1,0.0555555555555556,48,0
"3141",2007,"Evansville",NA,NA,NA,11,22,13,9,0,19,0,5,6,11,0,0,31,14,17,11,2,9,3,0.272727272727273,59,0
"3142",2007,"Fairfield",NA,NA,NA,12,28,13,9,0,17,0,16,4,20,0,0,22,6,16,16,8,8,6,0.5,75,0
"3143",2007,"Florida",NA,NA,NA,46,63,53,39,0,62,0,34,39,73,4,0,78,25,53,50,14,36,13,0.282608695652174,199,2.01005025125628
"3144",2007,"Florida International",NA,NA,NA,10,28,14,9,0,17,0,9,4,13,0,0,22,9,13,13,4,9,3,0.3,67,0
"3145",2007,"Florida State",NA,NA,NA,108,210,102,63,0,148,0,90,110,200,0,0,195,58,137,98,29,69,30,0.277777777777778,529,0
"3146",2007,"Fordham",NA,NA,NA,17,65,32,21,0,52,0,14,19,33,11,0,56,20,36,57,19,38,2,0.117647058823529,142,7.74647887323944
"3147",2007,"Fresno State",NA,NA,NA,42,78,46,30,0,55,0,32,32,64,15,0,72,25,47,34,9,25,6,0.142857142857143,197,7.61421319796954
"3148",2007,"George Mason",NA,NA,NA,17,39,27,18,0,37,0,14,12,26,8,0,38,6,32,34,8,26,2,0.117647058823529,91,8.79120879120879
"3149",2007,"George Washington",NA,NA,NA,127,237,123,70,0,154,0,81,56,137,42,0,273,90,183,106,38,68,36,0.283464566929134,606,6.93069306930693
"3150",2007,"Georgetown",NA,NA,NA,35,65,38,20,0,50,0,23,35,58,0,0,48,8,40,47,9,38,6,0.171428571428571,151,0
"3151",2007,"Georgia",NA,NA,NA,128,317,158,115,0,208,0,126,103,229,4,0,227,81,146,209,53,156,28,0.21875,742,0.539083557951483
"3152",2007,"Georgia Southern",NA,NA,NA,17,24,10,5,0,25,0,10,21,31,0,0,26,6,20,20,7,13,1,0.0588235294117647,68,0
"3153",2007,"Georgia State",NA,NA,NA,38,67,33,20,0,51,0,26,7,33,9,0,91,29,62,35,14,21,9,0.236842105263158,188,4.78723404255319
"3154",2007,"Georgia Tech",NA,NA,NA,31,34,19,13,0,36,0,9,11,20,0,0,58,22,36,39,10,29,4,0.129032258064516,109,0
"3155",2007,"Gonzaga",NA,NA,NA,56,142,47,31,0,70,0,38,28,66,15,0,143,59,84,57,16,41,13,0.232142857142857,323,4.64396284829721
"3156",2007,"Green Bay",NA,NA,NA,82,229,101,77,0,157,0,113,56,169,58,0,178,68,110,230,95,135,30,0.365853658536585,622,9.32475884244373
"3157",2007,"Hartford",NA,NA,NA,40,80,22,13,0,33,0,26,23,49,2,0,88,27,61,34,5,29,9,0.225,184,1.08695652173913
"3158",2007,"Harvard",NA,NA,NA,26,44,21,14,0,41,0,21,14,35,11,0,59,14,45,20,9,11,2,0.0769230769230769,120,9.16666666666667
"3159",2007,"Hawai'i",NA,NA,NA,20,60,32,21,0,27,0,19,13,32,10,0,37,10,27,29,10,19,4,0.2,128,7.8125
"3160",2007,"Hofstra",NA,NA,NA,38,70,31,19,0,59,0,29,21,50,29,0,63,25,38,61,24,37,10,0.263157894736842,191,15.1832460732984
"3161",2007,"Holy Cross",NA,NA,NA,39,83,20,15,0,43,0,26,27,53,0,0,67,21,46,86,27,59,6,0.153846153846154,203,0
"3162",2007,"Idaho",NA,NA,NA,16,48,22,16,0,36,0,5,11,16,16,0,61,25,36,45,11,34,2,0.125,107,14.9532710280374
"3163",2007,"Idaho State",NA,NA,NA,45,91,54,42,0,40,0,30,34,64,9,0,107,35,72,79,28,51,8,0.177777777777778,243,3.7037037037037
"3164",2007,"Illinois",NA,NA,NA,29,73,31,21,0,37,0,20,6,26,14,0,93,38,55,39,11,28,9,0.310344827586207,182,7.69230769230769
"3165",2007,"Illinois State",NA,NA,NA,16,60,28,21,0,26,0,25,15,40,0,0,44,16,28,27,11,16,2,0.125,142,0
"3166",2007,"Indiana",NA,NA,NA,68,121,53,36,0,88,0,57,39,96,15,0,105,28,77,101,26,75,20,0.294117647058824,313,4.79233226837061
"3167",2007,"Indiana State",NA,NA,NA,25,51,18,15,0,37,0,10,16,26,4,0,81,25,56,30,17,13,7,0.28,133,3.00751879699248
"3168",2007,"Iona",NA,NA,NA,34,52,13,8,0,42,0,20,29,49,3,0,41,13,28,27,10,17,4,0.117647058823529,131,2.29007633587786
"3169",2007,"Iowa",NA,NA,NA,88,131,79,56,0,106,0,54,35,89,35,0,179,53,126,89,37,52,26,0.295454545454545,389,8.9974293059126
"3170",2007,"Iowa State",NA,NA,NA,112,362,143,101,0,191,0,87,65,152,29,0,262,96,166,276,95,181,31,0.276785714285714,787,3.6848792884371
"3171",2007,"James Madison",NA,NA,NA,99,131,75,51,0,92,0,57,40,97,27,0,153,49,104,68,15,53,25,0.252525252525253,372,7.25806451612903
"3172",2007,"Kansas",NA,NA,NA,62,111,50,34,0,82,0,41,34,75,12,0,138,44,94,69,22,47,15,0.241935483870968,292,4.10958904109589
"3173",2007,"Kansas State",NA,NA,NA,95,171,79,42,0,130,0,55,47,102,33,0,169,52,117,184,50,134,21,0.221052631578947,439,7.51708428246014
"3174",2007,"Kent State",NA,NA,NA,32,57,35,23,0,43,0,26,15,41,16,0,64,18,46,21,8,13,5,0.15625,149,10.738255033557
"3175",2007,"LSU",NA,NA,NA,140,320,134,81,0,148,0,111,123,234,0,0,299,100,199,131,50,81,43,0.307142857142857,759,0
"3176",2007,"La Salle",NA,NA,NA,7,15,6,5,0,12,0,10,7,17,7,0,23,10,13,8,0,8,0,0,45,15.5555555555556
"3177",2007,"Louisiana",NA,NA,NA,62,84,48,26,0,67,0,40,38,78,0,0,83,25,58,73,17,56,10,0.161290322580645,239,0
"3178",2007,"Louisiana Tech",NA,NA,NA,45,89,49,30,0,60,0,35,34,69,15,0,77,27,50,28,10,18,14,0.311111111111111,217,6.91244239631336
"3179",2007,"Louisville",NA,NA,NA,155,254,113,68,0,171,0,120,67,187,54,0,251,91,160,200,51,149,41,0.264516129032258,700,7.71428571428571
"3180",2007,"Loyola Chicago",NA,NA,NA,10,28,23,16,0,15,0,10,8,18,8,0,18,6,12,16,8,8,4,0.4,70,11.4285714285714
"3181",2007,"Loyola Marymount",NA,NA,NA,52,69,50,30,0,36,0,35,44,79,25,0,68,16,52,31,9,22,15,0.288461538461538,190,13.1578947368421
"3182",2007,"Maine",NA,NA,NA,15,49,22,14,0,26,0,18,22,40,3,0,34,14,20,29,10,19,4,0.266666666666667,112,2.67857142857143
"3183",2007,"Marist",NA,NA,NA,40,104,66,47,0,65,0,49,44,93,12,0,88,29,59,70,26,44,11,0.275,267,4.49438202247191
"3184",2007,"Marquette",NA,NA,NA,150,268,156,106,0,188,0,116,81,197,66,0,236,77,159,174,48,126,29,0.193333333333333,693,9.52380952380952
"3185",2007,"Marshall",NA,NA,NA,29,72,53,31,0,50,0,13,7,20,9,0,85,27,58,43,14,29,5,0.172413793103448,172,5.23255813953488
"3186",2007,"Maryland",NA,NA,NA,128,256,110,68,0,149,0,136,54,190,0,0,226,83,143,158,52,106,46,0.359375,679,0
"3187",2007,"Memphis",NA,NA,NA,17,20,12,7,0,20,0,7,10,17,0,0,23,5,18,26,7,19,2,0.117647058823529,60,0
"3188",2007,"Miami (OH)",NA,NA,NA,55,114,62,33,0,74,0,45,22,67,21,0,137,52,85,71,12,59,14,0.254545454545455,299,7.02341137123746
"3189",2007,"Michigan",NA,NA,NA,21,46,24,15,0,32,0,21,16,37,7,0,23,5,18,43,10,33,6,0.285714285714286,109,6.42201834862385
"3190",2007,"Michigan State",NA,NA,NA,128,209,91,65,0,163,0,102,81,183,28,0,198,46,152,149,52,97,29,0.2265625,561,4.99108734402852
"3191",2007,"Middle Tennessee",NA,NA,NA,77,105,52,37,0,105,0,71,37,108,16,0,140,53,87,126,46,80,22,0.285714285714286,373,4.28954423592493
"3192",2007,"Milwaukee",NA,NA,NA,80,149,68,43,0,105,0,81,55,136,19,0,103,35,68,121,45,76,15,0.1875,408,4.65686274509804
"3193",2007,"Minnesota",NA,NA,NA,63,98,66,40,0,91,0,52,37,89,7,0,113,31,82,41,15,26,13,0.206349206349206,276,2.53623188405797
"3194",2007,"Missouri",NA,NA,NA,33,71,38,25,0,52,0,21,9,30,11,0,83,22,61,54,17,37,7,0.212121212121212,170,6.47058823529412
"3195",2007,"Monmouth",NA,NA,NA,13,29,9,4,0,23,0,9,23,32,11,0,14,3,11,13,6,7,3,0.230769230769231,63,17.4603174603175
"3196",2007,"Montana",NA,NA,NA,57,100,57,37,0,59,0,62,39,101,21,0,84,33,51,61,27,34,17,0.298245614035088,291,7.21649484536082
"3197",2007,"Montana State",NA,NA,NA,10,21,17,10,0,16,0,12,15,27,9,0,18,1,17,10,4,6,3,0.3,49,18.3673469387755
"3198",2007,"Morgan State",NA,NA,NA,14,26,12,8,0,14,0,6,6,12,0,0,35,7,28,10,1,9,3,0.214285714285714,56,0
"3199",2007,"NC State",NA,NA,NA,85,194,88,52,0,105,0,106,74,180,0,0,182,75,107,66,21,45,26,0.305882352941176,505,0
"3200",2007,"Nebraska",NA,NA,NA,123,290,133,92,0,185,0,78,39,117,41,0,314,118,196,177,58,119,30,0.24390243902439,695,5.89928057553957
"3201",2007,"Nevada",NA,NA,NA,36,31,30,18,0,26,0,22,14,36,18,0,50,13,37,31,8,23,5,0.138888888888889,116,15.5172413793103
"3202",2007,"New Mexico",NA,NA,NA,80,163,100,69,0,103,0,63,37,100,29,0,177,69,108,116,34,82,17,0.2125,432,6.71296296296296
"3203",2007,"New Mexico State",NA,NA,NA,23,62,27,17,0,35,0,13,6,19,8,0,65,18,47,32,12,20,5,0.217391304347826,133,6.01503759398496
"3204",2007,"Niagara",NA,NA,NA,12,17,11,8,0,14,0,13,6,19,0,0,25,5,20,18,6,12,2,0.166666666666667,56,0
"3205",2007,"North Carolina",NA,NA,NA,213,412,212,141,0,277,0,237,183,420,0,0,274,96,178,246,68,178,52,0.244131455399061,1075,0
"3206",2007,"North Texas",NA,NA,NA,10,23,8,4,0,14,0,8,9,17,8,0,25,9,16,17,6,11,2,0.2,58,13.7931034482759
"3207",2007,"Northeastern",NA,NA,NA,15,21,11,9,0,16,0,10,15,25,9,0,22,5,17,16,4,12,3,0.2,58,15.5172413793103
"3208",2007,"Northern Arizona",NA,NA,NA,37,83,31,21,0,58,0,39,33,72,25,0,78,28,50,42,17,25,11,0.297297297297297,213,11.7370892018779
"3209",2007,"Northern Colorado",NA,NA,NA,15,24,7,3,0,13,0,3,9,12,2,0,19,4,15,31,12,19,2,0.133333333333333,61,3.27868852459016
"3210",2007,"Northern Illinois",NA,NA,NA,26,55,27,19,0,36,0,15,15,30,5,0,50,16,34,45,18,27,7,0.269230769230769,135,3.7037037037037
"3211",2007,"Northern Iowa",NA,NA,NA,8,25,13,7,0,12,0,3,5,8,4,0,29,15,14,21,7,14,3,0.375,63,6.34920634920635
"3212",2007,"Northwestern",NA,NA,NA,13,18,11,8,0,20,0,3,8,11,0,0,26,6,20,17,4,13,2,0.153846153846154,46,0
"3213",2007,"Notre Dame",NA,NA,NA,116,170,133,87,0,139,0,70,67,137,9,0,217,77,140,108,25,83,24,0.206896551724138,495,1.81818181818182
"3214",2007,"Oakland",NA,NA,NA,25,43,11,5,0,34,0,27,30,57,0,0,41,12,29,28,8,20,6,0.24,119,0
"3215",2007,"Ohio",NA,NA,NA,5,23,13,8,0,22,0,6,3,9,7,0,36,15,21,14,5,9,1,0.2,57,12.280701754386
"3216",2007,"Ohio State",NA,NA,NA,151,324,165,106,0,177,0,167,79,246,19,0,326,137,189,135,39,96,46,0.304635761589404,867,2.19146482122261
"3217",2007,"Oklahoma",NA,NA,NA,258,611,282,165,0,334,0,271,196,467,27,0,369,159,210,302,103,199,76,0.294573643410853,1478,1.82679296346414
"3218",2007,"Oklahoma State",NA,NA,NA,64,123,76,46,0,98,0,40,34,74,19,0,110,37,73,97,31,66,12,0.1875,320,5.9375
"3219",2007,"Old Dominion",NA,NA,NA,68,115,78,51,0,105,0,46,45,91,34,0,141,62,79,50,19,31,18,0.264705882352941,331,10.2719033232628
"3220",2007,"Ole Miss",NA,NA,NA,122,147,145,90,0,134,0,87,60,147,0,0,212,71,141,108,25,83,30,0.245901639344262,492,0
"3221",2007,"Oral Roberts",NA,NA,NA,22,45,26,15,0,22,0,9,15,24,0,0,46,20,26,29,11,18,5,0.227272727272727,112,0
"3222",2007,"Oregon",NA,NA,NA,45,148,79,60,0,100,0,51,26,77,23,0,129,43,86,89,30,59,10,0.222222222222222,341,6.74486803519062
"3223",2007,"Oregon State",NA,NA,NA,19,42,38,23,0,34,0,17,9,26,4,0,51,17,34,20,7,13,2,0.105263157894737,109,3.6697247706422
"3224",2007,"Penn State",NA,NA,NA,93,159,113,74,0,118,0,91,50,141,35,0,175,53,122,73,29,44,25,0.268817204301075,455,7.69230769230769
"3225",2007,"Pennsylvania",NA,NA,NA,13,21,18,10,0,25,0,7,11,18,0,0,26,6,20,13,4,9,3,0.230769230769231,58,0
"3226",2007,"Pepperdine",NA,NA,NA,24,71,26,20,0,52,0,38,30,68,18,0,58,17,41,32,9,23,4,0.166666666666667,168,10.7142857142857
"3227",2007,"Pittsburgh",NA,NA,NA,111,186,115,74,0,153,0,93,60,153,18,0,233,71,162,57,24,33,20,0.18018018018018,519,3.46820809248555
"3228",2007,"Portland",NA,NA,NA,12,19,12,8,0,17,0,13,16,29,9,0,21,7,14,10,2,8,3,0.25,58,15.5172413793103
"3229",2007,"Portland State",NA,NA,NA,12,27,14,10,0,20,0,12,9,21,5,0,26,8,18,14,3,11,2,0.166666666666667,65,7.69230769230769
"3230",2007,"Prairie View A&M",NA,NA,NA,8,16,6,3,0,18,0,7,17,24,0,0,18,4,14,18,4,14,1,0.125,41,0
"3231",2007,"Providence",NA,NA,NA,22,31,12,8,0,34,0,10,9,19,14,0,40,16,24,47,9,38,6,0.272727272727273,91,15.3846153846154
"3232",2007,"Purdue",NA,NA,NA,119,299,130,88,0,180,0,123,88,211,18,0,279,120,159,177,59,118,33,0.277310924369748,754,2.38726790450928
"3233",2007,"Radford",NA,NA,NA,10,15,8,4,0,21,0,8,9,17,0,0,24,9,15,17,6,11,2,0.2,51,0
"3234",2007,"Rhode Island",NA,NA,NA,24,44,22,15,0,40,0,17,7,24,23,0,79,32,47,21,12,9,10,0.416666666666667,133,17.2932330827068
"3235",2007,"Rice",NA,NA,NA,21,31,21,14,0,26,0,6,8,14,0,0,36,9,27,19,6,13,6,0.285714285714286,78,0
"3236",2007,"Richmond",NA,NA,NA,70,109,52,31,0,93,0,59,49,108,21,0,105,26,79,80,34,46,17,0.242857142857143,306,6.86274509803922
"3237",2007,"Robert Morris",NA,NA,NA,21,21,8,5,0,13,0,12,17,29,0,0,22,7,15,17,2,15,7,0.333333333333333,64,0
"3238",2007,"Rutgers",NA,NA,NA,258,459,240,160,0,298,0,181,142,323,36,0,466,158,308,278,94,184,57,0.22093023255814,1215,2.96296296296296
"3239",2007,"Sacred Heart",NA,NA,NA,20,52,30,17,0,23,0,12,26,38,14,0,36,15,21,38,4,34,3,0.15,111,12.6126126126126
"3240",2007,"Saint Joseph's",NA,NA,NA,51,127,78,50,0,106,0,47,36,83,17,0,106,41,65,79,24,55,11,0.215686274509804,309,5.50161812297735
"3241",2007,"Saint Louis",NA,NA,NA,64,130,85,56,0,86,0,58,71,129,35,0,78,23,55,73,18,55,11,0.171875,314,11.1464968152866
"3242",2007,"Saint Mary's",NA,NA,NA,38,42,30,19,0,27,0,16,26,42,4,0,60,22,38,17,6,11,10,0.263157894736842,132,3.03030303030303
"3243",2007,"San Diego State",NA,NA,NA,6,10,8,5,0,16,0,2,3,5,0,0,14,3,11,12,3,9,2,0.333333333333333,25,0
"3244",2007,"San Francisco",NA,NA,NA,28,46,19,11,0,30,0,22,27,49,10,0,56,17,39,28,7,21,7,0.25,124,8.06451612903226
"3245",2007,"San José State",NA,NA,NA,65,165,86,55,0,105,0,45,47,92,31,1,183,64,119,74,21,53,15,0.230769230769231,391,7.92838874680307
"3246",2007,"Santa Clara",NA,NA,NA,9,24,2,1,0,22,0,15,14,29,6,0,16,6,10,14,2,12,1,0.111111111111111,57,10.5263157894737
"3247",2007,"Seton Hall",NA,NA,NA,67,136,51,33,0,102,0,47,41,88,18,0,195,69,126,26,6,20,20,0.298507462686567,336,5.35714285714286
"3248",2007,"South Alabama",NA,NA,NA,38,76,52,35,0,49,0,16,13,29,23,0,83,26,57,46,15,31,7,0.184210526315789,184,12.5
"3249",2007,"South Carolina",NA,NA,NA,54,61,27,14,0,60,0,40,41,81,0,0,79,20,59,42,13,29,11,0.203703703703704,195,0
"3250",2007,"South Florida",NA,NA,NA,174,229,148,92,0,168,0,130,128,258,44,0,251,73,178,146,48,98,44,0.252873563218391,688,6.3953488372093
"3251",2007,"Southeast Missouri State",NA,NA,NA,13,18,8,6,0,9,0,5,10,15,0,0,26,9,17,20,7,13,3,0.230769230769231,53,0
"3252",2007,"Southern Illinois",NA,NA,NA,19,25,17,8,0,15,0,8,3,11,0,0,35,13,22,15,4,11,4,0.210526315789474,75,0
"3253",2007,"Southern Miss",NA,NA,NA,12,27,9,6,0,18,0,5,3,8,13,0,41,21,20,18,7,11,5,0.416666666666667,75,17.3333333333333
"3254",2007,"Southern Utah",NA,NA,NA,6,23,5,2,0,13,0,8,6,14,3,0,15,3,12,14,3,11,3,0.5,43,6.97674418604651
"3255",2007,"St. Bonaventure",NA,NA,NA,21,72,35,24,0,43,0,33,26,59,20,0,50,16,34,41,17,24,3,0.142857142857143,172,11.6279069767442
"3256",2007,"St. John's",NA,NA,NA,34,64,38,22,0,51,0,27,31,58,13,0,68,27,41,34,13,21,6,0.176470588235294,176,7.38636363636364
"3257",2007,"Stanford",NA,NA,NA,133,311,108,66,0,178,0,127,83,210,14,0,273,98,175,138,57,81,39,0.293233082706767,746,1.87667560321716
"3258",2007,"Stephen F. Austin",NA,NA,NA,14,23,11,8,0,19,0,10,2,12,0,0,35,7,28,8,0,8,3,0.214285714285714,57,0
"3259",2007,"Stony Brook",NA,NA,NA,41,44,44,28,0,32,0,27,25,52,25,0,83,34,49,16,5,11,8,0.195121951219512,164,15.2439024390244
"3260",2007,"Syracuse",NA,NA,NA,98,229,127,85,0,128,0,70,69,139,30,0,209,64,145,142,32,110,24,0.244897959183673,532,5.6390977443609
"3261",2007,"TCU",NA,NA,NA,32,37,32,19,0,44,0,23,15,38,0,0,54,14,40,32,13,19,9,0.28125,127,0
"3262",2007,"Temple",NA,NA,NA,122,167,91,55,0,110,0,73,65,138,28,0,236,103,133,39,14,25,29,0.237704918032787,504,5.55555555555556
"3263",2007,"Tennessee",NA,NA,NA,338,610,344,218,1,418,0,315,198,513,9,0,622,218,404,366,135,231,97,0.28698224852071,1715,0.524781341107872
"3264",2007,"Texas",NA,NA,NA,119,264,126,77,0,164,0,103,88,191,14,0,309,93,216,96,29,67,27,0.226890756302521,648,2.16049382716049
"3265",2007,"Texas A&M",NA,NA,NA,203,316,170,103,0,270,0,124,115,239,51,0,388,130,258,209,69,140,49,0.241379310344828,886,5.75620767494357
"3266",2007,"Texas Tech",NA,NA,NA,44,83,43,29,0,72,0,39,17,56,19,0,110,36,74,58,20,38,9,0.204545454545455,236,8.05084745762712
"3267",2007,"Toledo",NA,NA,NA,68,135,88,60,0,99,0,75,34,109,20,0,137,41,96,98,32,66,18,0.264705882352941,374,5.3475935828877
"3268",2007,"Towson",NA,NA,NA,16,24,7,5,0,20,0,7,11,18,12,0,26,5,21,13,3,10,2,0.125,56,21.4285714285714
"3269",2007,"Troy",NA,NA,NA,10,31,17,8,0,19,0,6,2,8,6,0,34,13,21,11,1,10,2,0.2,65,9.23076923076923
"3270",2007,"Tulane",NA,NA,NA,14,20,13,7,0,24,0,11,4,15,9,0,32,14,18,20,3,17,3,0.214285714285714,67,13.4328358208955
"3271",2007,"UC Riverside",NA,NA,NA,14,22,11,7,0,19,0,9,9,18,0,0,29,9,20,6,1,5,3,0.214285714285714,56,0
"3272",2007,"UCF",NA,NA,NA,8,25,17,10,0,11,0,5,0,5,9,0,34,10,24,11,4,7,1,0.125,59,15.2542372881356
"3273",2007,"UCLA",NA,NA,NA,44,108,45,27,0,68,0,46,21,67,4,0,113,39,74,45,16,29,11,0.25,266,1.50375939849624
"3274",2007,"UConn",NA,NA,NA,414,1009,405,254,0,442,0,539,289,828,49,0,722,275,447,423,136,287,148,0.357487922705314,2480,1.9758064516129
"3275",2007,"UIC",NA,NA,NA,14,29,12,7,0,23,0,19,8,27,6,0,29,8,21,20,6,14,7,0.5,80,7.5
"3276",2007,"UL Monroe",NA,NA,NA,55,87,49,28,0,75,0,25,16,41,11,0,139,44,95,42,14,28,15,0.272727272727273,240,4.58333333333333
"3277",2007,"UMBC",NA,NA,NA,19,62,12,6,0,42,0,23,16,39,0,0,56,16,40,71,20,51,7,0.368421052631579,142,0
"3278",2007,"UMass",NA,NA,NA,46,105,42,29,0,51,0,55,36,91,17,0,87,26,61,38,11,27,11,0.239130434782609,257,6.6147859922179
"3279",2007,"UNC Asheville",NA,NA,NA,32,46,29,15,0,25,0,15,18,33,0,0,39,12,27,31,10,21,7,0.21875,122,0
"3280",2007,"UNC Greensboro",NA,NA,NA,26,61,21,15,0,33,0,43,15,58,9,0,47,15,32,20,8,12,11,0.423076923076923,157,5.73248407643312
"3281",2007,"UNC Wilmington",NA,NA,NA,59,132,89,58,0,87,0,39,20,59,30,0,158,45,113,60,13,47,12,0.203389830508475,311,9.64630225080386
"3282",2007,"UNLV",NA,NA,NA,20,40,28,14,0,41,0,20,20,40,4,0,44,14,30,20,7,13,6,0.3,107,3.73831775700935
"3283",2007,"USC",NA,NA,NA,54,65,48,29,0,55,0,28,28,56,6,0,67,20,47,60,17,43,14,0.259259259259259,198,3.03030303030303
"3284",2007,"UT Arlington",NA,NA,NA,38,44,37,24,0,36,0,20,17,37,4,0,63,14,49,20,5,15,9,0.236842105263158,129,3.10077519379845
"3285",2007,"UTEP",NA,NA,NA,8,25,4,3,0,19,0,15,3,18,15,0,26,9,17,17,5,12,5,0.625,63,23.8095238095238
"3286",2007,"Utah",NA,NA,NA,8,51,21,18,0,41,0,11,3,14,5,0,47,15,32,29,12,17,2,0.25,100,5
"3287",2007,"Utah State",NA,NA,NA,49,99,61,41,0,75,0,37,39,76,20,0,97,30,67,86,23,63,11,0.224489795918367,254,7.8740157480315
"3288",2007,"VCU",NA,NA,NA,41,81,48,30,0,42,0,45,18,63,16,0,90,30,60,33,10,23,16,0.390243902439024,223,7.17488789237668
"3289",2007,"Valparaiso",NA,NA,NA,6,21,12,7,0,14,0,13,9,22,0,0,7,4,3,9,4,5,2,0.333333333333333,51,0
"3290",2007,"Vanderbilt",NA,NA,NA,71,208,134,93,0,168,0,92,52,144,9,0,170,73,97,112,50,62,25,0.352112676056338,531,1.69491525423729
"3291",2007,"Vermont",NA,NA,NA,16,29,13,8,0,18,0,17,6,23,4,0,35,15,20,13,4,9,4,0.25,84,4.76190476190476
"3292",2007,"Villanova",NA,NA,NA,20,54,13,9,0,45,0,10,11,21,14,0,50,15,35,95,26,69,4,0.2,126,11.1111111111111
"3293",2007,"Virginia",NA,NA,NA,52,116,64,44,0,65,0,55,71,126,0,0,79,27,52,58,11,47,9,0.173076923076923,279,0
"3294",2007,"Virginia Tech",NA,NA,NA,19,44,22,14,0,32,0,24,20,44,0,0,44,14,30,20,7,13,6,0.31578947368421,112,0
"3295",2007,"Wake Forest",NA,NA,NA,11,18,9,6,0,17,0,8,8,16,0,0,22,7,15,25,5,20,1,0.0909090909090909,52,0
"3296",2007,"Washington",NA,NA,NA,44,67,47,26,0,60,0,34,32,66,0,0,79,27,52,47,11,36,8,0.181818181818182,201,0
"3297",2007,"Weber State",NA,NA,NA,56,76,43,26,0,65,0,23,25,48,12,0,94,31,63,51,19,32,18,0.321428571428571,217,5.52995391705069
"3298",2007,"West Virginia",NA,NA,NA,76,192,78,54,0,138,0,75,49,124,16,0,184,63,121,127,40,87,25,0.328947368421053,466,3.43347639484979
"3299",2007,"Western Carolina",NA,NA,NA,21,62,41,23,0,34,0,32,21,53,8,0,29,11,18,25,7,18,5,0.238095238095238,141,5.67375886524823
"3300",2007,"Western Illinois",NA,NA,NA,28,37,14,9,0,26,0,12,14,26,4,0,38,12,26,39,11,28,6,0.214285714285714,104,3.84615384615385
"3301",2007,"Western Kentucky",NA,NA,NA,12,29,23,12,0,23,0,8,6,14,13,0,23,7,16,15,7,8,3,0.25,68,19.1176470588235
"3302",2007,"Western Michigan",NA,NA,NA,47,112,60,39,0,67,0,59,19,78,27,0,111,29,82,52,15,37,17,0.361702127659574,280,9.64285714285714
"3303",2007,"William & Mary",NA,NA,NA,36,58,41,24,0,45,0,17,16,33,21,0,72,24,48,49,19,30,12,0.333333333333333,162,12.962962962963
"3304",2007,"Wisconsin",NA,NA,NA,14,26,11,10,0,19,0,12,15,27,0,0,20,8,12,18,7,11,3,0.214285714285714,70,0
"3305",2007,"Wright State",NA,NA,NA,35,47,26,20,0,36,0,22,22,44,17,0,16,6,10,58,15,43,3,0.0857142857142857,134,12.6865671641791
"3306",2007,"Wyoming",NA,NA,NA,23,63,46,32,0,45,0,21,19,40,11,0,50,20,30,38,14,24,5,0.217391304347826,150,7.33333333333333
"3307",2007,"Xavier",NA,NA,NA,37,73,49,33,0,36,0,25,18,43,0,0,70,27,43,50,15,35,10,0.27027027027027,192,0
"3308",2007,"Yale",NA,NA,NA,13,23,17,12,0,20,0,7,12,19,7,0,19,5,14,13,5,8,3,0.230769230769231,57,12.280701754386
"3309",2007,"Youngstown State",NA,NA,NA,59,120,64,45,0,87,0,24,22,46,30,0,146,48,98,88,25,63,12,0.203389830508475,294,10.2040816326531
"3310",2008,"Adams State",NA,NA,NA,10,27,11,6,0,13,0,7,10,17,7,0,23,6,17,15,5,10,3,0.3,60,11.6666666666667
"3311",2008,"Air Force",NA,NA,NA,171,281,119,77,0,188,2,107,108,215,94,0,339,102,237,152,56,96,33,0.192982456140351,748,12.5668449197861
"3312",2008,"Akron",NA,NA,NA,149,299,159,107,0,238,1,114,152,266,68,0,193,56,137,229,68,161,37,0.248322147651007,734,9.26430517711172
"3313",2008,"Alabama",NA,NA,NA,67,119,65,33,0,100,0,58,50,108,30,0,130,40,90,74,26,48,20,0.298507462686567,328,9.14634146341463
"3314",2008,"Alabama A&M",NA,NA,NA,12,20,19,15,0,15,1,7,5,12,0,0,26,7,19,11,6,5,4,0.333333333333333,60,0
"3315",2008,"Alabama State",NA,NA,NA,24,42,17,10,0,40,0,5,16,21,15,0,60,14,46,33,8,25,1,0.0416666666666667,95,15.7894736842105
"3316",2008,"Albany",NA,NA,NA,207,326,153,94,0,248,1,139,111,250,146,0,377,138,239,221,66,155,67,0.323671497584541,922,15.8351409978308
"3317",2008,"Alcorn State",NA,NA,NA,20,56,29,17,0,34,0,7,6,13,15,0,48,14,34,46,19,27,5,0.25,121,12.396694214876
"3318",2008,"Alice Lloyd College",NA,NA,NA,13,34,13,9,0,18,0,6,13,19,5,0,15,2,13,24,10,14,0,0,67,7.46268656716418
"3319",2008,"American University",NA,NA,NA,95,151,125,80,0,105,0,58,54,112,60,0,120,39,81,108,37,71,21,0.221052631578947,409,14.6699266503667
"3320",2008,"Appalachian State",NA,NA,NA,40,65,45,26,0,62,0,25,23,48,38,0,90,38,52,31,5,26,11,0.275,188,20.2127659574468
"3321",2008,"Arizona",NA,NA,NA,43,69,38,22,0,46,0,26,26,52,13,0,87,23,64,33,9,24,8,0.186046511627907,180,7.22222222222222
"3322",2008,"Arizona State",NA,NA,NA,52,104,62,40,0,89,0,43,36,79,10,0,106,38,68,61,22,39,12,0.230769230769231,276,3.6231884057971
"3323",2008,"Ark Monticello",NA,NA,NA,11,19,6,4,0,13,0,3,5,8,7,0,29,8,21,29,10,19,1,0.0909090909090909,54,12.962962962963
"3324",2008,"Arkansas",NA,NA,NA,86,168,73,48,0,94,0,72,43,115,46,0,173,58,115,116,43,73,21,0.244186046511628,446,10.3139013452915
"3325",2008,"Arkansas State",NA,NA,NA,188,251,168,97,0,178,0,102,137,239,109,0,269,88,181,128,30,98,41,0.218085106382979,706,15.4390934844193
"3326",2008,"Arkansas-Pine Bluff",NA,NA,NA,37,73,35,17,0,85,0,21,12,33,38,0,110,34,76,45,8,37,5,0.135135135135135,183,20.7650273224044
"3327",2008,"Army",NA,NA,NA,161,278,152,92,0,191,1,120,104,224,73,0,289,103,186,137,33,104,37,0.229813664596273,740,9.86486486486486
"3328",2008,"Auburn",NA,NA,NA,202,291,184,121,0,180,1,130,78,208,99,0,401,122,279,160,46,114,55,0.272277227722772,836,11.8421052631579
"3329",2008,"Austin Peay",NA,NA,NA,125,158,86,54,0,120,1,69,45,114,48,0,216,60,156,89,29,60,31,0.248,465,10.3225806451613
"3330",2008,"BYU",NA,NA,NA,73,159,47,29,0,144,1,49,39,88,33,0,148,40,108,123,32,91,15,0.205479452054795,363,9.09090909090909
"3331",2008,"Ball State",NA,NA,NA,175,346,163,107,0,197,0,203,138,341,111,0,236,67,169,235,83,152,53,0.302857142857143,920,12.0652173913043
"3332",2008,"Baylor",NA,NA,NA,351,635,408,256,0,387,2,131,74,205,176,0,867,348,519,340,108,232,97,0.276353276353276,1676,10.5011933174224
"3333",2008,"Belmont",NA,NA,NA,60,108,68,40,0,97,0,33,34,67,33,0,90,35,55,102,26,76,9,0.15,279,11.8279569892473
"3334",2008,"Bethune-Cookman",NA,NA,NA,71,95,59,33,0,87,0,47,33,80,47,0,110,33,77,97,19,78,19,0.267605633802817,277,16.9675090252708
"3335",2008,"Binghamton",NA,NA,NA,88,187,100,68,0,140,0,58,58,116,38,0,206,79,127,84,28,56,20,0.227272727272727,472,8.05084745762712
"3336",2008,"Birmingham-Southern",NA,NA,NA,13,19,10,6,0,22,0,2,5,7,5,0,38,15,23,11,2,9,4,0.307692307692308,53,9.43396226415094
"3337",2008,"Boise State",NA,NA,NA,271,433,248,160,0,278,2,170,107,277,175,0,480,164,316,359,124,235,63,0.232472324723247,1233,14.1930251419303
"3338",2008,"Boston College",NA,NA,NA,92,173,78,46,0,119,0,112,82,194,39,0,98,33,65,87,18,69,32,0.347826086956522,454,8.59030837004405
"3339",2008,"Boston University",NA,NA,NA,173,364,176,128,0,265,2,163,126,289,132,0,350,128,222,274,105,169,44,0.254335260115607,993,13.2930513595166
"3340",2008,"Bowling Green",NA,NA,NA,127,259,147,102,0,178,1,93,78,171,88,0,265,106,159,191,66,125,30,0.236220472440945,691,12.7351664254703
"3341",2008,"Bradley",NA,NA,NA,35,65,29,18,0,55,0,30,20,50,24,0,75,24,51,45,17,28,9,0.257142857142857,178,13.4831460674157
"3342",2008,"Brown",NA,NA,NA,81,151,68,34,0,126,0,36,61,97,49,0,180,60,120,86,22,64,19,0.234567901234568,371,13.2075471698113
"3343",2008,"Bucknell",NA,NA,NA,95,166,81,51,0,90,0,56,32,88,35,0,240,78,162,88,28,60,25,0.263157894736842,444,7.88288288288288
"3344",2008,"Buffalo",NA,NA,NA,223,420,183,104,0,258,0,235,167,402,143,0,377,112,265,228,69,159,67,0.300448430493274,1108,12.9061371841155
"3345",2008,"Butler",NA,NA,NA,206,380,252,156,0,279,3,210,121,331,165,0,317,97,220,309,86,223,54,0.262135922330097,1049,15.7292659675882
"3346",2008,"Cal Poly",NA,NA,NA,65,136,80,54,0,142,2,69,46,115,36,0,154,54,100,79,24,55,15,0.230769230769231,363,9.91735537190083
"3347",2008,"Cal State Bakersfield",NA,NA,NA,88,164,133,88,0,114,1,47,42,89,68,0,228,93,135,103,35,68,25,0.284090909090909,464,14.6551724137931
"3348",2008,"Cal State Fullerton",NA,NA,NA,52,86,39,28,0,66,0,23,22,45,26,0,119,47,72,71,21,50,11,0.211538461538462,239,10.8786610878661
"3349",2008,"Cal State Northridge",NA,NA,NA,56,104,60,38,0,89,1,32,19,51,34,0,129,37,92,59,17,42,10,0.178571428571429,261,13.0268199233716
"3350",2008,"California",NA,NA,NA,156,306,155,91,0,174,1,116,87,203,16,0,295,89,206,158,50,108,31,0.198717948717949,755,2.11920529801325
"3351",2008,"Campbell",NA,NA,NA,38,47,17,11,0,41,0,20,13,33,17,0,54,17,37,32,4,28,7,0.184210526315789,128,13.28125
"3352",2008,"Canisius",NA,NA,NA,158,378,198,122,0,232,1,112,125,237,93,0,291,86,205,251,79,172,32,0.20253164556962,868,10.7142857142857
"3353",2008,"Cardinal Stritch",NA,NA,NA,7,17,4,3,0,21,0,8,4,12,11,0,32,7,25,16,7,9,1,0.142857142857143,48,22.9166666666667
"3354",2008,"Centenary",NA,NA,NA,38,72,37,22,0,49,0,25,37,62,20,0,71,18,53,33,13,20,8,0.210526315789474,176,11.3636363636364
"3355",2008,"Central Arkansas",NA,NA,NA,18,40,10,5,0,43,0,12,14,26,15,0,58,13,45,49,9,40,2,0.111111111111111,93,16.1290322580645
"3356",2008,"Central Connecticut",NA,NA,NA,192,385,211,115,0,265,0,144,176,320,155,0,296,94,202,274,88,186,46,0.239583333333333,958,16.1795407098121
"3357",2008,"Central Michigan",NA,NA,NA,209,382,195,125,0,308,0,206,135,341,161,0,376,99,277,323,114,209,52,0.248803827751196,1053,15.289648622982
"3358",2008,"Charleston",NA,NA,NA,46,74,28,16,0,35,0,19,18,37,24,0,91,20,71,60,18,42,13,0.282608695652174,184,13.0434782608696
"3359",2008,"Charleston Southern",NA,NA,NA,115,223,105,73,0,143,0,67,59,126,63,0,297,93,204,162,61,101,24,0.208695652173913,584,10.7876712328767
"3360",2008,"Charlotte",NA,NA,NA,251,450,233,151,0,266,1,116,70,186,148,0,557,227,330,195,62,133,66,0.262948207171315,1178,12.5636672325976
"3361",2008,"Chattanooga",NA,NA,NA,44,102,40,26,0,55,0,47,45,92,17,0,64,22,42,68,28,40,9,0.204545454545455,256,6.640625
"3362",2008,"Chicago State",NA,NA,NA,6,23,21,12,0,9,0,9,5,14,10,0,22,8,14,19,3,16,3,0.5,53,18.8679245283019
"3363",2008,"Chowan",NA,NA,NA,6,20,6,4,0,18,0,7,9,16,4,0,16,3,13,14,3,11,0,0,41,9.75609756097561
"3364",2008,"Cincinnati",NA,NA,NA,281,499,245,160,0,269,3,157,134,291,96,0,439,129,310,446,156,290,52,0.185053380782918,1282,7.48829953198128
"3365",2008,"Clemson",NA,NA,NA,288,478,228,138,0,381,3,213,156,369,230,0,644,216,428,268,74,194,80,0.277777777777778,1322,17.3978819969743
"3366",2008,"Cleveland State",NA,NA,NA,218,444,250,181,0,346,0,197,153,350,189,0,408,138,270,335,110,225,63,0.288990825688073,1169,16.1676646706587
"3367",2008,"Coastal Carolina",NA,NA,NA,44,84,27,17,0,77,1,34,20,54,28,0,111,28,83,74,15,59,15,0.340909090909091,209,13.3971291866029
"3368",2008,"Colgate",NA,NA,NA,111,217,97,52,0,151,0,80,104,184,51,0,195,59,136,129,42,87,25,0.225225225225225,532,9.58646616541353
"3369",2008,"Colorado State",NA,NA,NA,91,159,78,44,0,119,1,52,39,91,34,0,180,44,136,82,26,56,22,0.241758241758242,391,8.69565217391304
"3370",2008,"Columbia",NA,NA,NA,234,469,278,172,0,332,1,181,195,376,150,0,332,89,243,369,104,265,54,0.230769230769231,1158,12.9533678756477
"3371",2008,"Coppin State",NA,NA,NA,79,137,77,45,0,112,1,79,52,131,24,0,165,68,97,56,16,40,26,0.329113924050633,399,6.01503759398496
"3372",2008,"Cornell",NA,NA,NA,93,162,95,58,0,106,0,56,53,109,42,0,141,36,105,121,44,77,19,0.204301075268817,415,10.1204819277108
"3373",2008,"Creighton",NA,NA,NA,100,202,104,71,0,144,0,69,50,119,59,0,176,52,124,155,57,98,27,0.27,510,11.5686274509804
"3374",2008,"Dartmouth",NA,NA,NA,275,505,329,201,0,281,1,139,160,299,160,0,503,179,324,278,88,190,63,0.229090909090909,1271,12.588512981904
"3375",2008,"Davidson",NA,NA,NA,191,388,189,124,0,277,0,173,172,345,141,0,222,81,141,282,104,178,37,0.193717277486911,980,14.3877551020408
"3376",2008,"Dayton",NA,NA,NA,174,453,200,127,0,241,0,146,106,252,82,0,416,144,272,285,84,201,43,0.247126436781609,1057,7.75780510879849
"3377",2008,"DePaul",NA,NA,NA,313,488,201,128,0,355,1,208,139,347,132,0,517,195,322,433,135,298,85,0.271565495207668,1395,9.46236559139785
"3378",2008,"Delaware",NA,NA,NA,45,74,47,24,0,53,0,30,30,60,27,0,97,24,73,19,5,14,9,0.2,189,14.2857142857143
"3379",2008,"Delaware State",NA,NA,NA,138,218,136,77,0,153,1,111,75,186,96,0,279,89,190,113,27,86,29,0.210144927536232,624,15.3846153846154
"3380",2008,"Denver",NA,NA,NA,180,424,194,122,0,287,0,175,139,314,149,0,349,112,237,314,120,194,43,0.238888888888889,1068,13.9513108614232
"3381",2008,"Detroit Mercy",NA,NA,NA,154,203,114,63,0,218,4,66,50,116,90,0,333,94,239,134,27,107,31,0.201298701298701,573,15.7068062827225
"3382",2008,"Drake",NA,NA,NA,248,486,284,183,1,270,0,198,123,321,148,0,483,173,310,300,84,216,61,0.245967741935484,1271,11.6443745082612
"3383",2008,"Drexel",NA,NA,NA,10,21,10,7,0,26,0,15,15,30,2,0,16,3,13,14,5,9,5,0.5,58,3.44827586206897
"3384",2008,"Duke",NA,NA,NA,363,538,313,184,0,441,2,331,255,586,51,0,481,164,317,319,82,237,91,0.25068870523416,1571,3.24633991088479
"3385",2008,"East Carolina",NA,NA,NA,278,515,304,175,0,330,1,200,167,367,132,0,523,171,352,284,93,191,60,0.215827338129496,1328,9.93975903614458
"3386",2008,"East Tennessee State",NA,NA,NA,145,221,135,90,0,192,0,119,102,221,88,0,231,75,156,141,48,93,29,0.2,648,13.5802469135802
"3387",2008,"Eastern Illinois",NA,NA,NA,34,120,49,41,0,78,0,32,26,58,28,0,98,26,72,58,18,40,4,0.117647058823529,246,11.3821138211382
"3388",2008,"Eastern Michigan",NA,NA,NA,196,349,199,124,0,256,1,155,125,280,139,0,357,118,239,226,81,145,39,0.198979591836735,955,14.5549738219895
"3389",2008,"Eastern Washington",NA,NA,NA,155,281,154,102,0,234,0,123,126,249,86,0,234,72,162,181,54,127,31,0.2,729,11.7969821673525
"3390",2008,"Elon",NA,NA,NA,50,95,39,23,0,55,1,40,18,58,31,0,117,44,73,46,13,33,16,0.32,251,12.3505976095618
"3391",2008,"Evansville",NA,NA,NA,135,173,99,62,0,142,0,81,81,162,72,0,157,54,103,172,48,124,31,0.22962962962963,509,14.1453831041257
"3392",2008,"Fairleigh Dickinson",NA,NA,NA,69,112,42,25,0,85,0,46,56,102,38,0,112,30,82,73,22,51,19,0.27536231884058,292,13.013698630137
"3393",2008,"Florida",NA,NA,NA,183,302,172,111,0,200,2,160,127,287,97,0,285,97,188,231,64,167,53,0.289617486338798,862,11.2529002320186
"3394",2008,"Florida A&M",NA,NA,NA,63,119,55,32,0,82,0,26,27,53,19,0,153,56,97,71,22,49,10,0.158730158730159,299,6.35451505016722
"3395",2008,"Florida Atlantic",NA,NA,NA,89,169,71,40,0,134,0,68,56,124,63,0,192,58,134,103,30,73,21,0.235955056179775,427,14.7540983606557
"3396",2008,"Florida Gulf Coast",NA,NA,NA,14,43,28,19,0,31,0,29,32,61,22,0,16,7,9,28,11,17,6,0.428571428571429,112,19.6428571428571
"3397",2008,"Florida International",NA,NA,NA,213,457,181,112,0,278,1,150,122,272,95,0,351,114,237,357,119,238,52,0.244131455399061,1099,8.6442220200182
"3398",2008,"Florida State",NA,NA,NA,292,570,330,197,0,381,1,220,167,387,143,0,578,197,381,346,113,233,75,0.256849315068493,1472,9.71467391304348
"3399",2008,"Fresno State",NA,NA,NA,90,147,79,48,0,92,0,51,53,104,39,0,107,40,67,133,45,88,14,0.155555555555556,393,9.9236641221374
"3400",2008,"Furman",NA,NA,NA,38,47,34,21,0,48,0,25,31,56,16,0,65,17,48,37,14,23,11,0.289473684210526,150,10.6666666666667
"3401",2008,"Gardner-Webb",NA,NA,NA,61,92,66,39,0,77,0,33,22,55,29,0,122,39,83,61,16,45,17,0.278688524590164,261,11.1111111111111
"3402",2008,"George Mason",NA,NA,NA,21,28,21,11,0,37,0,16,6,22,21,0,64,17,47,19,8,11,6,0.285714285714286,94,22.3404255319149
"3403",2008,"George Washington",NA,NA,NA,339,627,312,203,0,380,2,225,136,361,236,0,826,317,509,366,124,242,102,0.300884955752212,1720,13.7209302325581
"3404",2008,"Georgetown",NA,NA,NA,107,187,84,49,0,162,0,81,61,142,71,0,232,67,165,135,40,95,29,0.271028037383178,508,13.9763779527559
"3405",2008,"Georgia",NA,NA,NA,137,335,149,104,0,215,0,106,77,183,38,0,271,95,176,231,84,147,38,0.277372262773723,795,4.77987421383648
"3406",2008,"Georgia Southern",NA,NA,NA,93,128,83,44,0,102,0,64,53,117,57,0,141,42,99,91,29,62,28,0.301075268817204,380,15
"3407",2008,"Georgia State",NA,NA,NA,113,129,75,43,0,132,0,65,28,93,74,0,220,75,145,100,20,80,27,0.238938053097345,421,17.5771971496437
"3408",2008,"Gonzaga",NA,NA,NA,140,235,110,74,0,143,1,104,73,177,55,0,256,101,155,159,50,109,35,0.25,663,8.29562594268477
"3409",2008,"Grambling",NA,NA,NA,16,24,17,8,0,31,1,7,6,13,3,0,28,9,19,12,3,9,1,0.0625,64,4.6875
"3410",2008,"Green Bay",NA,NA,NA,99,295,139,103,0,178,0,166,92,258,118,0,229,85,144,155,65,90,31,0.313131313131313,756,15.6084656084656
"3411",2008,"Hampton",NA,NA,NA,164,224,154,86,0,160,0,89,80,169,75,0,263,87,176,114,35,79,39,0.23780487804878,638,11.7554858934169
"3412",2008,"Hartford",NA,NA,NA,158,268,143,87,0,167,1,111,79,190,78,0,299,96,203,197,61,136,38,0.240506329113924,730,10.6849315068493
"3413",2008,"Harvard",NA,NA,NA,132,254,101,66,0,189,0,111,75,186,70,0,241,94,147,142,55,87,41,0.310606060606061,675,10.3703703703704
"3414",2008,"Hawai'i",NA,NA,NA,182,362,195,120,0,233,1,101,39,140,106,0,443,161,282,163,52,111,44,0.241758241758242,907,11.6868798235943
"3415",2008,"High Point",NA,NA,NA,82,139,56,33,0,116,0,50,61,111,35,0,151,47,104,99,31,68,21,0.25609756097561,366,9.56284153005464
"3416",2008,"Hofstra",NA,NA,NA,43,79,47,31,0,87,0,31,19,50,28,0,106,31,75,61,26,35,15,0.348837209302326,220,12.7272727272727
"3417",2008,"Holy Cross",NA,NA,NA,140,263,136,87,0,154,0,98,120,218,81,0,181,43,138,202,63,139,34,0.242857142857143,642,12.6168224299065
"3418",2008,"Houston",NA,NA,NA,59,125,82,52,0,95,0,67,48,115,34,0,103,25,78,77,19,58,22,0.372881355932203,317,10.7255520504732
"3419",2008,"Howard",NA,NA,NA,48,62,44,22,0,57,0,42,28,70,32,0,88,23,65,59,13,46,14,0.291666666666667,201,15.9203980099502
"3420",2008,"IUPUI",NA,NA,NA,92,142,52,33,0,89,0,66,70,136,42,0,146,44,102,63,12,51,17,0.184782608695652,369,11.3821138211382
"3421",2008,"Idaho",NA,NA,NA,83,159,89,51,0,121,0,42,46,88,59,0,175,58,117,97,28,69,17,0.204819277108434,393,15.0127226463104
"3422",2008,"Idaho State",NA,NA,NA,66,146,62,51,0,80,1,43,45,88,21,0,136,45,91,115,40,75,16,0.242424242424242,358,5.8659217877095
"3423",2008,"Illinois",NA,NA,NA,213,523,256,185,0,283,0,140,81,221,151,0,608,226,382,345,114,231,59,0.276995305164319,1283,11.7692907248636
"3424",2008,"Illinois State",NA,NA,NA,79,204,84,63,0,137,0,96,52,148,36,0,161,53,108,123,39,84,23,0.291139240506329,502,7.17131474103586
"3425",2008,"Indiana",NA,NA,NA,115,204,119,74,0,161,3,72,65,137,59,0,261,93,168,137,46,91,26,0.226086956521739,566,10.4240282685512
"3426",2008,"Indiana State",NA,NA,NA,165,390,249,181,0,270,0,131,114,245,102,0,364,121,243,318,101,217,33,0.2,979,10.4187946884576
"3427",2008,"Iona",NA,NA,NA,236,390,244,156,0,281,1,178,167,345,137,0,313,112,201,257,96,161,66,0.279661016949153,1076,12.7323420074349
"3428",2008,"Iowa",NA,NA,NA,259,598,262,171,0,400,0,191,49,240,144,0,644,219,425,376,151,225,77,0.297297297297297,1483,9.71004720161834
"3429",2008,"Jackson State",NA,NA,NA,109,131,96,54,0,131,0,57,43,100,51,0,192,58,134,109,27,82,19,0.174311926605505,405,12.5925925925926
"3430",2008,"Jacksonville",NA,NA,NA,88,195,102,61,0,138,0,110,66,176,87,0,208,69,139,106,28,78,21,0.238636363636364,515,16.8932038834951
"3431",2008,"Jacksonville State",NA,NA,NA,21,19,14,10,0,17,0,6,12,18,7,0,32,8,24,21,7,14,5,0.238095238095238,66,10.6060606060606
"3432",2008,"James Madison",NA,NA,NA,192,279,172,107,0,198,0,116,77,193,71,0,298,118,180,155,40,115,48,0.25,792,8.96464646464646
"3433",2008,"Kansas",NA,NA,NA,189,420,172,112,0,300,0,158,99,257,95,0,450,159,291,189,55,134,47,0.248677248677249,1033,9.19651500484027
"3434",2008,"Kansas City",NA,NA,NA,90,185,89,55,0,139,0,58,66,124,40,0,148,47,101,111,36,75,29,0.322222222222222,444,9.00900900900901
"3435",2008,"Kansas State",NA,NA,NA,180,437,196,134,0,226,2,156,86,242,118,0,431,185,246,334,123,211,50,0.277777777777778,1141,10.34180543383
"3436",2008,"Kennesaw State",NA,NA,NA,69,102,52,34,0,82,0,41,24,65,38,0,120,29,91,67,19,48,14,0.202898550724638,275,13.8181818181818
"3437",2008,"Kent State",NA,NA,NA,192,395,259,155,0,228,0,144,132,276,131,0,361,124,237,204,65,139,39,0.203125,985,13.2994923857868
"3438",2008,"Kentucky",NA,NA,NA,183,365,236,136,0,233,0,127,85,212,56,0,380,101,279,159,50,109,29,0.158469945355191,886,6.32054176072235
"3439",2008,"LIU Brooklyn",NA,NA,NA,189,325,139,95,0,206,1,148,106,254,111,0,349,113,236,236,71,165,45,0.238095238095238,893,12.4300111982083
"3440",2008,"LSU",NA,NA,NA,188,516,248,138,0,246,0,210,138,348,53,0,460,170,290,257,92,165,50,0.265957446808511,1239,4.27764326069411
"3441",2008,"LSU Shreveport",NA,NA,NA,15,21,9,6,0,16,0,0,0,0,5,0,50,12,38,15,3,12,5,0.333333333333333,55,9.09090909090909
"3442",2008,"La Salle",NA,NA,NA,107,330,167,110,0,181,1,97,75,172,76,0,330,106,224,198,72,126,26,0.242990654205607,759,10.0131752305665
"3443",2008,"Lafayette",NA,NA,NA,145,338,195,122,0,270,0,154,113,267,122,0,302,86,216,200,59,141,40,0.275862068965517,833,14.6458583433373
"3444",2008,"Lamar",NA,NA,NA,17,29,18,10,0,28,0,15,20,35,6,0,16,3,13,16,1,15,3,0.176470588235294,72,8.33333333333333
"3445",2008,"Lehigh",NA,NA,NA,76,130,85,53,0,87,0,55,51,106,70,0,94,26,68,95,30,65,19,0.25,340,20.5882352941176
"3446",2008,"Liberty",NA,NA,NA,191,334,216,142,0,179,0,164,93,257,102,0,266,84,182,142,47,95,40,0.209424083769634,880,11.5909090909091
"3447",2008,"Lipscomb",NA,NA,NA,225,384,257,164,0,249,0,108,93,201,100,0,394,119,275,284,80,204,41,0.182222222222222,978,10.2249488752556
"3448",2008,"Little Rock",NA,NA,NA,56,108,44,25,0,81,0,29,21,50,34,0,154,58,96,70,16,54,17,0.303571428571429,283,12.0141342756184
"3449",2008,"Long Beach State",NA,NA,NA,30,76,30,18,0,54,0,31,16,47,20,0,55,14,41,47,16,31,5,0.166666666666667,176,11.3636363636364
"3450",2008,"Longwood",NA,NA,NA,150,242,130,79,0,188,1,104,101,205,88,0,216,55,161,140,45,95,36,0.24,626,14.0575079872204
"3451",2008,"Louisiana",NA,NA,NA,184,349,151,75,0,200,0,86,61,147,114,0,455,201,254,234,69,165,49,0.266304347826087,922,12.3644251626898
"3452",2008,"Louisiana Tech",NA,NA,NA,119,199,100,64,0,142,1,89,54,143,60,0,259,89,170,100,39,61,32,0.26890756302521,568,10.5633802816901
"3453",2008,"Louisville",NA,NA,NA,443,626,400,240,0,463,5,385,189,574,174,1,661,220,441,385,117,268,121,0.27313769751693,1906,9.12906610703043
"3454",2008,"Loyola Chicago",NA,NA,NA,53,159,72,49,0,126,1,59,28,87,35,0,139,51,88,92,34,58,13,0.245283018867925,381,9.18635170603675
"3455",2008,"Loyola Maryland",NA,NA,NA,225,412,263,173,0,269,1,163,141,304,111,0,395,126,269,228,62,166,56,0.248888888888889,1066,10.4127579737336
"3456",2008,"Loyola Marymount",NA,NA,NA,50,78,40,20,0,58,0,53,43,96,30,0,95,24,71,65,21,44,17,0.34,237,12.6582278481013
"3457",2008,"Lynn University",NA,NA,NA,12,22,16,9,0,18,0,9,10,19,8,0,26,10,16,12,4,8,3,0.25,61,13.1147540983607
"3458",2008,"Maine",NA,NA,NA,159,334,175,122,0,220,4,129,111,240,78,0,273,88,185,148,49,99,39,0.245283018867925,802,9.72568578553616
"3459",2008,"Manhattan",NA,NA,NA,33,61,29,19,0,50,0,35,20,55,16,0,55,21,34,49,24,25,10,0.303030303030303,185,8.64864864864865
"3460",2008,"Marist",NA,NA,NA,116,286,167,124,0,165,0,122,99,221,57,0,182,65,117,197,71,126,26,0.224137931034483,703,8.10810810810811
"3461",2008,"Marquette",NA,NA,NA,205,309,195,134,0,295,1,158,116,274,107,0,382,123,259,224,67,157,49,0.239024390243902,913,11.7196056955093
"3462",2008,"Marshall",NA,NA,NA,257,453,302,187,0,330,1,210,162,372,172,0,470,163,307,247,71,176,70,0.272373540856031,1232,13.961038961039
"3463",2008,"Maryland-Eastern Shore",NA,NA,NA,126,252,143,91,0,179,3,96,60,156,80,0,210,67,143,166,46,120,33,0.261904761904762,629,12.7186009538951
"3464",2008,"McNeese",NA,NA,NA,21,33,25,13,0,37,0,7,13,20,17,0,62,19,43,45,16,29,5,0.238095238095238,103,16.504854368932
"3465",2008,"Memphis",NA,NA,NA,69,143,55,32,0,80,0,40,53,93,43,0,156,55,101,92,35,57,18,0.260869565217391,357,12.0448179271709
"3466",2008,"Mercer",NA,NA,NA,64,145,73,51,0,106,1,40,43,83,52,0,204,59,145,79,28,51,14,0.21875,361,14.404432132964
"3467",2008,"Miami",NA,NA,NA,94,167,62,31,0,123,1,70,51,121,69,0,142,35,107,138,42,96,24,0.25531914893617,424,16.2735849056604
"3468",2008,"Miami (OH)",NA,NA,NA,118,169,100,70,0,136,0,74,58,132,82,0,181,54,127,178,56,122,30,0.254237288135593,504,16.2698412698413
"3469",2008,"Michigan",NA,NA,NA,111,320,137,88,0,200,1,119,92,211,65,0,223,72,151,226,66,160,25,0.225225225225225,724,8.97790055248619
"3470",2008,"Michigan State",NA,NA,NA,277,558,273,179,0,342,1,266,230,496,161,0,417,149,268,335,93,242,66,0.23826714801444,1410,11.4184397163121
"3471",2008,"Middle Tennessee",NA,NA,NA,128,175,98,66,0,176,0,95,67,162,111,0,218,77,141,260,87,173,35,0.2734375,591,18.7817258883249
"3472",2008,"Milwaukee",NA,NA,NA,257,555,326,200,0,352,0,201,186,387,154,0,381,142,239,395,147,248,60,0.233463035019455,1368,11.2573099415205
"3473",2008,"Minnesota",NA,NA,NA,123,224,150,97,0,171,0,90,48,138,54,0,298,105,193,95,31,64,26,0.211382113821138,616,8.76623376623377
"3474",2008,"Mississippi State",NA,NA,NA,139,230,116,72,0,172,4,54,54,108,68,0,351,117,234,164,42,122,35,0.251798561151079,616,11.038961038961
"3475",2008,"Mississippi Valley State",NA,NA,NA,48,71,31,17,0,62,0,19,11,30,18,0,118,39,79,32,9,23,17,0.354166666666667,192,9.375
"3476",2008,"Missouri",NA,NA,NA,218,464,214,127,0,287,0,125,93,218,165,0,524,154,370,354,134,220,53,0.243119266055046,1147,14.3853530950305
"3477",2008,"Missouri State",NA,NA,NA,84,121,71,44,0,107,0,51,65,116,28,0,111,32,79,102,26,76,18,0.214285714285714,332,8.43373493975904
"3478",2008,"Monmouth",NA,NA,NA,57,124,61,38,0,88,1,74,72,146,38,0,80,30,50,45,13,32,18,0.31578947368421,321,11.8380062305296
"3479",2008,"Montana",NA,NA,NA,241,528,291,209,0,264,2,88,38,126,136,0,673,284,389,311,122,189,75,0.311203319502075,1355,10.0369003690037
"3480",2008,"Montana State",NA,NA,NA,138,262,164,114,0,220,0,114,76,190,107,0,360,149,211,173,51,122,39,0.282608695652174,771,13.8780804150454
"3481",2008,"Montana-Western",NA,NA,NA,12,21,9,4,0,18,0,0,0,0,6,0,31,11,20,22,3,19,1,0.0833333333333333,48,12.5
"3482",2008,"Morehead State",NA,NA,NA,75,191,100,61,0,133,0,54,70,124,48,0,123,40,83,173,50,123,13,0.173333333333333,428,11.214953271028
"3483",2008,"Morgan State",NA,NA,NA,45,75,35,22,0,60,0,36,38,74,36,0,55,21,34,57,16,41,8,0.177777777777778,201,17.910447761194
"3484",2008,"Mount St. Mary's",NA,NA,NA,76,144,60,35,0,79,1,56,56,112,40,0,88,23,65,125,35,90,19,0.25,347,11.5273775216138
"3485",2008,"Murray State",NA,NA,NA,39,101,50,35,0,68,0,22,22,44,23,0,110,47,63,74,28,46,6,0.153846153846154,251,9.16334661354582
"3486",2008,"NC State",NA,NA,NA,306,581,304,189,0,365,1,190,131,321,169,0,704,257,447,289,88,201,66,0.215686274509804,1502,11.2516644474035
"3487",2008,"NJIT",NA,NA,NA,36,57,44,26,0,42,0,27,22,49,36,0,68,15,53,47,19,28,9,0.25,166,21.6867469879518
"3488",2008,"Navy",NA,NA,NA,219,434,218,128,0,304,0,125,104,229,127,0,434,138,296,255,79,176,43,0.19634703196347,1049,12.1067683508103
"3489",2008,"Nebraska",NA,NA,NA,282,581,353,216,0,354,0,202,61,263,161,0,731,271,460,278,92,186,85,0.301418439716312,1515,10.6270627062706
"3490",2008,"Nevada",NA,NA,NA,220,324,240,152,0,277,1,131,90,221,216,0,509,190,319,245,77,168,69,0.313636363636364,1004,21.5139442231076
"3491",2008,"New Hampshire",NA,NA,NA,90,163,71,46,0,114,0,45,29,74,49,0,187,51,136,128,28,100,22,0.244444444444444,395,12.4050632911392
"3492",2008,"New Mexico",NA,NA,NA,121,214,118,75,0,145,1,47,27,74,31,0,259,81,178,136,46,90,26,0.214876033057851,539,5.75139146567718
"3493",2008,"New Mexico State",NA,NA,NA,164,335,198,133,0,216,2,96,74,170,100,0,407,156,251,137,50,87,40,0.24390243902439,848,11.7924528301887
"3494",2008,"New Orleans",NA,NA,NA,82,140,76,38,0,112,0,69,53,122,41,0,144,43,101,70,14,56,16,0.195121951219512,362,11.3259668508287
"3495",2008,"Niagara",NA,NA,NA,60,130,49,25,0,96,1,41,38,79,31,0,124,36,88,92,30,62,11,0.183333333333333,310,10
"3496",2008,"Nicholls",NA,NA,NA,18,49,32,20,0,27,0,10,11,21,11,0,65,27,38,21,7,14,2,0.111111111111111,118,9.32203389830508
"3497",2008,"Norfolk State",NA,NA,NA,126,179,110,63,0,154,4,85,95,180,82,0,213,65,148,123,37,86,33,0.261904761904762,508,16.1417322834646
"3498",2008,"North Carolina",NA,NA,NA,343,509,392,248,0,305,1,301,201,502,36,0,507,197,310,220,64,156,109,0.317784256559767,1524,2.36220472440945
"3499",2008,"North Carolina A&T",NA,NA,NA,155,202,142,87,0,155,0,141,99,240,95,0,246,82,164,141,46,95,38,0.245161290322581,666,14.2642642642643
"3500",2008,"North Carolina Central",NA,NA,NA,24,42,20,12,0,20,0,18,14,32,23,0,46,11,35,20,5,15,5,0.208333333333333,104,22.1153846153846
"3501",2008,"North Dakota State",NA,NA,NA,107,267,142,91,0,142,0,88,51,139,81,0,253,102,151,171,62,109,29,0.271028037383178,666,12.1621621621622
"3502",2008,"North Florida",NA,NA,NA,38,74,28,19,0,53,0,17,16,33,18,0,87,24,63,51,21,30,6,0.157894736842105,180,10
"3503",2008,"North Texas",NA,NA,NA,64,134,61,40,0,80,0,46,33,79,33,0,175,63,112,54,14,40,17,0.265625,336,9.82142857142857
"3504",2008,"Northeastern",NA,NA,NA,44,76,23,17,0,57,0,30,24,54,25,0,91,40,51,80,24,56,6,0.136363636363636,219,11.4155251141553
"3505",2008,"Northern Arizona",NA,NA,NA,105,146,87,53,0,130,0,39,40,79,52,2,244,85,159,106,36,70,33,0.314285714285714,436,11.9266055045872
"3506",2008,"Northern Colorado",NA,NA,NA,75,150,90,62,0,111,3,36,34,70,50,0,160,59,101,134,47,87,20,0.266666666666667,379,13.1926121372032
"3507",2008,"Northern Illinois",NA,NA,NA,64,100,42,27,0,89,0,46,30,76,34,0,134,38,96,77,30,47,17,0.265625,289,11.7647058823529
"3508",2008,"Northern Iowa",NA,NA,NA,120,277,121,74,0,188,0,73,54,127,50,0,275,92,183,220,77,143,29,0.241666666666667,667,7.49625187406297
"3509",2008,"Northwestern",NA,NA,NA,81,182,56,36,0,111,0,43,48,91,45,0,258,77,181,91,20,71,15,0.185185185185185,417,10.7913669064748
"3510",2008,"Northwestern State",NA,NA,NA,9,24,16,8,0,24,1,8,7,15,7,0,22,7,15,17,8,9,6,0.666666666666667,59,11.864406779661
"3511",2008,"Notre Dame",NA,NA,NA,406,658,409,285,0,457,2,379,284,663,225,0,781,313,468,242,73,169,102,0.251231527093596,1942,11.5859938208033
"3512",2008,"Oakland",NA,NA,NA,46,117,50,28,0,69,0,60,48,108,35,0,79,25,54,47,17,30,12,0.260869565217391,280,12.5
"3513",2008,"Oakland City",NA,NA,NA,6,19,14,9,0,19,0,8,6,14,7,0,11,1,10,16,5,11,2,0.333333333333333,41,17.0731707317073
"3514",2008,"Ohio",NA,NA,NA,174,320,154,100,0,223,0,145,103,248,76,0,259,84,175,219,90,129,43,0.247126436781609,854,8.89929742388759
"3515",2008,"Ohio State",NA,NA,NA,236,508,198,123,0,269,0,247,145,392,98,0,518,194,324,275,101,174,67,0.283898305084746,1343,7.29709605361132
"3516",2008,"Oklahoma",NA,NA,NA,470,768,332,200,0,501,1,408,236,644,207,0,802,305,497,377,105,272,147,0.312765957446809,2141,9.66837926202709
"3517",2008,"Oklahoma State",NA,NA,NA,380,703,416,265,0,421,2,339,246,585,197,0,549,196,353,461,147,314,102,0.268421052631579,1881,10.4731525784157
"3518",2008,"Old Dominion",NA,NA,NA,185,260,184,103,0,207,2,134,84,218,33,0,293,100,193,173,57,116,46,0.248648648648649,785,4.20382165605096
"3519",2008,"Ole Miss",NA,NA,NA,117,184,96,58,0,146,1,59,45,104,62,0,299,81,218,101,20,81,22,0.188034188034188,488,12.7049180327869
"3520",2008,"Oregon",NA,NA,NA,124,240,100,68,0,185,0,71,75,146,42,0,200,60,140,181,51,130,17,0.137096774193548,572,7.34265734265734
"3521",2008,"Oregon State",NA,NA,NA,9,20,18,12,0,18,0,8,1,9,8,0,25,9,16,16,6,10,5,0.555555555555556,58,13.7931034482759
"3522",2008,"Pacific",NA,NA,NA,90,187,122,76,0,144,0,72,61,133,58,0,119,44,75,137,46,91,18,0.2,472,12.2881355932203
"3523",2008,"Palm Beach Atlantic University",NA,NA,NA,4,35,17,9,0,12,0,7,6,13,2,0,28,8,20,8,1,7,0,0,59,3.38983050847458
"3524",2008,"Penn State",NA,NA,NA,191,368,215,151,0,292,0,180,152,332,87,0,380,125,255,224,66,158,51,0.267015706806283,983,8.85045778229908
"3525",2008,"Pennsylvania",NA,NA,NA,111,243,95,60,0,185,1,77,42,119,63,0,251,89,162,181,65,116,17,0.153153153153153,612,10.2941176470588
"3526",2008,"Pepperdine",NA,NA,NA,78,143,52,35,0,109,0,62,54,116,38,0,152,54,98,85,23,62,22,0.282051282051282,378,10.0529100529101
"3527",2008,"Pittsburgh",NA,NA,NA,412,659,431,261,0,471,3,295,196,491,134,1,790,269,521,294,93,201,116,0.281553398058252,1843,7.27075420510038
"3528",2008,"Portland",NA,NA,NA,89,174,65,52,0,121,2,93,83,176,58,0,172,54,118,78,28,50,23,0.258426966292135,457,12.691466083151
"3529",2008,"Portland State",NA,NA,NA,106,223,129,82,0,155,1,62,37,99,81,0,291,132,159,160,62,98,31,0.292452830188679,618,13.1067961165049
"3530",2008,"Prairie View A&M",NA,NA,NA,24,45,26,13,0,45,0,20,13,33,8,0,47,15,32,18,8,10,5,0.208333333333333,114,7.01754385964912
"3531",2008,"Presbyterian",NA,NA,NA,67,130,63,42,0,105,0,30,49,79,51,0,158,35,123,93,21,72,10,0.149253731343284,300,17
"3532",2008,"Princeton",NA,NA,NA,70,154,97,55,0,126,0,51,51,102,47,0,178,68,110,123,37,86,17,0.242857142857143,408,11.5196078431373
"3533",2008,"Providence",NA,NA,NA,114,209,116,65,0,189,1,99,62,161,56,0,250,86,164,147,47,100,33,0.289473684210526,589,9.50764006791171
"3534",2008,"Purdue",NA,NA,NA,272,517,314,196,0,338,2,123,131,254,140,0,729,276,453,259,83,176,53,0.194852941176471,1364,10.2639296187683
"3535",2008,"Purdue Fort Wayne",NA,NA,NA,75,136,68,48,0,137,0,47,46,93,44,0,134,42,92,168,42,126,16,0.213333333333333,359,12.2562674094708
"3536",2008,"Quinnipiac",NA,NA,NA,158,300,109,73,0,165,1,109,74,183,71,0,324,119,205,156,64,92,46,0.291139240506329,779,9.11424903722721
"3537",2008,"Radford",NA,NA,NA,169,293,209,133,0,221,0,104,96,200,125,0,298,92,206,195,66,129,30,0.177514792899408,783,15.9642401021711
"3538",2008,"Rhode Island",NA,NA,NA,272,444,215,138,0,354,0,146,120,266,217,0,654,229,425,322,105,217,64,0.235294117647059,1252,17.332268370607
"3539",2008,"Rice",NA,NA,NA,153,328,163,105,0,206,1,82,74,156,86,0,350,108,242,175,50,125,31,0.202614379084967,756,11.3756613756614
"3540",2008,"Richmond",NA,NA,NA,222,378,196,120,0,269,0,173,138,311,131,0,346,112,234,244,88,156,55,0.247747747747748,1040,12.5961538461538
"3541",2008,"Rider",NA,NA,NA,81,148,55,38,0,114,0,48,61,109,31,0,139,38,101,120,38,82,18,0.222222222222222,365,8.49315068493151
"3542",2008,"Robert Morris",NA,NA,NA,135,208,115,72,0,114,1,83,55,138,64,0,276,78,198,116,43,73,38,0.281481481481481,576,11.1111111111111
"3543",2008,"Robert Morris Col.",NA,NA,NA,22,21,12,7,0,19,0,14,25,39,6,0,15,2,13,16,8,8,4,0.181818181818182,71,8.45070422535211
"3544",2008,"Rutgers",NA,NA,NA,334,655,299,176,0,406,0,252,159,411,103,0,677,271,406,385,130,255,101,0.302395209580838,1725,5.97101449275362
"3545",2008,"SE Louisiana",NA,NA,NA,13,24,12,4,0,21,0,12,9,21,2,0,25,10,15,17,6,11,2,0.153846153846154,66,3.03030303030303
"3546",2008,"SMU",NA,NA,NA,110,225,149,104,0,144,0,99,88,187,77,0,222,76,146,140,35,105,30,0.272727272727273,590,13.0508474576271
"3547",2008,"Sacramento State",NA,NA,NA,58,132,65,41,0,119,0,19,18,37,33,0,154,57,97,131,39,92,12,0.206896551724138,321,10.2803738317757
"3548",2008,"Sacred Heart",NA,NA,NA,179,384,238,158,0,235,0,182,135,317,128,0,301,94,207,279,101,178,47,0.262569832402235,1019,12.5613346418057
"3549",2008,"Saint Joseph's",NA,NA,NA,158,340,126,81,0,213,2,154,123,277,96,0,270,85,185,237,78,159,38,0.240506329113924,846,11.3475177304965
"3550",2008,"Saint Mary's",NA,NA,NA,89,151,89,57,0,114,1,76,85,161,40,0,130,38,92,89,34,55,25,0.280898876404494,415,9.63855421686747
"3551",2008,"Saint Peter's",NA,NA,NA,80,151,118,73,0,174,0,66,82,148,54,0,174,58,116,96,24,72,22,0.275,420,12.8571428571429
"3552",2008,"Sam Houston",NA,NA,NA,28,36,22,12,0,44,0,15,11,26,20,0,70,27,43,33,12,21,8,0.285714285714286,121,16.5289256198347
"3553",2008,"Samford",NA,NA,NA,28,128,60,40,0,61,0,45,38,83,37,0,70,22,48,98,37,61,9,0.321428571428571,273,13.5531135531136
"3554",2008,"San Diego",NA,NA,NA,50,133,54,41,0,70,0,67,63,130,17,0,110,38,72,37,18,19,14,0.28,325,5.23076923076923
"3555",2008,"San Diego State",NA,NA,NA,177,247,166,103,0,254,1,119,63,182,138,0,393,124,269,177,56,121,40,0.225988700564972,767,17.9921773142112
"3556",2008,"San Francisco",NA,NA,NA,26,41,17,12,0,30,0,18,22,40,13,0,44,18,26,25,10,15,3,0.115384615384615,119,10.9243697478992
"3557",2008,"San José State",NA,NA,NA,160,251,148,80,0,237,4,125,110,235,114,0,305,85,220,160,50,110,30,0.1875,700,16.2857142857143
"3558",2008,"Santa Clara",NA,NA,NA,18,54,16,11,0,44,0,21,22,43,21,0,27,6,21,35,14,21,5,0.277777777777778,120,17.5
"3559",2008,"Savannah State",NA,NA,NA,34,81,43,33,0,66,0,34,28,62,28,0,104,37,67,30,9,21,5,0.147058823529412,210,13.3333333333333
"3560",2008,"Seton Hall",NA,NA,NA,121,198,101,60,0,169,0,64,57,121,39,0,262,90,172,107,37,70,26,0.214876033057851,535,7.28971962616822
"3561",2008,"Siena",NA,NA,NA,80,183,124,80,0,144,0,103,69,172,47,0,148,57,91,106,35,71,20,0.25,492,9.55284552845528
"3562",2008,"South Alabama",NA,NA,NA,159,353,167,96,0,198,0,132,122,254,98,0,289,92,197,246,75,171,31,0.19496855345912,863,11.3557358053302
"3563",2008,"South Carolina",NA,NA,NA,78,190,128,79,0,164,0,82,57,139,55,0,168,54,114,97,36,61,14,0.17948717948718,479,11.482254697286
"3564",2008,"South Carolina State",NA,NA,NA,71,146,88,52,0,73,0,67,54,121,19,0,90,27,63,63,20,43,10,0.140845070422535,354,5.36723163841808
"3565",2008,"South Carolina Upstate",NA,NA,NA,117,204,108,72,0,123,0,79,96,175,65,0,211,65,146,146,37,109,29,0.247863247863248,538,12.0817843866171
"3566",2008,"South Dakota State",NA,NA,NA,61,112,62,37,0,89,0,49,29,78,47,0,83,24,59,128,36,92,12,0.19672131147541,297,15.8249158249158
"3567",2008,"South Florida",NA,NA,NA,278,455,304,175,0,320,2,225,237,462,124,0,316,78,238,323,111,212,42,0.151079136690647,1222,10.1472995090016
"3568",2008,"Southeast Missouri State",NA,NA,NA,45,86,51,30,0,66,1,29,29,58,33,0,96,22,74,82,24,58,7,0.155555555555556,223,14.7982062780269
"3569",2008,"Southern",NA,NA,NA,52,95,51,30,0,86,0,35,36,71,39,0,93,25,68,52,13,39,12,0.230769230769231,234,16.6666666666667
"3570",2008,"Southern Illinois",NA,NA,NA,71,141,69,40,0,131,0,44,33,77,43,0,177,64,113,110,36,74,19,0.267605633802817,373,11.5281501340483
"3571",2008,"Southern Miss",NA,NA,NA,245,589,282,188,0,381,1,180,92,272,168,0,700,326,374,289,109,180,73,0.297959183673469,1519,11.0599078341014
"3572",2008,"Southern Utah",NA,NA,NA,34,90,28,16,0,63,0,16,23,39,13,0,112,35,77,60,13,47,6,0.176470588235294,194,6.70103092783505
"3573",2008,"St. Bonaventure",NA,NA,NA,112,226,118,71,0,154,0,74,78,152,54,0,236,72,164,147,57,90,20,0.178571428571429,573,9.42408376963351
"3574",2008,"St. Francis (PA)",NA,NA,NA,66,118,58,34,0,97,0,41,30,71,44,0,158,57,101,76,21,55,14,0.212121212121212,318,13.8364779874214
"3575",2008,"St. Francis Brooklyn",NA,NA,NA,80,154,83,52,0,108,0,56,89,145,42,0,91,24,67,119,46,73,16,0.2,386,10.880829015544
"3576",2008,"St. John's",NA,NA,NA,135,209,124,78,0,174,0,93,91,184,64,0,234,60,174,159,48,111,38,0.281481481481481,572,11.1888111888112
"3577",2008,"Stanislaus State",NA,NA,NA,7,19,6,4,0,19,0,9,6,15,9,0,22,4,18,11,5,6,1,0.142857142857143,46,19.5652173913043
"3578",2008,"Stephen F. Austin",NA,NA,NA,70,137,69,42,0,83,0,56,46,102,38,0,151,44,107,66,20,46,19,0.271428571428571,342,11.1111111111111
"3579",2008,"Stetson",NA,NA,NA,60,98,36,24,0,79,0,29,34,63,33,0,119,33,86,53,13,40,16,0.266666666666667,243,13.5802469135802
"3580",2008,"Stony Brook",NA,NA,NA,283,438,292,168,0,371,3,160,123,283,182,0,609,182,427,169,43,126,55,0.19434628975265,1184,15.3716216216216
"3581",2008,"Syracuse",NA,NA,NA,327,548,358,236,0,299,2,236,175,411,153,0,518,157,361,260,91,169,66,0.201834862385321,1463,10.457963089542
"3582",2008,"TCU",NA,NA,NA,301,482,325,201,0,335,1,287,184,471,203,0,405,117,288,329,114,215,72,0.239202657807309,1392,14.5833333333333
"3583",2008,"TX Woman's Univ",NA,NA,NA,9,18,10,8,0,15,0,7,0,7,6,0,35,8,27,11,5,6,0,0,49,12.2448979591837
"3584",2008,"Temple",NA,NA,NA,138,177,118,63,0,141,0,74,81,155,51,0,220,63,157,110,37,73,31,0.22463768115942,519,9.82658959537572
"3585",2008,"Tennessee",NA,NA,NA,465,828,452,280,0,490,1,399,249,648,27,0,783,284,499,528,201,327,129,0.27741935483871,2301,1.17340286831812
"3586",2008,"Tennessee State",NA,NA,NA,34,76,39,27,0,62,1,37,29,66,16,0,65,27,38,30,12,18,12,0.352941176470588,200,8
"3587",2008,"Tennessee Tech",NA,NA,NA,24,41,29,19,0,38,0,15,20,35,5,0,41,16,25,35,11,24,6,0.25,116,4.31034482758621
"3588",2008,"Texas",NA,NA,NA,262,429,235,155,0,355,2,167,153,320,104,0,529,189,340,271,81,190,61,0.232824427480916,1204,8.63787375415282
"3589",2008,"Texas A&M",NA,NA,NA,453,645,386,240,0,554,1,268,207,475,234,0,919,345,574,393,136,257,98,0.216335540838852,1947,12.0184899845917
"3590",2008,"Texas A&M-Corpus Christi",NA,NA,NA,52,88,50,28,0,67,0,18,10,28,24,0,127,39,88,75,16,59,13,0.25,221,10.8597285067873
"3591",2008,"Texas Southern",NA,NA,NA,12,35,6,4,0,30,1,7,9,16,10,0,43,12,31,19,4,15,2,0.166666666666667,72,13.8888888888889
"3592",2008,"Texas State",NA,NA,NA,49,92,36,20,0,60,0,23,9,32,16,0,122,42,80,53,14,39,10,0.204081632653061,236,6.77966101694915
"3593",2008,"Texas Tech",NA,NA,NA,138,236,139,83,0,187,3,58,37,95,57,0,297,100,197,150,37,113,25,0.181159420289855,603,9.45273631840796
"3594",2008,"Toledo",NA,NA,NA,211,362,177,105,0,203,2,138,114,252,125,0,353,116,237,266,81,185,44,0.208530805687204,956,13.0753138075314
"3595",2008,"Towson",NA,NA,NA,52,55,41,29,0,53,0,32,21,53,42,0,98,26,72,35,11,24,12,0.230769230769231,184,22.8260869565217
"3596",2008,"Troy",NA,NA,NA,102,237,101,62,0,173,0,76,65,141,57,0,213,72,141,159,54,105,26,0.254901960784314,567,10.0529100529101
"3597",2008,"Tulane",NA,NA,NA,99,150,84,57,0,119,0,59,53,112,70,0,195,66,129,113,32,81,17,0.171717171717172,428,16.3551401869159
"3598",2008,"UC Davis",NA,NA,NA,127,298,181,128,0,228,0,144,126,270,157,0,185,71,114,228,71,157,29,0.228346456692913,760,20.6578947368421
"3599",2008,"UC Irvine",NA,NA,NA,73,138,97,56,0,108,1,59,50,109,49,0,164,47,117,74,24,50,14,0.191780821917808,368,13.3152173913043
"3600",2008,"UC Riverside",NA,NA,NA,58,116,71,49,0,95,1,26,21,47,35,0,134,39,95,84,25,59,8,0.137931034482759,287,12.1951219512195
"3601",2008,"UC Santa Barbara",NA,NA,NA,188,261,179,114,0,237,4,140,102,242,101,0,297,102,195,181,51,130,50,0.265957446808511,785,12.8662420382166
"3602",2008,"UCF",NA,NA,NA,290,455,278,169,0,343,1,248,190,438,167,0,466,164,302,243,60,183,71,0.244827586206897,1291,12.9357087529047
"3603",2008,"UCLA",NA,NA,NA,92,178,77,42,0,110,0,76,62,138,28,0,199,66,133,68,24,44,27,0.293478260869565,456,6.14035087719298
"3604",2008,"UConn",NA,NA,NA,518,1030,433,267,0,475,3,592,315,907,14,0,690,282,408,611,216,395,193,0.372586872586873,2755,0.508166969147005
"3605",2008,"UIC",NA,NA,NA,100,255,93,51,0,158,0,72,51,123,71,0,332,112,220,123,31,92,22,0.22,591,12.0135363790186
"3606",2008,"UL Monroe",NA,NA,NA,52,55,29,20,0,55,0,10,7,17,19,0,130,45,85,43,12,31,11,0.211538461538462,184,10.3260869565217
"3607",2008,"UMBC",NA,NA,NA,101,297,121,79,0,175,3,103,90,193,84,0,204,71,133,285,104,181,25,0.247524752475248,709,11.8476727785614
"3608",2008,"UMass",NA,NA,NA,177,449,200,134,0,252,0,239,192,431,140,0,342,138,204,205,64,141,43,0.242937853107345,1127,12.4223602484472
"3609",2008,"UNC Asheville",NA,NA,NA,103,185,100,58,0,122,2,62,67,129,35,0,149,34,115,121,35,86,18,0.174757281553398,439,7.97266514806378
"3610",2008,"UNC Greensboro",NA,NA,NA,162,269,149,83,0,198,0,99,105,204,110,0,281,83,198,142,45,97,37,0.228395061728395,688,15.9883720930233
"3611",2008,"UNC Wilmington",NA,NA,NA,166,317,227,143,0,239,0,127,67,194,141,0,372,133,239,126,44,82,38,0.228915662650602,841,16.7657550535077
"3612",2008,"UNLV",NA,NA,NA,146,198,167,96,0,204,0,90,57,147,69,0,267,64,203,141,38,103,29,0.198630136986301,571,12.0840630472855
"3613",2008,"USC",NA,NA,NA,49,65,36,23,0,55,0,21,10,31,14,0,97,22,75,67,18,49,6,0.122448979591837,183,7.65027322404372
"3614",2008,"UT Arlington",NA,NA,NA,64,103,54,34,0,74,1,22,25,47,17,0,136,49,87,42,9,33,16,0.25,261,6.51340996168582
"3615",2008,"UT Martin",NA,NA,NA,67,140,33,23,0,76,0,24,26,50,39,0,180,61,119,92,24,68,14,0.208955223880597,326,11.9631901840491
"3616",2008,"UT Rio Grande Valley",NA,NA,NA,31,55,22,14,0,49,0,12,7,19,23,0,97,32,65,43,13,30,5,0.161290322580645,149,15.4362416107383
"3617",2008,"UTEP",NA,NA,NA,180,317,155,99,0,221,1,178,113,291,117,0,338,123,215,255,86,169,47,0.261111111111111,929,12.5941872981701
"3618",2008,"UTSA",NA,NA,NA,71,91,77,45,0,80,0,24,55,79,36,0,95,24,71,75,23,52,11,0.154929577464789,254,14.1732283464567
"3619",2008,"Utah State",NA,NA,NA,172,273,150,100,0,183,1,124,154,278,119,0,289,89,200,190,58,132,31,0.180232558139535,762,15.6167979002625
"3620",2008,"Utah Valley",NA,NA,NA,165,373,159,113,0,227,0,160,88,248,94,0,346,148,198,254,99,155,48,0.290909090909091,989,9.50455005055612
"3621",2008,"VCU",NA,NA,NA,83,131,99,65,0,100,1,34,19,53,60,0,219,84,135,74,27,47,20,0.240963855421687,388,15.4639175257732
"3622",2008,"Valparaiso",NA,NA,NA,79,233,93,58,0,184,1,67,65,132,80,0,208,75,133,206,81,125,12,0.151898734177215,560,14.2857142857143
"3623",2008,"Vanderbilt",NA,NA,NA,303,613,336,205,0,473,2,390,263,653,181,0,367,127,240,439,161,278,86,0.283828382838284,1696,10.6721698113208
"3624",2008,"Vermont",NA,NA,NA,297,610,279,180,0,355,2,269,228,497,194,0,533,195,338,342,116,226,57,0.191919191919192,1563,12.4120281509917
"3625",2008,"Villanova",NA,NA,NA,157,487,151,105,0,340,0,162,131,293,122,0,254,89,165,578,218,360,45,0.286624203821656,1160,10.5172413793103
"3626",2008,"Virginia Tech",NA,NA,NA,254,448,217,147,0,281,0,234,183,417,159,0,500,168,332,212,53,159,63,0.248031496062992,1227,12.958435207824
"3627",2008,"Wagner",NA,NA,NA,96,187,116,70,0,154,0,84,91,175,78,0,171,45,126,110,30,80,20,0.208333333333333,469,16.6311300639659
"3628",2008,"Wake Forest",NA,NA,NA,242,486,171,96,0,275,1,130,130,260,152,0,507,165,342,293,100,193,61,0.252066115702479,1172,12.9692832764505
"3629",2008,"Washington",NA,NA,NA,77,168,69,40,0,89,0,70,49,119,15,0,158,49,109,91,26,65,22,0.285714285714286,409,3.66748166259169
"3630",2008,"Washington State",NA,NA,NA,50,88,42,22,0,73,0,19,17,36,12,0,98,31,67,89,26,63,10,0.2,221,5.42986425339367
"3631",2008,"Weber State",NA,NA,NA,99,178,89,59,0,126,1,69,69,138,46,0,225,69,156,112,41,71,19,0.191919191919192,477,9.64360587002096
"3632",2008,"West Virginia",NA,NA,NA,289,589,269,170,0,409,1,261,151,412,189,0,508,181,327,452,175,277,86,0.29757785467128,1570,12.0382165605096
"3633",2008,"Western Carolina",NA,NA,NA,47,84,46,25,0,50,0,35,31,66,22,0,86,25,61,31,10,21,10,0.212765957446809,209,10.5263157894737
"3634",2008,"Western Colorado",NA,NA,NA,16,20,16,9,0,15,0,17,10,27,7,0,20,4,16,15,4,11,5,0.3125,63,11.1111111111111
"3635",2008,"Western Illinois",NA,NA,NA,185,279,155,107,0,202,0,119,147,266,113,0,299,100,199,203,65,138,40,0.216216216216216,802,14.0897755610973
"3636",2008,"Western Kentucky",NA,NA,NA,353,634,404,268,0,395,0,345,170,515,182,0,585,207,378,278,86,192,107,0.303116147308782,1758,10.3526734926052
"3637",2008,"Western Michigan",NA,NA,NA,198,414,303,204,0,234,1,189,73,262,160,0,427,116,311,223,80,143,42,0.212121212121212,1081,14.8011100832562
"3638",2008,"Westminster (UT)",NA,NA,NA,3,19,8,4,0,13,0,5,0,5,9,0,27,6,21,19,3,16,1,0.333333333333333,39,23.0769230769231
"3639",2008,"Wichita State",NA,NA,NA,166,355,155,95,0,257,0,151,132,283,83,0,307,91,216,154,44,110,43,0.259036144578313,848,9.7877358490566
"3640",2008,"William & Mary",NA,NA,NA,23,42,29,18,0,24,1,16,10,26,28,0,53,22,31,28,13,15,8,0.347826086956522,122,22.9508196721311
"3641",2008,"Winston Salem",NA,NA,NA,25,53,25,16,0,29,0,13,17,30,12,0,49,11,38,33,9,24,6,0.24,117,10.2564102564103
"3642",2008,"Winthrop",NA,NA,NA,63,155,72,42,0,107,0,64,39,103,31,0,127,39,88,88,24,64,16,0.253968253968254,360,8.61111111111111
"3643",2008,"Wisconsin",NA,NA,NA,326,491,306,198,0,399,1,249,197,446,169,0,610,213,397,291,104,187,111,0.340490797546012,1468,11.5122615803815
"3644",2008,"Wofford",NA,NA,NA,43,82,51,26,0,49,0,34,33,67,26,0,61,22,39,48,11,37,15,0.348837209302326,199,13.0653266331658
"3645",2008,"Wright State",NA,NA,NA,187,400,232,142,0,340,0,184,117,301,182,0,353,126,227,260,96,164,34,0.181818181818182,1045,17.4162679425837
"3646",2008,"Wyoming",NA,NA,NA,218,487,265,175,0,292,0,207,40,247,134,0,385,89,296,435,159,276,52,0.238532110091743,1237,10.8326596604689
"3647",2008,"Xavier",NA,NA,NA,275,579,271,158,0,265,1,216,135,351,100,0,436,152,284,328,105,223,84,0.305454545454545,1402,7.13266761768902
"3648",2008,"Yale",NA,NA,NA,150,292,172,109,0,276,0,163,142,305,96,0,176,49,127,217,65,152,37,0.246666666666667,764,12.565445026178
"3649",2008,"Youngstown State",NA,NA,NA,239,457,240,162,0,320,1,91,83,174,121,0,586,217,369,344,113,231,51,0.213389121338912,1173,10.3154305200341
"3650",2009,"Air Force",NA,NA,NA,17,32,13,11,0,15,0,10,7,17,9,0,27,7,20,17,7,10,4,0.235294117647059,76,11.8421052631579
"3651",2009,"Akron",NA,NA,NA,57,106,51,32,0,80,0,41,51,92,37,0,70,25,45,97,19,78,13,0.228070175438596,259,14.2857142857143
"3652",2009,"Alabama",NA,NA,NA,338,579,272,164,0,413,2,191,106,297,159,0,709,238,471,425,107,318,83,0.245562130177515,1524,10.4330708661417
"3653",2009,"Alabama A&M",NA,NA,NA,40,74,54,34,0,65,1,22,23,45,30,0,88,23,65,33,6,27,4,0.1,182,16.4835164835165
"3654",2009,"Alabama State",NA,NA,NA,60,92,50,26,0,98,1,20,43,63,19,0,91,16,75,52,18,34,9,0.15,220,8.63636363636364
"3655",2009,"Alaska Anchorage",NA,NA,NA,26,58,27,19,0,26,0,18,29,47,15,0,16,6,10,49,17,32,12,0.461538461538462,131,11.4503816793893
"3656",2009,"Alcorn State",NA,NA,NA,32,31,15,7,0,41,0,6,12,18,22,0,60,8,52,26,7,19,2,0.0625,85,25.8823529411765
"3657",2009,"American University",NA,NA,NA,13,28,8,4,0,13,0,11,9,20,0,0,23,9,14,15,6,9,6,0.461538461538462,68,0
"3658",2009,"Appalachian State",NA,NA,NA,43,93,36,21,0,66,0,20,22,42,28,0,84,31,53,43,13,30,9,0.209302325581395,205,13.6585365853659
"3659",2009,"Arizona",NA,NA,NA,28,38,23,16,0,26,0,25,9,34,19,0,58,18,40,14,5,9,7,0.25,120,15.8333333333333
"3660",2009,"Arizona State",NA,NA,NA,109,198,92,57,0,151,0,113,76,189,65,0,236,81,155,149,62,87,22,0.201834862385321,584,11.1301369863014
"3661",2009,"Arkansas",NA,NA,NA,403,649,324,200,0,449,1,281,166,447,257,0,651,201,450,548,163,385,85,0.210918114143921,1772,14.5033860045147
"3662",2009,"Arkansas State",NA,NA,NA,9,16,16,10,0,10,0,4,6,10,7,0,30,13,17,10,2,8,2,0.222222222222222,46,15.2173913043478
"3663",2009,"Arkansas-Pine Bluff",NA,NA,NA,39,67,41,22,0,54,1,9,24,33,23,0,97,27,70,42,9,33,6,0.153846153846154,163,14.1104294478528
"3664",2009,"Army",NA,NA,NA,37,84,44,26,0,50,0,31,11,42,14,0,70,26,44,35,5,30,8,0.216216216216216,194,7.21649484536082
"3665",2009,"Auburn",NA,NA,NA,404,687,445,290,0,384,0,370,180,550,237,0,917,338,579,244,95,149,107,0.264851485148515,2013,11.7734724292101
"3666",2009,"Austin Peay",NA,NA,NA,101,116,73,39,0,84,0,32,42,74,37,0,137,35,102,90,24,66,20,0.198019801980198,320,11.5625
"3667",2009,"BYU",NA,NA,NA,15,23,12,11,0,19,0,11,8,19,8,0,24,9,15,18,9,9,3,0.2,73,10.958904109589
"3668",2009,"Ball State",NA,NA,NA,70,170,96,67,0,108,0,77,47,124,57,0,140,42,98,122,42,80,21,0.3,427,13.3489461358314
"3669",2009,"Baylor",NA,NA,NA,426,792,476,292,1,423,0,189,121,310,185,0,1063,407,656,332,109,223,110,0.258215962441315,2049,9.02879453391899
"3670",2009,"Belmont",NA,NA,NA,18,47,21,13,0,40,0,14,14,28,17,0,32,8,24,40,11,29,3,0.166666666666667,106,16.0377358490566
"3671",2009,"Bethel (TN)",NA,NA,NA,8,25,11,9,0,34,0,11,14,25,11,0,31,13,18,15,2,13,5,0.625,63,17.4603174603175
"3672",2009,"Bethune-Cookman",NA,NA,NA,14,27,23,14,0,21,0,7,7,14,7,0,31,8,23,20,7,13,5,0.357142857142857,69,10.1449275362319
"3673",2009,"Binghamton",NA,NA,NA,66,144,98,59,0,117,0,44,50,94,39,0,119,35,84,79,22,57,17,0.257575757575758,338,11.5384615384615
"3674",2009,"Boise State",NA,NA,NA,24,39,24,16,0,41,0,12,5,17,22,0,59,14,45,30,14,16,5,0.208333333333333,110,20
"3675",2009,"Boston College",NA,NA,NA,378,685,291,183,0,455,2,324,216,540,175,0,635,249,386,370,119,251,112,0.296296296296296,1830,9.56284153005464
"3676",2009,"Boston University",NA,NA,NA,100,209,137,83,0,158,0,116,86,202,67,0,151,36,115,167,56,111,24,0.24,556,12.0503597122302
"3677",2009,"Bowling Green",NA,NA,NA,140,266,163,117,0,170,2,101,82,183,85,0,214,66,148,228,77,151,33,0.235714285714286,692,12.2832369942197
"3678",2009,"Bradley",NA,NA,NA,66,101,62,39,0,85,0,26,15,41,33,0,144,57,87,48,19,29,19,0.287878787878788,286,11.5384615384615
"3679",2009,"Brown",NA,NA,NA,36,43,35,16,0,30,0,16,14,30,17,0,57,13,44,25,6,19,7,0.194444444444444,126,13.4920634920635
"3680",2009,"Bryant",NA,NA,NA,9,20,15,9,0,19,0,15,6,21,5,0,21,8,13,9,2,7,3,0.333333333333333,58,8.62068965517241
"3681",2009,"Bucknell",NA,NA,NA,38,78,23,15,0,52,0,32,44,76,25,0,71,26,45,24,7,17,8,0.210526315789474,190,13.1578947368421
"3682",2009,"Buffalo",NA,NA,NA,66,147,62,37,0,79,0,47,35,82,34,0,163,58,105,50,17,33,19,0.287878787878788,356,9.55056179775281
"3683",2009,"Butler",NA,NA,NA,34,83,44,23,0,55,0,37,23,60,39,0,73,22,51,63,15,48,4,0.117647058823529,202,19.3069306930693
"3684",2009,"Cal Poly",NA,NA,NA,12,17,10,6,0,18,0,9,11,20,9,0,23,8,15,14,5,9,2,0.166666666666667,54,16.6666666666667
"3685",2009,"Cal State Bakersfield",NA,NA,NA,16,43,26,21,0,34,0,6,10,16,14,0,56,18,38,41,19,22,1,0.0625,108,12.962962962963
"3686",2009,"Cal State Northridge",NA,NA,NA,33,66,29,18,1,52,0,13,6,19,22,0,96,20,76,51,12,39,4,0.121212121212121,150,14.6666666666667
"3687",2009,"California",NA,NA,NA,132,277,156,101,0,157,0,110,91,201,47,0,184,65,119,204,73,131,26,0.196969696969697,704,6.67613636363636
"3688",2009,"Campbell",NA,NA,NA,10,29,19,12,0,17,0,15,4,19,8,0,26,13,13,14,6,8,7,0.7,78,10.2564102564103
"3689",2009,"Canisius",NA,NA,NA,35,63,50,36,0,45,0,14,24,38,17,0,54,16,38,65,23,42,7,0.2,168,10.1190476190476
"3690",2009,"Centenary",NA,NA,NA,37,85,43,27,0,61,1,22,21,43,12,0,76,18,58,49,13,36,8,0.216216216216216,185,6.48648648648649
"3691",2009,"Central Arkansas",NA,NA,NA,8,19,12,6,0,17,0,5,10,15,7,0,19,7,12,14,2,12,2,0.25,43,16.2790697674419
"3692",2009,"Central Connecticut",NA,NA,NA,28,38,21,16,0,35,0,12,13,25,21,0,37,13,24,49,15,34,7,0.25,113,18.5840707964602
"3693",2009,"Central Michigan",NA,NA,NA,27,46,40,27,0,40,0,19,14,33,19,0,37,6,31,49,15,34,7,0.259259259259259,122,15.5737704918033
"3694",2009,"Chadron State",NA,NA,NA,11,21,9,4,0,21,0,3,13,16,5,0,11,2,9,33,12,21,2,0.181818181818182,50,10
"3695",2009,"Charleston Southern",NA,NA,NA,27,36,22,16,0,35,0,20,25,45,18,0,43,14,29,47,16,31,5,0.185185185185185,118,15.2542372881356
"3696",2009,"Charlotte",NA,NA,NA,97,226,104,66,0,123,1,96,92,188,50,0,200,72,128,121,39,82,21,0.216494845360825,558,8.96057347670251
"3697",2009,"Chattanooga",NA,NA,NA,64,130,62,43,0,91,1,49,32,81,23,0,94,35,59,103,38,65,16,0.25,338,6.80473372781065
"3698",2009,"Chicago State",NA,NA,NA,40,66,42,26,0,38,1,16,20,36,19,0,64,13,51,36,11,25,7,0.175,155,12.258064516129
"3699",2009,"Cincinnati",NA,NA,NA,261,614,250,174,0,329,2,164,104,268,133,0,540,203,337,540,177,363,53,0.203065134099617,1485,8.95622895622896
"3700",2009,"Clemson",NA,NA,NA,209,409,174,114,0,324,0,187,144,331,158,0,451,155,296,272,86,186,55,0.263157894736842,1087,14.5354185832567
"3701",2009,"Cleveland State",NA,NA,NA,47,107,65,44,0,68,0,60,31,91,29,0,60,20,40,55,22,33,12,0.25531914893617,276,10.5072463768116
"3702",2009,"Coastal Carolina",NA,NA,NA,30,43,28,14,0,32,0,7,4,11,19,0,79,22,57,32,7,25,4,0.133333333333333,115,16.5217391304348
"3703",2009,"Colgate",NA,NA,NA,16,29,13,6,0,17,0,12,11,23,8,0,27,10,17,11,2,9,6,0.375,73,10.958904109589
"3704",2009,"Colorado",NA,NA,NA,183,431,225,135,0,322,1,185,155,340,136,0,356,125,231,286,95,191,41,0.224043715846995,1074,12.6629422718808
"3705",2009,"Colorado State",NA,NA,NA,24,52,23,13,0,27,0,12,15,27,20,0,47,8,39,35,14,21,5,0.208333333333333,113,17.6991150442478
"3706",2009,"Columbia",NA,NA,NA,74,99,65,39,0,66,0,61,49,110,37,0,69,18,51,60,15,45,12,0.162162162162162,284,13.0281690140845
"3707",2009,"Coppin State",NA,NA,NA,67,111,58,31,0,70,1,48,47,95,26,0,150,37,113,20,2,18,16,0.238805970149254,274,9.48905109489051
"3708",2009,"Cornell",NA,NA,NA,11,33,0,0,0,11,0,5,1,6,3,0,27,11,16,15,5,10,3,0.272727272727273,65,4.61538461538462
"3709",2009,"Creighton",NA,NA,NA,65,112,53,32,0,78,0,22,26,48,37,0,150,48,102,84,26,58,17,0.261538461538462,287,12.8919860627178
"3710",2009,"Dartmouth",NA,NA,NA,74,121,70,44,0,79,0,47,48,95,33,0,105,25,80,78,17,61,12,0.162162162162162,307,10.7491856677524
"3711",2009,"Davidson",NA,NA,NA,36,84,26,18,0,52,0,27,35,62,11,0,48,15,33,54,15,39,7,0.194444444444444,184,5.97826086956522
"3712",2009,"Dayton",NA,NA,NA,123,242,76,46,0,112,0,69,57,126,50,0,239,76,163,170,51,119,29,0.235772357723577,583,8.57632933104631
"3713",2009,"DePaul",NA,NA,NA,331,616,329,202,0,421,0,225,133,358,202,0,626,245,381,473,151,322,83,0.250755287009063,1665,12.1321321321321
"3714",2009,"Delaware",NA,NA,NA,13,31,23,12,0,9,0,7,11,18,7,0,29,10,19,1,0,1,4,0.307692307692308,67,10.4477611940298
"3715",2009,"Delaware State",NA,NA,NA,49,57,38,26,0,73,0,29,46,75,41,0,97,22,75,43,13,30,8,0.163265306122449,181,22.6519337016575
"3716",2009,"Denver",NA,NA,NA,34,103,51,33,0,71,0,45,31,76,36,0,60,24,36,66,19,47,6,0.176470588235294,239,15.0627615062762
"3717",2009,"Detroit Mercy",NA,NA,NA,43,78,34,22,0,49,0,12,14,26,17,0,85,25,60,50,7,43,11,0.255813953488372,172,9.88372093023256
"3718",2009,"Drake",NA,NA,NA,73,132,61,40,0,97,0,32,29,61,35,0,189,66,123,74,21,53,17,0.232876712328767,344,10.1744186046512
"3719",2009,"Drexel",NA,NA,NA,35,81,34,26,0,67,0,33,32,65,26,0,78,27,51,70,17,53,10,0.285714285714286,203,12.807881773399
"3720",2009,"Duke",NA,NA,NA,450,690,389,244,0,457,1,328,241,569,284,0,733,239,494,354,115,239,126,0.28,1924,14.7609147609148
"3721",2009,"Duquesne",NA,NA,NA,43,63,35,21,0,42,0,24,15,39,26,0,78,21,57,60,17,43,14,0.325581395348837,173,15.028901734104
"3722",2009,"East Carolina",NA,NA,NA,49,81,44,27,0,48,0,35,33,68,29,0,88,36,52,40,9,31,13,0.26530612244898,223,13.0044843049327
"3723",2009,"East Tennessee State",NA,NA,NA,33,59,20,10,0,25,0,19,14,33,15,0,60,15,45,26,11,15,5,0.151515151515152,141,10.6382978723404
"3724",2009,"Eastern Illinois",NA,NA,NA,59,125,58,44,0,77,0,31,25,56,21,0,123,49,74,75,26,49,18,0.305084745762712,304,6.90789473684211
"3725",2009,"Eastern Kentucky",NA,NA,NA,25,64,19,12,0,52,0,14,12,26,16,0,55,17,38,67,18,49,5,0.2,144,11.1111111111111
"3726",2009,"Eastern Michigan",NA,NA,NA,43,72,53,37,0,63,0,23,38,61,34,0,68,15,53,58,18,40,6,0.13953488372093,183,18.5792349726776
"3727",2009,"Eastern Washington",NA,NA,NA,9,21,13,5,0,19,0,10,6,16,7,0,15,2,13,11,6,5,0,0,52,13.4615384615385
"3728",2009,"Elon",NA,NA,NA,15,24,7,4,0,10,0,9,10,19,6,0,33,7,26,9,1,8,3,0.2,58,10.3448275862069
"3729",2009,"Evansville",NA,NA,NA,89,152,81,53,0,99,0,45,48,93,41,0,163,56,107,98,26,72,28,0.314606741573034,393,10.4325699745547
"3730",2009,"Fairfield",NA,NA,NA,65,108,46,31,0,55,0,47,42,89,31,0,151,47,104,43,16,27,19,0.292307692307692,295,10.5084745762712
"3731",2009,"Fairleigh Dickinson",NA,NA,NA,9,28,5,2,0,18,0,10,13,23,5,0,15,3,12,17,6,11,4,0.444444444444444,57,8.7719298245614
"3732",2009,"Florida",NA,NA,NA,381,626,364,227,0,457,0,355,197,552,237,0,487,154,333,481,168,313,93,0.244094488188976,1781,13.307130825379
"3733",2009,"Florida A&M",NA,NA,NA,73,88,55,33,0,70,0,31,25,56,22,0,137,32,105,62,20,42,18,0.246575342465753,261,8.42911877394636
"3734",2009,"Florida Atlantic",NA,NA,NA,41,68,36,21,0,60,0,39,19,58,27,0,87,31,56,48,16,32,17,0.414634146341463,205,13.1707317073171
"3735",2009,"Florida Gulf Coast",NA,NA,NA,7,19,11,7,0,22,0,12,9,21,7,0,10,4,6,31,13,18,3,0.428571428571429,57,12.280701754386
"3736",2009,"Florida International",NA,NA,NA,61,113,45,23,0,63,0,31,29,60,27,0,100,35,65,61,22,39,14,0.229508196721311,270,10
"3737",2009,"Florida State",NA,NA,NA,354,611,382,240,0,441,1,286,232,518,189,0,558,172,386,377,141,236,95,0.268361581920904,1656,11.4130434782609
"3738",2009,"Fordham",NA,NA,NA,42,61,35,24,0,38,0,22,31,53,29,0,78,28,50,38,10,28,5,0.119047619047619,174,16.6666666666667
"3739",2009,"Fresno State",NA,NA,NA,117,189,77,48,8,97,1,46,54,100,51,0,109,27,82,204,70,134,22,0.188034188034188,480,10.625
"3740",2009,"Furman",NA,NA,NA,32,73,28,22,0,40,0,10,8,18,18,0,92,24,68,38,14,24,10,0.3125,161,11.1801242236025
"3741",2009,"Gardner-Webb",NA,NA,NA,6,23,16,11,0,14,0,15,7,22,7,0,10,2,8,15,4,11,3,0.5,57,12.280701754386
"3742",2009,"George Washington",NA,NA,NA,101,230,117,70,0,168,2,70,44,114,56,0,246,76,170,129,46,83,23,0.227722772277228,557,10.0538599640934
"3743",2009,"Georgia",NA,NA,NA,216,415,207,123,0,281,1,172,131,303,111,0,418,154,264,213,67,146,51,0.236111111111111,1091,10.1741521539872
"3744",2009,"Georgia Southern",NA,NA,NA,33,70,43,24,0,48,0,21,24,45,19,0,51,13,38,58,18,40,8,0.242424242424242,167,11.377245508982
"3745",2009,"Georgia State",NA,NA,NA,39,85,70,43,0,67,1,45,50,95,50,0,91,41,50,33,6,27,8,0.205128205128205,233,21.4592274678112
"3746",2009,"Georgia Tech",NA,NA,NA,356,511,340,214,0,421,4,274,224,498,261,0,501,156,345,297,84,213,74,0.207865168539326,1469,17.7671885636487
"3747",2009,"Gonzaga",NA,NA,NA,39,101,51,37,0,54,1,30,19,49,12,0,133,48,85,48,15,33,8,0.205128205128205,249,4.81927710843374
"3748",2009,"Grambling",NA,NA,NA,50,53,36,19,0,41,0,15,9,24,16,0,91,21,70,38,10,28,10,0.2,160,10
"3749",2009,"Green Bay",NA,NA,NA,53,149,110,68,0,129,0,77,54,131,52,0,110,37,73,114,43,71,13,0.245283018867925,392,13.265306122449
"3750",2009,"Hampton",NA,NA,NA,24,32,20,14,0,23,0,19,10,29,8,0,34,9,25,11,3,8,7,0.291666666666667,91,8.79120879120879
"3751",2009,"Hartford",NA,NA,NA,116,199,125,80,0,160,0,75,43,118,54,0,225,58,167,153,43,110,18,0.155172413793103,528,10.2272727272727
"3752",2009,"Harvard",NA,NA,NA,58,88,37,18,0,64,0,33,32,65,21,0,132,46,86,49,14,35,13,0.224137931034483,248,8.46774193548387
"3753",2009,"Hawai'i",NA,NA,NA,32,66,32,22,0,50,1,21,11,32,21,0,77,26,51,44,13,31,9,0.28125,165,12.7272727272727
"3754",2009,"High Point",NA,NA,NA,21,60,24,14,0,37,0,8,5,13,13,0,63,18,45,26,7,19,4,0.19047619047619,121,10.7438016528926
"3755",2009,"Hofstra",NA,NA,NA,23,64,29,17,0,40,0,31,18,49,19,0,37,16,21,24,8,16,5,0.217391304347826,151,12.5827814569536
"3756",2009,"Holy Cross",NA,NA,NA,25,45,24,15,0,33,0,19,23,42,8,0,37,8,29,43,6,37,7,0.28,112,7.14285714285714
"3757",2009,"Houston",NA,NA,NA,45,70,38,26,0,45,0,20,24,44,16,0,97,30,67,38,16,22,11,0.244444444444444,193,8.29015544041451
"3758",2009,"Howard",NA,NA,NA,28,43,14,8,0,25,0,8,6,14,16,0,74,21,53,28,7,21,2,0.0714285714285714,110,14.5454545454545
"3759",2009,"IUPUI",NA,NA,NA,51,66,40,22,0,55,0,18,14,32,26,0,115,40,75,51,12,39,7,0.137254901960784,195,13.3333333333333
"3760",2009,"Idaho",NA,NA,NA,13,27,13,7,0,18,0,11,14,25,10,0,21,7,14,11,4,7,2,0.153846153846154,66,15.1515151515152
"3761",2009,"Idaho State",NA,NA,NA,11,19,12,7,0,20,0,12,8,20,2,0,10,4,6,27,5,22,1,0.0909090909090909,53,3.77358490566038
"3762",2009,"Illinois",NA,NA,NA,220,437,166,114,0,277,0,92,47,139,121,0,747,256,491,197,48,149,43,0.195454545454545,1100,11
"3763",2009,"Illinois State",NA,NA,NA,94,264,128,87,0,161,1,102,68,170,54,0,209,74,135,147,41,106,23,0.24468085106383,613,8.80913539967374
"3764",2009,"Indiana",NA,NA,NA,264,434,234,151,0,322,0,172,149,321,180,0,479,163,316,328,108,220,73,0.276515151515151,1209,14.8883374689826
"3765",2009,"Indiana State",NA,NA,NA,11,24,16,9,0,13,0,5,11,16,0,0,29,7,22,16,4,12,1,0.0909090909090909,56,0
"3766",2009,"Iona",NA,NA,NA,20,55,21,17,0,41,0,16,9,25,24,0,67,19,48,38,14,24,6,0.3,133,18.0451127819549
"3767",2009,"Iowa State",NA,NA,NA,404,725,368,243,0,416,1,173,92,265,188,3,731,238,493,710,244,466,103,0.254950495049505,1885,9.97347480106101
"3768",2009,"Jackson State",NA,NA,NA,32,57,31,15,0,50,0,12,12,24,29,0,85,30,55,56,21,35,3,0.09375,155,18.7096774193548
"3769",2009,"Jacksonville",NA,NA,NA,45,55,29,18,0,51,0,17,13,30,33,0,118,25,93,50,14,36,11,0.244444444444444,166,19.8795180722892
"3770",2009,"Jacksonville State",NA,NA,NA,35,72,34,20,0,49,0,22,28,50,19,0,57,13,44,66,16,50,4,0.114285714285714,166,11.4457831325301
"3771",2009,"James Madison",NA,NA,NA,27,52,19,11,0,33,0,18,11,29,7,0,49,13,36,50,18,32,10,0.37037037037037,131,5.34351145038168
"3772",2009,"Kansas",NA,NA,NA,346,801,427,281,0,494,0,337,217,554,209,0,750,289,461,366,134,232,93,0.26878612716763,2027,10.3108041440553
"3773",2009,"Kansas City",NA,NA,NA,24,53,23,17,0,54,0,13,18,31,18,0,72,25,47,42,12,30,5,0.208333333333333,134,13.4328358208955
"3774",2009,"Kansas State",NA,NA,NA,277,571,245,167,0,328,0,184,83,267,151,0,631,256,375,418,135,283,80,0.288808664259928,1496,10.0935828877005
"3775",2009,"Kennesaw State",NA,NA,NA,42,55,41,24,0,64,0,18,16,34,38,0,91,34,57,54,13,41,8,0.19047619047619,175,21.7142857142857
"3776",2009,"Kent State",NA,NA,NA,33,75,31,22,0,57,1,22,22,44,25,0,72,28,44,44,16,28,8,0.242424242424242,186,13.4408602150538
"3777",2009,"Kentucky",NA,NA,NA,414,719,398,260,0,445,2,243,173,416,187,0,721,201,520,403,120,283,85,0.205314009661836,1807,10.3486441615938
"3778",2009,"LIU Brooklyn",NA,NA,NA,11,24,18,9,0,17,0,16,11,27,15,0,22,5,17,6,2,4,4,0.363636363636364,63,23.8095238095238
"3779",2009,"LSU",NA,NA,NA,265,647,329,193,0,386,2,218,133,351,191,0,839,299,540,170,49,121,62,0.233962264150943,1571,12.1578612348822
"3780",2009,"La Salle",NA,NA,NA,28,69,30,18,0,24,0,22,25,47,14,0,61,17,44,46,18,28,7,0.25,162,8.64197530864197
"3781",2009,"Lafayette",NA,NA,NA,27,71,34,17,0,53,0,20,26,46,7,0,56,21,35,36,11,25,5,0.185185185185185,152,4.60526315789474
"3782",2009,"Lamar",NA,NA,NA,10,31,13,8,0,33,0,5,1,6,14,0,64,15,49,36,9,27,6,0.6,75,18.6666666666667
"3783",2009,"Lehigh",NA,NA,NA,71,143,73,44,0,101,0,59,56,115,22,0,114,35,79,113,34,79,17,0.23943661971831,366,6.01092896174863
"3784",2009,"Liberty",NA,NA,NA,56,101,38,21,0,60,0,39,44,83,23,0,76,21,55,50,14,36,12,0.214285714285714,240,9.58333333333333
"3785",2009,"Lipscomb",NA,NA,NA,48,105,74,46,0,59,0,26,38,64,25,0,84,23,61,50,12,38,5,0.104166666666667,235,10.6382978723404
"3786",2009,"Little Rock",NA,NA,NA,24,36,20,11,0,34,0,18,13,31,21,0,58,20,38,22,9,13,7,0.291666666666667,113,18.5840707964602
"3787",2009,"Long Beach State",NA,NA,NA,13,26,1,1,0,17,0,3,0,3,12,0,50,17,33,17,1,16,3,0.230769230769231,61,19.672131147541
"3788",2009,"Longwood",NA,NA,NA,19,56,43,27,0,50,1,19,29,48,22,0,40,10,30,63,19,44,2,0.105263157894737,133,16.5413533834586
"3789",2009,"Louisiana",NA,NA,NA,44,63,32,20,0,42,0,29,19,48,14,0,83,15,68,43,14,29,11,0.25,172,8.13953488372093
"3790",2009,"Louisiana Tech",NA,NA,NA,81,123,68,37,0,103,0,30,14,44,39,0,197,57,140,80,20,60,17,0.209876543209877,325,12
"3791",2009,"Loyola Chicago",NA,NA,NA,10,21,9,5,0,27,0,8,6,14,7,0,24,6,18,12,3,9,4,0.4,51,13.7254901960784
"3792",2009,"Loyola Maryland",NA,NA,NA,29,94,45,32,0,65,0,36,25,61,20,0,63,19,44,57,15,42,5,0.172413793103448,208,9.61538461538462
"3793",2009,"Loyola Marymount",NA,NA,NA,18,27,18,12,0,17,0,14,15,29,0,0,20,7,13,17,5,12,5,0.277777777777778,78,0
"3794",2009,"Maine",NA,NA,NA,30,57,39,22,0,64,0,16,20,36,23,0,67,19,48,34,13,21,6,0.2,144,15.9722222222222
"3795",2009,"Manhattan",NA,NA,NA,56,86,48,26,0,69,0,30,36,66,31,0,92,35,57,73,22,51,14,0.25,244,12.7049180327869
"3796",2009,"Marist",NA,NA,NA,62,149,82,58,0,102,0,72,46,118,24,0,110,41,69,115,37,78,16,0.258064516129032,382,6.282722513089
"3797",2009,"Marquette",NA,NA,NA,173,294,165,109,0,225,0,79,73,152,54,0,339,103,236,231,67,164,31,0.179190751445087,765,7.05882352941176
"3798",2009,"Marshall",NA,NA,NA,52,137,85,55,0,107,3,58,33,91,43,0,125,44,81,48,18,30,16,0.307692307692308,339,12.6843657817109
"3799",2009,"Maryland",NA,NA,NA,356,648,360,249,0,317,3,303,207,510,127,0,524,192,332,415,167,248,92,0.258426966292135,1766,7.19139297848245
"3800",2009,"Maryland-Eastern Shore",NA,NA,NA,22,48,26,19,0,39,0,14,19,33,8,0,35,8,27,39,13,26,2,0.0909090909090909,112,7.14285714285714
"3801",2009,"McNeese",NA,NA,NA,23,51,20,12,0,41,0,16,22,38,8,0,42,11,31,39,12,27,7,0.304347826086957,118,6.77966101694915
"3802",2009,"Memphis",NA,NA,NA,42,63,44,26,0,58,0,30,32,62,29,0,65,22,43,60,17,43,11,0.261904761904762,186,15.5913978494624
"3803",2009,"Mercer",NA,NA,NA,34,65,48,29,0,57,0,30,25,55,28,0,75,26,49,28,6,22,11,0.323529411764706,175,16
"3804",2009,"Mercyhurst",NA,NA,NA,9,18,5,4,0,21,0,2,5,7,7,0,22,9,13,19,3,16,0,0,41,17.0731707317073
"3805",2009,"Miami",NA,NA,NA,308,487,256,149,0,347,1,202,116,318,225,0,675,237,438,361,99,262,78,0.253246753246753,1401,16.0599571734475
"3806",2009,"Miami (OH)",NA,NA,NA,76,134,66,44,0,99,1,57,35,92,61,0,177,49,128,79,23,56,22,0.289473684210526,350,17.4285714285714
"3807",2009,"Michigan",NA,NA,NA,233,524,225,144,0,311,1,62,64,126,178,0,594,257,337,527,157,370,44,0.188841201716738,1277,13.9389193422083
"3808",2009,"Michigan State",NA,NA,NA,363,698,357,228,0,454,2,306,227,533,205,0,601,213,388,329,87,242,102,0.28099173553719,1767,11.601584606678
"3809",2009,"Middle Tennessee",NA,NA,NA,127,226,131,91,0,184,1,126,61,187,97,0,180,58,122,231,85,146,33,0.259842519685039,663,14.630467571644
"3810",2009,"Minnesota",NA,NA,NA,252,412,223,143,0,330,0,79,55,134,155,0,621,225,396,331,101,230,64,0.253968253968254,1126,13.765541740675
"3811",2009,"Mississippi State",NA,NA,NA,378,602,273,169,0,443,5,225,140,365,217,0,678,237,441,466,141,325,102,0.26984126984127,1647,13.1754705525197
"3812",2009,"Mississippi Valley State",NA,NA,NA,22,74,18,11,0,41,0,18,16,34,16,0,73,17,56,41,13,28,9,0.409090909090909,150,10.6666666666667
"3813",2009,"Missouri",NA,NA,NA,346,540,280,169,0,410,1,194,114,308,242,0,750,233,517,368,101,267,86,0.248554913294798,1498,16.154873164219
"3814",2009,"Missouri State",NA,NA,NA,28,31,18,12,0,39,0,16,13,29,21,0,34,13,21,48,9,39,5,0.178571428571429,107,19.6261682242991
"3815",2009,"Monmouth",NA,NA,NA,49,101,44,26,0,63,0,26,24,50,27,0,122,39,83,30,9,21,9,0.183673469387755,236,11.4406779661017
"3816",2009,"Montana",NA,NA,NA,32,71,36,25,0,42,1,9,8,17,17,0,89,34,55,54,12,42,7,0.21875,165,10.3030303030303
"3817",2009,"Montana State-Northern",NA,NA,NA,9,20,10,7,0,12,0,3,7,10,5,0,32,11,21,7,0,7,1,0.111111111111111,46,10.8695652173913
"3818",2009,"Morehead State",NA,NA,NA,51,62,37,18,0,47,0,32,33,65,35,0,47,10,37,72,21,51,9,0.176470588235294,183,19.1256830601093
"3819",2009,"Morgan State",NA,NA,NA,11,23,21,13,0,22,0,10,9,19,18,0,29,12,17,21,9,12,4,0.363636363636364,71,25.3521126760563
"3820",2009,"Mount St. Mary's",NA,NA,NA,14,52,27,15,0,42,0,11,15,26,18,0,45,15,30,30,11,19,3,0.214285714285714,107,16.8224299065421
"3821",2009,"Murray State",NA,NA,NA,35,108,59,46,0,50,0,34,19,53,20,0,97,43,54,88,21,67,10,0.285714285714286,258,7.75193798449612
"3822",2009,"NC State",NA,NA,NA,305,544,231,146,0,317,0,128,95,223,172,0,764,266,498,295,81,214,79,0.259016393442623,1395,12.3297491039427
"3823",2009,"NJIT",NA,NA,NA,22,35,28,17,0,30,0,10,32,42,16,0,27,10,17,36,9,27,4,0.181818181818182,93,17.2043010752688
"3824",2009,"Navy",NA,NA,NA,37,67,30,17,0,44,0,21,30,51,20,0,53,21,32,61,18,43,9,0.243243243243243,172,11.6279069767442
"3825",2009,"Nebraska",NA,NA,NA,282,610,296,200,0,406,0,150,86,236,181,0,793,280,513,440,149,291,74,0.26241134751773,1551,11.6698903932946
"3826",2009,"Nevada",NA,NA,NA,97,126,78,54,0,91,0,43,41,84,50,0,168,62,106,95,21,74,23,0.237113402061856,367,13.6239782016349
"3827",2009,"New Hampshire",NA,NA,NA,18,46,16,12,0,29,0,16,14,30,13,0,46,8,38,32,9,23,5,0.277777777777778,102,12.7450980392157
"3828",2009,"New Mexico",NA,NA,NA,115,201,107,74,0,131,0,72,60,132,52,0,188,46,142,127,40,87,22,0.191304347826087,503,10.337972166998
"3829",2009,"New Mexico State",NA,NA,NA,17,51,23,18,0,44,0,7,5,12,14,0,72,27,45,24,7,17,3,0.176470588235294,116,12.0689655172414
"3830",2009,"New Orleans",NA,NA,NA,30,46,15,9,0,46,0,18,24,42,17,0,51,13,38,29,7,22,4,0.133333333333333,118,14.406779661017
"3831",2009,"Niagara",NA,NA,NA,62,96,43,26,0,87,0,44,38,82,26,0,97,29,68,77,19,58,12,0.193548387096774,263,9.88593155893536
"3832",2009,"Nicholls",NA,NA,NA,16,43,12,9,0,30,0,7,10,17,13,0,50,9,41,25,4,21,3,0.1875,85,15.2941176470588
"3833",2009,"Norfolk State",NA,NA,NA,22,40,20,12,0,53,0,14,11,25,27,0,64,14,50,29,7,22,5,0.227272727272727,100,27
"3834",2009,"North Carolina",NA,NA,NA,472,868,522,346,0,509,1,182,163,345,315,0,1221,569,652,448,151,297,138,0.292372881355932,2414,13.0488815244408
"3835",2009,"North Carolina A&T",NA,NA,NA,49,85,61,41,0,75,0,52,26,78,22,0,97,27,70,51,18,33,10,0.204081632653061,251,8.76494023904383
"3836",2009,"North Carolina Central",NA,NA,NA,59,97,57,30,0,70,0,21,27,48,47,0,169,46,123,44,8,36,11,0.186440677966102,247,19.0283400809717
"3837",2009,"North Dakota",NA,NA,NA,23,81,48,28,0,86,0,29,7,36,18,0,107,38,69,64,18,46,11,0.478260869565217,206,8.7378640776699
"3838",2009,"North Dakota State",NA,NA,NA,35,86,27,17,0,55,0,39,26,65,25,0,69,19,50,41,7,34,9,0.257142857142857,192,13.0208333333333
"3839",2009,"North Florida",NA,NA,NA,32,74,15,9,0,56,0,22,29,51,25,0,71,24,47,40,11,29,6,0.1875,168,14.8809523809524
"3840",2009,"North Texas",NA,NA,NA,36,69,33,20,0,68,0,35,30,65,47,0,60,16,44,45,17,28,7,0.194444444444444,184,25.5434782608696
"3841",2009,"Northeastern",NA,NA,NA,72,106,45,28,0,77,0,39,32,71,32,0,134,46,88,92,24,68,20,0.277777777777778,301,10.6312292358804
"3842",2009,"Northern Arizona",NA,NA,NA,30,51,12,8,0,40,0,19,26,45,9,0,46,12,34,33,8,25,8,0.266666666666667,124,7.25806451612903
"3843",2009,"Northern Colorado",NA,NA,NA,7,15,3,2,0,11,0,5,8,13,0,0,16,5,11,21,6,15,3,0.428571428571429,40,0
"3844",2009,"Northern Illinois",NA,NA,NA,101,158,88,54,0,159,1,67,67,134,73,0,194,61,133,119,40,79,22,0.217821782178218,456,16.0087719298246
"3845",2009,"Northern Iowa",NA,NA,NA,42,86,67,39,0,79,0,39,26,65,28,0,89,23,66,58,15,43,10,0.238095238095238,222,12.6126126126126
"3846",2009,"Northwestern",NA,NA,NA,117,268,121,80,0,192,1,61,34,95,61,0,286,91,195,165,40,125,22,0.188034188034188,607,10.0494233937397
"3847",2009,"Northwestern State",NA,NA,NA,49,112,67,37,0,83,1,44,42,86,42,0,76,20,56,62,21,41,10,0.204081632653061,265,15.8490566037736
"3848",2009,"Notre Dame",NA,NA,NA,361,673,385,252,0,421,0,341,316,657,243,0,672,253,419,311,106,205,102,0.282548476454294,1844,13.177874186551
"3849",2009,"Oakland",NA,NA,NA,42,103,42,29,0,61,0,36,36,72,31,0,131,33,98,39,17,22,9,0.214285714285714,239,12.9707112970711
"3850",2009,"Ohio",NA,NA,NA,93,149,66,38,0,104,0,72,43,115,45,0,143,39,104,76,22,54,21,0.225806451612903,394,11.4213197969543
"3851",2009,"Ohio State",NA,NA,NA,309,662,341,220,0,353,1,264,135,399,173,0,656,241,415,350,118,232,70,0.226537216828479,1681,10.291493158834
"3852",2009,"Oklahoma",NA,NA,NA,543,957,474,298,0,556,2,567,332,899,244,0,780,278,502,507,163,344,159,0.292817679558011,2662,9.16604057099925
"3853",2009,"Oklahoma State",NA,NA,NA,340,699,398,251,0,456,2,287,213,500,229,0,623,215,408,479,161,318,90,0.264705882352941,1806,12.6799557032115
"3854",2009,"Old Dominion",NA,NA,NA,142,204,149,88,0,155,0,123,95,218,68,0,163,36,127,122,31,91,34,0.23943661971831,575,11.8260869565217
"3855",2009,"Ole Miss",NA,NA,NA,415,633,359,228,0,434,1,316,226,542,238,0,614,171,443,418,131,287,99,0.23855421686747,1771,13.4387351778656
"3856",2009,"Oral Roberts",NA,NA,NA,59,110,62,34,0,86,2,40,42,82,29,0,73,26,47,74,22,52,9,0.152542372881356,273,10.6227106227106
"3857",2009,"Oregon",NA,NA,NA,147,290,157,106,0,228,1,125,128,253,73,0,231,61,170,205,73,132,23,0.156462585034014,739,9.87821380243572
"3858",2009,"Oregon State",NA,NA,NA,28,37,11,8,0,32,0,14,17,31,13,0,59,20,39,27,6,21,8,0.285714285714286,109,11.9266055045872
"3859",2009,"Pacific",NA,NA,NA,12,19,8,7,0,28,0,10,11,21,10,0,20,7,13,22,6,16,2,0.166666666666667,58,17.2413793103448
"3860",2009,"Pennsylvania",NA,NA,NA,18,47,19,13,0,32,1,14,22,36,9,0,43,13,30,33,9,24,6,0.333333333333333,106,8.49056603773585
"3861",2009,"Pittsburgh",NA,NA,NA,446,651,362,238,0,378,3,301,189,490,165,0,800,264,536,345,125,220,117,0.262331838565022,1895,8.70712401055409
"3862",2009,"Portland",NA,NA,NA,12,18,9,6,0,18,0,0,0,0,9,0,35,10,25,9,5,4,1,0.0833333333333333,45,20
"3863",2009,"Portland State",NA,NA,NA,39,74,44,30,0,54,0,10,22,32,21,0,69,28,41,69,19,50,11,0.282051282051282,182,11.5384615384615
"3864",2009,"Prairie View A&M",NA,NA,NA,76,134,64,39,0,91,0,45,26,71,55,0,204,68,136,63,18,45,11,0.144736842105263,356,15.4494382022472
"3865",2009,"Presbyterian",NA,NA,NA,12,63,9,8,0,39,0,11,14,25,12,0,48,11,37,40,9,31,1,0.0833333333333333,110,10.9090909090909
"3866",2009,"Princeton",NA,NA,NA,43,60,33,22,0,52,0,26,31,57,28,0,54,15,39,50,12,38,7,0.162790697674419,160,17.5
"3867",2009,"Providence",NA,NA,NA,259,537,213,146,0,394,5,201,201,402,143,0,502,157,345,350,107,243,58,0.223938223938224,1313,10.8910891089109
"3868",2009,"Purdue",NA,NA,NA,345,774,372,252,0,506,0,170,130,300,260,0,1030,441,589,387,142,245,92,0.266666666666667,1975,13.1645569620253
"3869",2009,"Purdue Fort Wayne",NA,NA,NA,29,65,13,7,0,51,0,18,20,38,10,0,72,25,47,62,19,43,9,0.310344827586207,157,6.36942675159236
"3870",2009,"Quinnipiac",NA,NA,NA,35,58,51,32,0,50,0,22,24,46,26,0,63,23,40,51,19,32,9,0.257142857142857,166,15.6626506024096
"3871",2009,"Radford",NA,NA,NA,32,56,29,17,0,61,1,23,27,50,30,0,66,23,43,34,7,27,4,0.125,149,20.1342281879195
"3872",2009,"Rhode Island",NA,NA,NA,45,108,37,17,0,77,0,33,30,63,36,0,147,45,102,65,21,44,13,0.288888888888889,263,13.6882129277567
"3873",2009,"Rice",NA,NA,NA,48,70,41,26,0,63,0,25,30,55,23,0,64,14,50,75,18,57,7,0.145833333333333,187,12.2994652406417
"3874",2009,"Richmond",NA,NA,NA,78,140,52,31,0,98,0,56,82,138,50,0,132,46,86,76,25,51,21,0.269230769230769,360,13.8888888888889
"3875",2009,"Rider",NA,NA,NA,40,64,20,12,0,49,0,20,29,49,18,0,62,20,42,52,13,39,7,0.175,162,11.1111111111111
"3876",2009,"Robert Morris",NA,NA,NA,36,43,33,19,0,32,0,23,19,42,18,0,43,10,33,49,13,36,9,0.25,135,13.3333333333333
"3877",2009,"SE Louisiana",NA,NA,NA,31,45,11,6,0,34,0,3,2,5,7,0,52,14,38,64,23,41,5,0.161290322580645,118,5.93220338983051
"3878",2009,"SMU",NA,NA,NA,33,56,25,16,0,34,1,23,28,51,9,0,38,10,28,31,8,23,4,0.121212121212121,138,6.52173913043478
"3879",2009,"Sacramento State",NA,NA,NA,11,13,5,2,0,15,0,1,0,1,7,0,35,10,25,22,7,15,5,0.454545454545455,42,16.6666666666667
"3880",2009,"Sacred Heart",NA,NA,NA,68,155,101,60,0,119,0,64,59,123,28,0,113,47,66,89,31,58,14,0.205882352941176,389,7.19794344473008
"3881",2009,"Saint Joseph's",NA,NA,NA,47,94,41,28,0,65,0,25,27,52,24,0,103,36,67,71,19,52,15,0.319148936170213,233,10.3004291845494
"3882",2009,"Saint Louis",NA,NA,NA,31,30,49,33,0,42,0,16,23,39,16,0,40,14,26,20,5,15,3,0.0967741935483871,112,14.2857142857143
"3883",2009,"Sam Houston",NA,NA,NA,19,38,23,14,0,42,0,11,12,23,13,0,51,13,38,48,10,38,1,0.0526315789473684,95,13.6842105263158
"3884",2009,"Samford",NA,NA,NA,16,78,32,22,0,59,1,19,14,33,8,0,55,19,36,74,21,53,3,0.1875,162,4.93827160493827
"3885",2009,"San Diego",NA,NA,NA,31,76,46,33,0,60,0,15,12,27,4,0,105,41,64,29,8,21,2,0.0645161290322581,188,2.12765957446809
"3886",2009,"San Diego State",NA,NA,NA,89,123,82,45,0,122,0,57,43,100,47,0,189,53,136,123,44,79,18,0.202247191011236,382,12.303664921466
"3887",2009,"San Francisco",NA,NA,NA,28,36,9,7,0,35,0,7,14,21,10,0,48,9,39,56,16,40,5,0.178571428571429,98,10.2040816326531
"3888",2009,"San José State",NA,NA,NA,21,56,29,16,0,60,1,20,28,48,22,0,66,20,46,47,18,29,5,0.238095238095238,143,15.3846153846154
"3889",2009,"Santa Clara",NA,NA,NA,12,28,8,6,0,10,0,3,6,9,5,0,23,7,16,20,5,15,1,0.0833333333333333,59,8.47457627118644
"3890",2009,"Savannah State",NA,NA,NA,29,67,34,17,0,57,0,16,13,29,25,0,84,23,61,38,9,29,2,0.0689655172413793,151,16.5562913907285
"3891",2009,"Seton Hall",NA,NA,NA,252,408,256,162,0,310,3,163,117,280,138,0,527,177,350,229,67,162,69,0.273809523809524,1130,12.212389380531
"3892",2009,"Siena",NA,NA,NA,46,98,36,23,0,68,0,24,27,51,27,0,112,45,67,69,23,46,9,0.195652173913043,248,10.8870967741935
"3893",2009,"South Alabama",NA,NA,NA,35,68,36,17,0,61,0,36,22,58,29,0,61,20,41,60,21,39,11,0.314285714285714,186,15.5913978494624
"3894",2009,"South Carolina",NA,NA,NA,238,439,239,146,0,314,0,131,92,223,123,0,548,181,367,263,83,180,54,0.226890756302521,1136,10.8274647887324
"3895",2009,"South Carolina State",NA,NA,NA,28,47,32,19,0,36,0,8,11,19,9,0,65,20,45,25,6,19,3,0.107142857142857,116,7.75862068965517
"3896",2009,"South Carolina Upstate",NA,NA,NA,19,26,2,1,0,15,0,12,16,28,6,0,22,6,16,28,8,20,2,0.105263157894737,72,8.33333333333333
"3897",2009,"South Dakota",NA,NA,NA,5,21,6,5,0,14,0,0,0,0,8,0,27,10,17,28,14,14,1,0.2,53,15.0943396226415
"3898",2009,"South Dakota State",NA,NA,NA,114,282,140,98,0,180,0,114,93,207,65,0,142,56,86,250,92,158,25,0.219298245614035,694,9.36599423631124
"3899",2009,"South Florida",NA,NA,NA,400,641,402,240,0,428,2,369,248,617,213,0,483,148,335,531,198,333,115,0.2875,1862,11.4393125671321
"3900",2009,"Southeast Missouri State",NA,NA,NA,32,43,19,10,0,32,0,7,19,26,18,0,44,9,35,50,5,45,3,0.09375,100,18
"3901",2009,"Southern",NA,NA,NA,95,145,61,35,0,126,0,41,58,99,44,0,190,46,144,85,24,61,17,0.178947368421053,362,12.1546961325967
"3902",2009,"Southern Illinois",NA,NA,NA,14,15,11,7,0,23,0,6,7,13,4,0,24,2,22,17,4,13,1,0.0714285714285714,44,9.09090909090909
"3903",2009,"Southern Miss",NA,NA,NA,108,196,125,73,0,172,1,82,46,128,43,0,212,71,141,96,28,68,29,0.268518518518519,511,8.41487279843444
"3904",2009,"Southern Utah",NA,NA,NA,11,33,10,6,0,20,0,0,0,0,7,0,45,17,28,12,4,8,2,0.181818181818182,67,10.4477611940298
"3905",2009,"St. Bonaventure",NA,NA,NA,23,39,19,10,0,26,0,17,13,30,19,0,40,14,26,42,13,29,7,0.304347826086957,107,17.7570093457944
"3906",2009,"St. Francis (PA)",NA,NA,NA,84,141,74,45,0,120,0,43,46,89,38,0,168,69,99,122,34,88,16,0.19047619047619,390,9.74358974358974
"3907",2009,"St. Francis Brooklyn",NA,NA,NA,10,19,12,5,0,11,0,12,6,18,9,0,14,3,11,20,5,15,2,0.2,51,17.6470588235294
"3908",2009,"St. John's",NA,NA,NA,387,721,442,258,0,494,1,185,146,331,229,0,1040,396,644,386,141,245,99,0.255813953488372,1950,11.7435897435897
"3909",2009,"Stanford",NA,NA,NA,406,719,360,224,0,350,0,396,216,612,141,0,495,175,320,433,141,292,137,0.33743842364532,1939,7.2717895822589
"3910",2009,"Stephen F. Austin",NA,NA,NA,33,55,24,12,0,59,0,14,12,26,26,0,87,25,62,54,20,34,11,0.333333333333333,152,17.1052631578947
"3911",2009,"Stetson",NA,NA,NA,35,67,39,19,0,57,0,21,26,47,23,0,95,27,68,35,8,27,3,0.0857142857142857,168,13.6904761904762
"3912",2009,"Stony Brook",NA,NA,NA,51,81,49,32,0,94,0,18,27,45,36,0,150,45,105,37,11,26,12,0.235294117647059,219,16.4383561643836
"3913",2009,"Syracuse",NA,NA,NA,458,662,448,303,0,430,3,302,212,514,235,0,716,220,496,463,134,329,111,0.24235807860262,1911,12.2972265829409
"3914",2009,"TCU",NA,NA,NA,67,152,71,50,0,102,0,34,22,56,37,0,191,64,127,111,42,69,14,0.208955223880597,380,9.73684210526316
"3915",2009,"Temple",NA,NA,NA,71,153,81,49,0,113,0,65,43,108,37,0,134,51,83,95,22,73,21,0.295774647887324,387,9.56072351421188
"3916",2009,"Tennessee",NA,NA,NA,551,747,494,298,0,515,2,314,208,522,116,0,859,284,575,460,148,312,135,0.245009074410163,2166,5.35549399815328
"3917",2009,"Tennessee State",NA,NA,NA,52,68,70,45,0,80,0,20,15,35,33,0,110,36,74,85,20,65,11,0.211538461538462,215,15.3488372093023
"3918",2009,"Tennessee Tech",NA,NA,NA,45,79,38,19,0,53,0,36,33,69,14,0,49,14,35,56,15,41,7,0.155555555555556,200,7
"3919",2009,"Texas",NA,NA,NA,361,661,387,257,0,445,1,247,164,411,208,0,725,241,484,363,123,240,83,0.229916897506925,1758,11.8316268486917
"3920",2009,"Texas A&M",NA,NA,NA,382,618,345,217,0,546,1,269,168,437,315,0,960,383,577,303,96,207,111,0.290575916230366,1850,17.027027027027
"3921",2009,"Texas A&M-Corpus Christi",NA,NA,NA,77,105,53,35,0,77,1,40,48,88,31,0,132,41,91,71,13,58,15,0.194805194805195,292,10.6164383561644
"3922",2009,"Texas Southern",NA,NA,NA,25,47,21,12,0,30,0,9,17,26,16,0,57,18,39,10,3,7,5,0.2,108,14.8148148148148
"3923",2009,"Texas State",NA,NA,NA,45,64,44,25,0,58,0,27,28,55,22,0,108,37,71,35,7,28,8,0.177777777777778,194,11.340206185567
"3924",2009,"Texas Tech",NA,NA,NA,282,600,313,204,0,401,3,128,63,191,195,0,831,293,538,292,88,204,52,0.184397163120567,1475,13.2203389830508
"3925",2009,"Toledo",NA,NA,NA,34,68,37,22,0,53,0,27,18,45,25,0,75,21,54,49,15,34,7,0.205882352941176,172,14.5348837209302
"3926",2009,"Towson",NA,NA,NA,58,80,51,29,0,62,0,43,34,77,50,0,99,33,66,43,14,29,19,0.327586206896552,245,20.4081632653061
"3927",2009,"Troy",NA,NA,NA,41,93,56,36,0,77,1,23,32,55,38,0,101,32,69,54,15,39,10,0.24390243902439,218,17.4311926605505
"3928",2009,"Tulane",NA,NA,NA,51,87,65,33,0,68,0,43,35,78,16,0,84,30,54,54,9,45,13,0.254901960784314,233,6.86695278969957
"3929",2009,"Tulsa",NA,NA,NA,52,73,31,18,0,47,0,21,21,42,21,0,89,25,64,45,11,34,18,0.346153846153846,189,11.1111111111111
"3930",2009,"UAB",NA,NA,NA,83,161,89,52,0,114,1,49,56,105,43,0,144,44,100,138,48,90,14,0.168674698795181,400,10.75
"3931",2009,"UC Davis",NA,NA,NA,38,102,58,37,0,83,2,42,41,83,27,0,51,18,33,80,30,50,6,0.157894736842105,244,11.0655737704918
"3932",2009,"UC Irvine",NA,NA,NA,9,27,8,5,0,23,0,10,14,24,2,0,19,9,10,9,3,6,3,0.333333333333333,61,3.27868852459016
"3933",2009,"UC Riverside",NA,NA,NA,13,37,13,5,0,25,0,17,13,30,15,0,59,22,37,20,6,14,5,0.384615384615385,96,15.625
"3934",2009,"UC Santa Barbara",NA,NA,NA,49,120,41,24,0,65,0,33,19,52,37,0,139,41,98,69,27,42,13,0.26530612244898,281,13.1672597864769
"3935",2009,"UCF",NA,NA,NA,132,159,102,60,0,131,1,92,103,195,52,0,161,43,118,97,32,65,35,0.265151515151515,481,10.8108108108108
"3936",2009,"UCLA",NA,NA,NA,59,97,50,28,0,83,0,42,22,64,29,0,120,34,86,48,23,25,13,0.220338983050847,268,10.8208955223881
"3937",2009,"UConn",NA,NA,NA,485,1005,515,339,0,432,2,548,246,794,138,0,635,256,379,672,251,421,146,0.301030927835052,2688,5.13392857142857
"3938",2009,"UIC",NA,NA,NA,12,19,17,7,0,14,0,8,8,16,5,0,20,4,16,22,9,13,4,0.333333333333333,55,9.09090909090909
"3939",2009,"UL Monroe",NA,NA,NA,63,100,44,28,0,67,0,43,35,78,35,0,134,39,95,48,12,36,14,0.222222222222222,269,13.0111524163569
"3940",2009,"UMBC",NA,NA,NA,14,28,35,25,0,26,0,6,12,18,14,0,25,10,15,12,5,7,1,0.0714285714285714,72,19.4444444444444
"3941",2009,"UMass",NA,NA,NA,58,120,67,45,0,69,0,62,78,140,34,0,55,12,43,94,31,63,16,0.275862068965517,300,11.3333333333333
"3942",2009,"UNC Asheville",NA,NA,NA,14,24,3,2,0,15,0,5,1,6,5,0,36,10,26,28,8,20,5,0.357142857142857,61,8.19672131147541
"3943",2009,"UNC Greensboro",NA,NA,NA,23,53,23,13,0,29,0,10,10,20,24,0,54,11,43,27,6,21,3,0.130434782608696,110,21.8181818181818
"3944",2009,"UNC Wilmington",NA,NA,NA,22,45,22,16,0,28,0,12,5,17,15,0,64,22,42,26,6,20,3,0.136363636363636,116,12.9310344827586
"3945",2009,"UNLV",NA,NA,NA,49,104,47,31,0,73,0,33,30,63,24,0,84,31,53,84,32,52,10,0.204081632653061,266,9.02255639097744
"3946",2009,"USC",NA,NA,NA,83,167,77,57,0,132,0,77,49,126,55,0,173,48,125,143,49,94,16,0.192771084337349,447,12.3042505592841
"3947",2009,"UT Arlington",NA,NA,NA,71,143,82,57,0,84,1,53,37,90,34,0,154,40,114,87,32,55,17,0.23943661971831,366,9.2896174863388
"3948",2009,"UT Martin",NA,NA,NA,79,99,50,30,0,86,0,29,48,77,28,0,127,30,97,66,13,53,13,0.164556962025316,261,10.727969348659
"3949",2009,"UT Rio Grande Valley",NA,NA,NA,21,34,11,7,0,35,0,6,9,15,13,0,49,13,36,31,10,21,3,0.142857142857143,87,14.9425287356322
"3950",2009,"UTEP",NA,NA,NA,54,79,35,21,0,58,0,29,25,54,12,0,103,28,75,70,27,43,9,0.166666666666667,226,5.30973451327434
"3951",2009,"UTSA",NA,NA,NA,49,97,49,31,0,60,0,31,32,63,22,0,83,21,62,80,32,48,10,0.204081632653061,244,9.01639344262295
"3952",2009,"Utah",NA,NA,NA,73,218,96,71,0,124,1,85,34,119,49,0,171,55,116,108,36,72,14,0.191780821917808,486,10.082304526749
"3953",2009,"Utah State",NA,NA,NA,52,79,50,27,0,43,0,24,22,46,20,0,86,27,59,31,8,23,11,0.211538461538462,197,10.1522842639594
"3954",2009,"VCU",NA,NA,NA,14,20,8,6,0,17,0,9,11,20,5,0,24,7,17,13,2,11,4,0.285714285714286,55,9.09090909090909
"3955",2009,"Valley City State",NA,NA,NA,9,17,7,4,0,13,0,7,8,15,2,0,18,6,12,22,5,17,0,0,46,4.34782608695652
"3956",2009,"Valparaiso",NA,NA,NA,45,95,53,35,0,67,0,37,37,74,36,0,76,23,53,66,27,39,8,0.177777777777778,238,15.1260504201681
"3957",2009,"Vanderbilt",NA,NA,NA,355,617,384,254,0,473,2,363,230,593,270,0,550,200,350,471,173,298,99,0.27887323943662,1809,14.9253731343284
"3958",2009,"Vermont",NA,NA,NA,80,159,94,66,0,131,0,64,53,117,49,0,200,75,125,88,29,59,15,0.1875,434,11.2903225806452
"3959",2009,"Villanova",NA,NA,NA,161,544,177,132,0,374,0,151,129,280,120,0,292,110,182,640,192,448,37,0.229813664596273,1220,9.83606557377049
"3960",2009,"Virginia",NA,NA,NA,496,733,480,308,0,494,0,334,260,594,256,0,910,321,589,340,100,240,124,0.25,2122,12.0640904806786
"3961",2009,"Virginia Tech",NA,NA,NA,293,557,292,175,0,313,2,278,200,478,184,0,595,204,391,291,79,212,77,0.262798634812287,1486,12.3822341857335
"3962",2009,"Wagner",NA,NA,NA,36,97,51,35,0,84,0,37,32,69,32,0,96,32,64,54,11,43,7,0.194444444444444,227,14.0969162995595
"3963",2009,"Wake Forest",NA,NA,NA,350,601,317,197,0,436,1,175,161,336,320,0,748,271,477,511,149,362,86,0.245714285714286,1644,19.4647201946472
"3964",2009,"Washington",NA,NA,NA,55,68,53,31,0,81,0,39,39,78,31,0,88,24,64,68,11,57,11,0.2,215,14.4186046511628
"3965",2009,"Washington State",NA,NA,NA,47,68,34,19,0,62,0,11,18,29,16,0,81,25,56,69,21,48,8,0.170212765957447,177,9.03954802259887
"3966",2009,"Weber State",NA,NA,NA,47,94,63,45,0,55,0,32,27,59,20,0,92,26,66,66,20,46,15,0.319148936170213,237,8.43881856540084
"3967",2009,"West Virginia",NA,NA,NA,396,638,385,208,0,452,3,278,179,457,220,1,621,185,436,458,139,319,83,0.20959595959596,1737,12.6655152561888
"3968",2009,"West Virginia St.",NA,NA,NA,13,15,4,3,0,16,0,5,10,15,7,0,32,5,27,16,4,12,1,0.0769230769230769,43,16.2790697674419
"3969",2009,"Western Illinois",NA,NA,NA,57,158,64,36,0,113,1,27,40,67,36,0,185,66,119,85,29,56,11,0.192982456140351,356,10.1123595505618
"3970",2009,"Western Kentucky",NA,NA,NA,57,99,58,35,0,72,0,39,28,67,26,0,118,32,86,52,16,36,17,0.298245614035088,255,10.1960784313725
"3971",2009,"Western Michigan",NA,NA,NA,73,81,54,32,0,68,0,40,15,55,25,0,148,43,105,56,12,44,17,0.232876712328767,261,9.57854406130268
"3972",2009,"Westminster (UT)",NA,NA,NA,17,16,3,3,0,9,0,7,5,12,12,0,19,4,15,27,7,20,5,0.294117647058824,51,23.5294117647059
"3973",2009,"Wichita State",NA,NA,NA,32,54,29,20,0,42,0,18,19,37,8,0,61,22,39,24,6,18,7,0.21875,139,5.75539568345324
"3974",2009,"William & Mary",NA,NA,NA,15,27,9,5,0,12,0,16,9,25,9,0,23,9,14,26,8,18,6,0.4,79,11.3924050632911
"3975",2009,"Winston Salem",NA,NA,NA,20,54,27,17,0,36,0,15,20,35,13,0,46,12,34,23,5,18,4,0.2,115,11.304347826087
"3976",2009,"Winthrop",NA,NA,NA,23,57,25,15,0,43,0,26,13,39,17,0,66,15,51,43,11,32,5,0.217391304347826,140,12.1428571428571
"3977",2009,"Wofford",NA,NA,NA,16,30,8,4,0,23,0,0,0,0,7,0,44,8,36,26,6,20,1,0.0625,60,11.6666666666667
"3978",2009,"Wright State",NA,NA,NA,45,48,25,13,0,42,0,27,15,42,23,0,72,18,54,44,13,31,8,0.177777777777778,158,14.5569620253165
"3979",2009,"Wyoming",NA,NA,NA,58,100,57,38,0,65,0,43,25,68,32,0,82,27,55,91,29,62,14,0.241379310344828,273,11.7216117216117
"3980",2009,"Xavier",NA,NA,NA,355,715,298,174,0,330,0,264,204,468,144,0,498,167,331,458,159,299,93,0.261971830985915,1742,8.26636050516648
"3981",2009,"Yale",NA,NA,NA,23,23,17,12,0,15,0,20,22,42,6,0,20,3,17,10,2,8,9,0.391304347826087,79,7.59493670886076
"3982",2009,"Youngstown State",NA,NA,NA,39,55,35,20,0,59,0,7,7,14,21,0,114,38,76,40,6,34,9,0.230769230769231,153,13.7254901960784
"3983",2010,"Alabama",NA,NA,NA,127,254,116,65,0,175,1,99,56,155,66,2,279,88,191,129,30,99,23,0.181102362204724,627,10.5263157894737
"3984",2010,"Alabama A&M",NA,NA,NA,18,23,13,9,0,17,0,4,1,5,4,0,44,14,30,10,2,8,2,0.111111111111111,68,5.88235294117647
"3985",2010,"Alabama State",NA,NA,NA,31,73,28,17,0,63,0,16,23,39,22,0,74,20,54,40,14,26,4,0.129032258064516,158,13.9240506329114
"3986",2010,"Albany",NA,NA,NA,14,43,9,5,0,32,0,8,4,12,19,0,82,25,57,26,8,18,2,0.142857142857143,101,18.8118811881188
"3987",2010,"Alcorn State",NA,NA,NA,13,16,4,3,0,21,0,2,5,7,9,0,30,7,23,29,9,20,2,0.153846153846154,50,18
"3988",2010,"American University",NA,NA,NA,19,18,17,9,0,11,0,7,13,20,12,0,15,4,11,20,2,18,2,0.105263157894737,51,23.5294117647059
"3989",2010,"Appalachian State",NA,NA,NA,11,29,9,6,0,20,0,12,7,19,5,0,27,6,21,12,4,8,2,0.181818181818182,64,7.8125
"3990",2010,"Arizona",NA,NA,NA,60,133,68,41,0,77,0,50,49,99,33,0,114,41,73,74,27,47,18,0.3,331,9.96978851963746
"3991",2010,"Arizona State",NA,NA,NA,169,267,165,98,0,213,2,149,130,279,89,0,240,82,158,100,27,73,41,0.242603550295858,736,12.0923913043478
"3992",2010,"Arkansas",NA,NA,NA,164,305,147,95,0,236,2,135,89,224,123,0,319,83,236,241,74,167,31,0.189024390243902,799,15.3942428035044
"3993",2010,"Arkansas State",NA,NA,NA,25,22,15,9,0,26,0,5,3,8,12,0,58,25,33,8,2,6,6,0.24,82,14.6341463414634
"3994",2010,"Arkansas-Pine Bluff",NA,NA,NA,55,92,56,32,0,89,0,27,29,56,32,0,121,40,81,75,18,57,15,0.272727272727273,249,12.85140562249
"3995",2010,"Army",NA,NA,NA,15,25,15,9,0,19,0,5,11,16,7,0,20,3,17,20,6,14,4,0.266666666666667,59,11.864406779661
"3996",2010,"Auburn",NA,NA,NA,236,352,207,115,0,207,2,116,86,202,87,0,448,166,282,183,56,127,46,0.194915254237288,978,8.89570552147239
"3997",2010,"Austin Peay",NA,NA,NA,68,119,72,43,0,84,0,26,26,52,24,0,140,46,94,86,18,68,17,0.25,294,8.16326530612245
"3998",2010,"Ball State",NA,NA,NA,17,45,18,11,0,32,0,7,6,13,11,0,56,29,27,34,8,26,6,0.352941176470588,114,9.64912280701754
"3999",2010,"Baylor",NA,NA,NA,389,1000,552,361,3,444,1,266,122,388,228,0,1109,465,644,292,78,214,109,0.280205655526992,2356,9.67741935483871
"4000",2010,"Belmont",NA,NA,NA,11,20,17,11,0,17,0,4,8,12,5,0,24,8,16,19,5,14,2,0.181818181818182,56,8.92857142857143
"4001",2010,"Bethune-Cookman",NA,NA,NA,15,26,11,6,0,15,0,4,10,14,10,0,42,11,31,13,3,10,4,0.266666666666667,60,16.6666666666667
"4002",2010,"Binghamton",NA,NA,NA,35,52,21,9,0,41,0,28,13,41,21,0,56,17,39,70,25,45,7,0.2,162,12.962962962963
"4003",2010,"Boise State",NA,NA,NA,34,60,18,9,2,40,0,15,19,34,15,0,46,15,31,50,15,35,5,0.147058823529412,143,10.4895104895105
"4004",2010,"Boston College",NA,NA,NA,179,294,149,100,0,203,0,135,119,254,82,0,252,96,156,245,78,167,51,0.284916201117318,820,10
"4005",2010,"Boston University",NA,NA,NA,21,52,24,12,0,39,0,9,11,20,9,0,64,25,39,31,5,26,3,0.142857142857143,118,7.6271186440678
"4006",2010,"Bowling Green",NA,NA,NA,46,102,54,34,0,69,1,31,30,61,25,0,91,26,65,71,32,39,12,0.260869565217391,249,10.0401606425703
"4007",2010,"Bradley",NA,NA,NA,13,25,9,3,0,14,0,2,1,3,6,0,43,7,36,25,7,18,0,0,56,10.7142857142857
"4008",2010,"Buffalo",NA,NA,NA,15,23,14,7,0,18,0,13,9,22,9,0,15,5,10,18,6,12,6,0.4,66,13.6363636363636
"4009",2010,"Butler",NA,NA,NA,15,48,27,17,0,36,0,28,14,42,13,0,28,11,17,39,9,30,5,0.333333333333333,118,11.0169491525424
"4010",2010,"Cal State Fullerton",NA,NA,NA,38,41,33,25,0,42,0,15,18,33,14,0,65,19,46,39,10,29,6,0.157894736842105,133,10.5263157894737
"4011",2010,"California",NA,NA,NA,217,327,196,111,0,206,0,169,85,254,109,0,364,105,259,163,40,123,62,0.285714285714286,908,12.0044052863436
"4012",2010,"Canisius",NA,NA,NA,8,25,7,4,0,21,1,3,11,14,10,0,22,5,17,20,7,13,0,0,49,20.4081632653061
"4013",2010,"Centenary",NA,NA,NA,9,24,2,1,0,23,0,3,8,11,5,0,24,3,21,9,2,7,2,0.222222222222222,42,11.9047619047619
"4014",2010,"Central Michigan",NA,NA,NA,37,90,64,41,0,65,1,23,17,40,37,0,61,20,41,89,31,58,11,0.297297297297297,223,16.5919282511211
"4015",2010,"Charleston",NA,NA,NA,13,31,14,8,0,30,0,0,0,0,10,0,38,16,22,26,5,21,2,0.153846153846154,70,14.2857142857143
"4016",2010,"Charleston Southern",NA,NA,NA,24,19,10,6,0,13,0,0,0,0,11,0,23,4,19,48,17,31,4,0.166666666666667,66,16.6666666666667
"4017",2010,"Charlotte",NA,NA,NA,51,89,35,20,0,68,0,31,36,67,43,0,103,25,78,54,14,40,5,0.0980392156862745,220,19.5454545454545
"4018",2010,"Chattanooga",NA,NA,NA,54,133,59,41,0,74,0,46,36,82,23,0,64,14,50,125,42,83,13,0.240740740740741,305,7.54098360655738
"4019",2010,"Cincinnati",NA,NA,NA,184,383,192,119,0,226,1,124,105,229,118,0,387,118,269,282,94,188,48,0.260869565217391,957,12.3301985370951
"4020",2010,"Cleveland State",NA,NA,NA,49,92,60,35,0,65,0,55,22,77,33,0,72,20,52,79,20,59,14,0.285714285714286,256,12.890625
"4021",2010,"Coastal Carolina",NA,NA,NA,10,13,12,6,0,17,0,5,3,8,10,0,30,10,20,12,1,11,1,0.1,41,24.390243902439
"4022",2010,"Colorado",NA,NA,NA,218,396,173,119,0,299,2,166,132,298,143,0,302,99,203,379,129,250,56,0.256880733944954,1063,13.4524929444967
"4023",2010,"Colorado State",NA,NA,NA,34,38,11,8,0,28,0,22,16,38,14,0,46,10,36,48,7,41,9,0.264705882352941,117,11.965811965812
"4024",2010,"Columbia",NA,NA,NA,20,48,32,19,0,31,1,21,20,41,12,0,34,11,23,36,13,23,7,0.35,122,9.83606557377049
"4025",2010,"Coppin State",NA,NA,NA,58,89,41,23,0,67,0,43,42,85,28,0,102,32,70,40,6,34,10,0.172413793103448,241,11.6182572614108
"4026",2010,"Cornell",NA,NA,NA,9,18,13,9,0,21,0,2,0,2,2,0,32,8,24,14,5,9,1,0.111111111111111,42,4.76190476190476
"4027",2010,"Creighton",NA,NA,NA,54,117,66,44,0,101,0,32,27,59,37,0,148,47,101,73,18,55,9,0.166666666666667,286,12.9370629370629
"4028",2010,"Dartmouth",NA,NA,NA,13,38,21,12,0,21,0,8,6,14,17,0,29,5,24,43,12,31,2,0.153846153846154,80,21.25
"4029",2010,"Davidson",NA,NA,NA,7,23,23,14,0,31,0,8,0,8,10,0,40,14,26,3,0,3,4,0.571428571428571,61,16.3934426229508
"4030",2010,"Dayton",NA,NA,NA,120,229,141,82,0,153,0,62,37,99,58,0,288,104,184,175,57,118,32,0.266666666666667,607,9.55518945634267
"4031",2010,"DePaul",NA,NA,NA,209,398,172,122,0,269,1,178,87,265,141,0,411,152,259,249,65,184,55,0.263157894736842,1067,13.2146204311153
"4032",2010,"Delaware State",NA,NA,NA,28,34,21,14,0,32,0,8,16,24,22,0,42,2,40,26,5,21,3,0.107142857142857,84,26.1904761904762
"4033",2010,"Denver",NA,NA,NA,7,20,20,13,0,18,0,14,18,32,6,0,9,5,4,1,0,1,3,0.428571428571429,51,11.7647058823529
"4034",2010,"Detroit Mercy",NA,NA,NA,16,55,12,10,0,32,0,19,11,30,6,0,33,7,26,39,10,29,4,0.25,114,5.26315789473684
"4035",2010,"Drake",NA,NA,NA,11,19,9,5,0,19,0,7,7,14,4,0,25,14,11,19,7,12,3,0.272727272727273,63,6.34920634920635
"4036",2010,"Drexel",NA,NA,NA,24,35,29,19,0,33,0,15,20,35,17,0,43,17,26,34,10,24,4,0.166666666666667,109,15.5963302752294
"4037",2010,"Duke",NA,NA,NA,481,672,374,232,0,462,1,299,217,516,345,0,778,259,519,384,115,269,99,0.205821205821206,1930,17.8756476683938
"4038",2010,"Duquesne",NA,NA,NA,23,46,28,18,0,31,0,11,7,18,20,0,51,19,32,50,13,37,3,0.130434782608696,120,16.6666666666667
"4039",2010,"East Tennessee State",NA,NA,NA,77,125,73,47,0,103,1,33,47,80,37,0,166,54,112,102,33,69,11,0.142857142857143,344,10.7558139534884
"4040",2010,"Eastern Illinois",NA,NA,NA,22,49,34,18,0,40,1,18,14,32,17,0,46,12,34,48,14,34,4,0.181818181818182,121,14.0495867768595
"4041",2010,"Eastern Kentucky",NA,NA,NA,13,50,16,8,0,35,0,7,9,16,10,0,40,13,27,34,13,21,0,0,100,10
"4042",2010,"Eastern Michigan",NA,NA,NA,16,30,16,9,0,19,0,11,10,21,11,0,29,8,21,15,2,13,3,0.1875,71,15.4929577464789
"4043",2010,"Elon",NA,NA,NA,10,20,13,7,0,18,0,7,10,17,10,0,22,6,16,14,3,11,3,0.3,49,20.4081632653061
"4044",2010,"Evansville",NA,NA,NA,23,45,16,10,0,24,1,14,18,32,11,0,49,17,32,24,5,19,5,0.217391304347826,111,9.90990990990991
"4045",2010,"Fairleigh Dickinson",NA,NA,NA,11,27,6,4,0,15,0,6,7,13,3,0,22,5,17,27,6,21,2,0.181818181818182,57,5.26315789473684
"4046",2010,"Florida",NA,NA,NA,209,282,148,93,0,243,0,117,93,210,101,0,247,70,177,330,101,229,38,0.181818181818182,826,12.227602905569
"4047",2010,"Florida A&M",NA,NA,NA,79,129,56,34,0,98,0,42,58,100,36,0,130,34,96,77,23,54,15,0.189873417721519,321,11.214953271028
"4048",2010,"Florida Atlantic",NA,NA,NA,10,19,7,4,0,23,0,0,0,0,4,0,28,8,20,23,6,17,2,0.2,45,8.88888888888889
"4049",2010,"Florida Gulf Coast",NA,NA,NA,18,34,29,17,0,31,0,21,27,48,17,0,13,1,12,49,17,32,6,0.333333333333333,100,17
"4050",2010,"Florida International",NA,NA,NA,6,18,11,6,0,16,0,7,3,10,4,0,14,3,11,21,11,10,3,0.5,47,8.51063829787234
"4051",2010,"Florida State",NA,NA,NA,478,909,521,338,0,577,1,386,252,638,291,0,813,290,523,540,205,335,137,0.286610878661088,2417,12.0397186594952
"4052",2010,"Fresno State",NA,NA,NA,59,110,43,30,2,76,1,35,26,61,35,0,118,34,84,129,34,95,16,0.271186440677966,286,12.2377622377622
"4053",2010,"Furman",NA,NA,NA,47,83,40,25,0,77,0,28,35,63,28,0,84,16,68,64,15,49,6,0.127659574468085,199,14.070351758794
"4054",2010,"Gardner-Webb",NA,NA,NA,13,31,14,12,0,25,0,0,0,0,14,0,49,19,30,15,2,13,4,0.307692307692308,70,20
"4055",2010,"George Mason",NA,NA,NA,13,20,7,4,0,15,0,6,9,15,8,0,24,5,19,21,5,16,4,0.307692307692308,52,15.3846153846154
"4056",2010,"George Washington",NA,NA,NA,19,43,13,8,0,29,0,12,8,20,21,0,61,22,39,31,6,25,3,0.157894736842105,106,19.811320754717
"4057",2010,"Georgia",NA,NA,NA,393,691,370,232,0,386,0,216,168,384,206,0,678,222,456,481,135,346,90,0.229007633587786,1765,11.671388101983
"4058",2010,"Georgia Southern",NA,NA,NA,35,59,27,15,0,51,0,20,30,50,29,0,52,18,34,56,16,40,10,0.285714285714286,153,18.9542483660131
"4059",2010,"Georgia State",NA,NA,NA,8,18,14,7,0,18,0,8,6,14,9,0,30,9,21,9,3,6,3,0.375,50,18
"4060",2010,"Georgia Tech",NA,NA,NA,183,258,154,96,0,198,0,122,94,216,98,0,290,107,183,110,22,88,46,0.251366120218579,732,13.3879781420765
"4061",2010,"Gonzaga",NA,NA,NA,79,148,62,36,0,79,1,82,57,139,59,0,171,61,110,84,29,55,15,0.189873417721519,418,14.1148325358852
"4062",2010,"Grambling",NA,NA,NA,14,23,13,9,0,14,0,3,3,6,0,0,38,15,23,16,4,12,5,0.357142857142857,62,0
"4063",2010,"Green Bay",NA,NA,NA,71,152,95,70,0,133,0,75,36,111,74,0,130,52,78,119,38,81,15,0.211267605633803,415,17.8313253012048
"4064",2010,"Hampton",NA,NA,NA,9,20,7,3,0,19,0,2,2,4,7,0,35,9,26,15,4,11,1,0.111111111111111,45,15.5555555555556
"4065",2010,"Hartford",NA,NA,NA,103,237,109,74,0,126,3,83,57,140,54,0,178,63,115,142,38,104,32,0.310679611650485,556,9.71223021582734
"4066",2010,"Harvard",NA,NA,NA,28,40,25,15,0,34,0,14,22,36,10,0,48,12,36,44,15,29,3,0.107142857142857,117,8.54700854700855
"4067",2010,"Hawai'i",NA,NA,NA,19,50,30,19,0,40,0,13,9,22,13,0,55,11,44,19,3,16,5,0.263157894736842,102,12.7450980392157
"4068",2010,"High Point",NA,NA,NA,14,35,16,10,0,33,0,16,11,27,19,0,62,25,37,24,3,21,4,0.285714285714286,99,19.1919191919192
"4069",2010,"Hofstra",NA,NA,NA,20,44,30,16,0,40,0,20,8,28,21,0,46,13,33,28,10,18,3,0.15,116,18.1034482758621
"4070",2010,"Holy Cross",NA,NA,NA,27,51,40,26,0,51,0,14,26,40,14,0,57,12,45,49,16,33,3,0.111111111111111,133,10.5263157894737
"4071",2010,"Houston",NA,NA,NA,58,104,48,32,0,61,0,44,37,81,33,0,113,25,88,58,15,43,13,0.224137931034483,265,12.4528301886792
"4072",2010,"Houston Christian",NA,NA,NA,5,20,4,2,0,20,0,5,5,10,2,0,26,5,21,13,3,10,0,0,39,5.12820512820513
"4073",2010,"Howard",NA,NA,NA,16,18,14,8,0,13,0,6,8,14,5,0,30,10,20,17,2,15,4,0.25,55,9.09090909090909
"4074",2010,"IUPUI",NA,NA,NA,17,29,5,2,0,22,0,9,12,21,2,0,27,5,22,9,1,8,4,0.235294117647059,62,3.2258064516129
"4075",2010,"Idaho",NA,NA,NA,21,44,7,3,0,28,0,8,8,16,10,0,42,14,28,62,15,47,6,0.285714285714286,104,9.61538461538462
"4076",2010,"Idaho State",NA,NA,NA,20,34,19,11,0,38,0,1,3,4,14,0,58,21,37,33,8,25,2,0.1,86,16.2790697674419
"4077",2010,"Illinois",NA,NA,NA,120,301,125,75,0,193,0,93,26,119,96,0,358,131,227,148,41,107,42,0.35,720,13.3333333333333
"4078",2010,"Illinois State",NA,NA,NA,23,50,18,13,0,39,0,20,2,22,7,0,63,14,49,29,9,20,11,0.478260869565217,121,5.78512396694215
"4079",2010,"Indiana",NA,NA,NA,142,248,141,87,0,172,0,121,96,217,79,0,243,75,168,167,53,114,36,0.253521126760563,674,11.7210682492582
"4080",2010,"Indiana State",NA,NA,NA,6,31,17,14,0,23,0,11,5,16,7,0,23,9,14,11,3,8,1,0.166666666666667,62,11.2903225806452
"4081",2010,"Iona",NA,NA,NA,10,45,14,8,0,37,0,10,15,25,12,0,29,9,20,32,10,22,2,0.2,89,13.4831460674157
"4082",2010,"Iowa",NA,NA,NA,165,358,151,106,0,214,1,117,73,190,82,0,306,105,201,310,110,200,42,0.254545454545455,895,9.16201117318436
"4083",2010,"Iowa State",NA,NA,NA,303,613,290,191,0,367,1,170,63,233,135,0,563,189,374,551,200,351,69,0.227722772277228,1567,8.61518825781749
"4084",2010,"Jackson State",NA,NA,NA,28,54,26,16,0,39,0,24,15,39,15,1,50,12,38,27,3,24,4,0.142857142857143,131,11.4503816793893
"4085",2010,"Jacksonville",NA,NA,NA,45,54,27,15,0,49,0,15,33,48,26,0,60,15,45,36,9,27,5,0.111111111111111,142,18.3098591549296
"4086",2010,"Jacksonville State",NA,NA,NA,11,19,5,2,0,18,0,0,0,0,3,0,48,11,37,23,7,16,0,0,50,6
"4087",2010,"James Madison",NA,NA,NA,134,207,118,73,0,142,0,78,59,137,56,0,216,80,136,143,47,96,27,0.201492537313433,583,9.60548885077187
"4088",2010,"Kansas City",NA,NA,NA,11,20,8,6,0,21,0,6,16,22,7,0,30,9,21,8,4,4,4,0.363636363636364,52,13.4615384615385
"4089",2010,"Kansas State",NA,NA,NA,189,379,179,121,0,272,0,87,53,140,89,0,458,162,296,346,115,231,56,0.296296296296296,974,9.13757700205339
"4090",2010,"Kean University",NA,NA,NA,9,23,9,6,0,22,0,3,15,18,8,0,9,3,6,27,9,18,1,0.111111111111111,50,16
"4091",2010,"Kennesaw State",NA,NA,NA,12,15,3,2,0,18,0,0,0,0,9,0,42,15,27,21,4,17,1,0.0833333333333333,47,19.1489361702128
"4092",2010,"Kentucky",NA,NA,NA,357,601,442,284,0,459,5,335,214,549,296,0,572,163,409,413,130,283,54,0.151260504201681,1708,17.3302107728337
"4093",2010,"LIU Brooklyn",NA,NA,NA,28,38,27,15,0,31,0,15,12,27,13,0,72,35,37,26,4,22,8,0.285714285714286,129,10.077519379845
"4094",2010,"La Salle",NA,NA,NA,8,21,6,4,0,10,0,2,4,6,5,0,25,7,18,26,8,18,1,0.125,49,10.2040816326531
"4095",2010,"Lafayette",NA,NA,NA,4,14,13,8,0,15,0,5,4,9,5,0,26,10,16,12,4,8,2,0.5,41,12.1951219512195
"4096",2010,"Lamar",NA,NA,NA,61,114,52,31,0,91,0,28,24,52,50,0,154,50,104,117,32,85,13,0.213114754098361,299,16.7224080267559
"4097",2010,"Lehigh",NA,NA,NA,33,65,31,20,0,52,1,23,22,45,18,0,51,12,39,64,17,47,9,0.272727272727273,160,11.25
"4098",2010,"Liberty",NA,NA,NA,40,57,29,21,0,64,0,55,31,86,24,0,56,18,38,28,6,22,12,0.3,188,12.7659574468085
"4099",2010,"Little Rock",NA,NA,NA,46,91,38,20,0,84,0,40,35,75,36,0,108,38,70,44,11,33,10,0.217391304347826,233,15.450643776824
"4100",2010,"Long Beach State",NA,NA,NA,22,54,26,18,0,44,1,14,19,33,7,0,46,17,29,41,14,27,6,0.272727272727273,129,5.42635658914729
"4101",2010,"Longwood",NA,NA,NA,31,82,48,30,0,84,1,25,37,62,29,0,99,27,72,55,16,39,7,0.225806451612903,194,14.9484536082474
"4102",2010,"Louisiana",NA,NA,NA,12,12,7,4,0,16,0,0,0,0,11,0,43,11,32,19,5,14,4,0.333333333333333,44,25
"4103",2010,"Louisiana Tech",NA,NA,NA,89,193,97,61,0,120,4,66,50,116,31,0,228,90,138,81,18,63,19,0.213483146067416,481,6.44490644490645
"4104",2010,"Louisville",NA,NA,NA,236,383,258,163,0,303,1,165,103,268,104,0,432,143,289,197,68,129,60,0.254237288135593,1070,9.7196261682243
"4105",2010,"Loyola Chicago",NA,NA,NA,11,17,3,1,0,14,0,5,7,12,5,0,25,5,20,10,3,7,2,0.181818181818182,41,12.1951219512195
"4106",2010,"Loyola Maryland",NA,NA,NA,11,33,12,8,0,15,0,10,8,18,9,0,16,9,7,25,8,17,2,0.181818181818182,75,12
"4107",2010,"Maine",NA,NA,NA,30,48,20,11,0,54,1,18,28,46,16,0,77,14,63,22,6,16,7,0.233333333333333,120,13.3333333333333
"4108",2010,"Manhattan",NA,NA,NA,16,46,37,21,0,33,0,28,30,58,16,0,25,7,18,32,9,23,5,0.3125,116,13.7931034482759
"4109",2010,"Marist",NA,NA,NA,24,57,25,17,0,23,0,12,12,24,9,0,39,11,28,45,8,37,2,0.0833333333333333,119,7.56302521008403
"4110",2010,"Marquette",NA,NA,NA,214,407,252,162,0,270,0,113,74,187,132,0,462,132,330,208,62,146,34,0.158878504672897,994,13.2796780684105
"4111",2010,"Marshall",NA,NA,NA,41,72,43,26,0,55,0,24,19,43,15,0,80,23,57,44,11,33,16,0.390243902439024,184,8.15217391304348
"4112",2010,"Maryland",NA,NA,NA,276,425,223,125,0,274,2,163,101,264,99,0,391,141,250,328,96,232,83,0.300724637681159,1156,8.56401384083045
"4113",2010,"Maryland-Eastern Shore",NA,NA,NA,17,28,14,6,0,14,0,7,5,12,3,0,37,9,28,10,2,8,3,0.176470588235294,66,4.54545454545455
"4114",2010,"McNeese",NA,NA,NA,17,20,14,8,0,23,0,3,4,7,7,0,33,7,26,14,4,10,1,0.0588235294117647,55,12.7272727272727
"4115",2010,"Memphis",NA,NA,NA,33,49,40,23,0,40,0,27,19,46,16,0,53,15,38,33,10,23,4,0.121212121212121,148,10.8108108108108
"4116",2010,"Mercer",NA,NA,NA,24,48,29,19,0,42,0,10,16,26,9,0,47,13,34,63,19,44,6,0.25,121,7.43801652892562
"4117",2010,"Miami",NA,NA,NA,256,401,219,141,0,274,1,198,121,319,152,0,430,118,312,300,92,208,58,0.2265625,1118,13.5957066189624
"4118",2010,"Miami (OH)",NA,NA,NA,22,35,39,26,0,52,1,18,21,39,21,0,56,10,46,23,7,16,4,0.181818181818182,108,19.4444444444444
"4119",2010,"Michigan",NA,NA,NA,126,310,133,79,0,205,1,103,61,164,117,0,295,136,159,220,75,145,28,0.222222222222222,787,14.866581956798
"4120",2010,"Michigan State",NA,NA,NA,250,458,276,173,0,319,3,171,157,328,126,0,413,148,265,257,75,182,54,0.216,1187,10.6149957877001
"4121",2010,"Middle Tennessee",NA,NA,NA,80,125,55,36,0,113,0,52,45,97,38,0,79,18,61,179,62,117,10,0.125,350,10.8571428571429
"4122",2010,"Milwaukee",NA,NA,NA,29,80,28,17,0,55,0,16,12,28,14,0,80,33,47,45,12,33,7,0.241379310344828,178,7.86516853932584
"4123",2010,"Minnesota",NA,NA,NA,177,294,172,123,0,209,0,29,39,68,127,0,424,177,247,198,77,121,47,0.265536723163842,798,15.9147869674185
"4124",2010,"Mississippi State",NA,NA,NA,249,424,237,141,0,294,2,150,111,261,155,0,437,180,257,380,129,251,66,0.265060240963855,1198,12.9382303839733
"4125",2010,"Mississippi Valley State",NA,NA,NA,42,90,62,31,0,93,0,18,13,31,23,0,113,31,82,51,14,37,11,0.261904761904762,212,10.8490566037736
"4126",2010,"Missouri",NA,NA,NA,207,305,186,110,0,226,0,128,82,210,125,0,396,124,272,236,64,172,50,0.241545893719807,875,14.2857142857143
"4127",2010,"Missouri State",NA,NA,NA,15,22,10,6,0,19,0,11,1,12,6,0,35,10,25,15,3,12,2,0.133333333333333,63,9.52380952380952
"4128",2010,"Monmouth",NA,NA,NA,31,31,18,11,0,30,0,11,17,28,12,0,69,19,50,24,5,19,6,0.193548387096774,103,11.6504854368932
"4129",2010,"Montana",NA,NA,NA,15,34,17,13,0,15,0,0,0,0,4,0,60,24,36,13,4,9,6,0.4,82,4.8780487804878
"4130",2010,"Montana State",NA,NA,NA,12,35,9,5,0,9,0,9,8,17,5,0,19,6,13,19,7,12,5,0.416666666666667,71,7.04225352112676
"4131",2010,"Morehead State",NA,NA,NA,13,29,11,7,0,16,0,7,6,13,7,0,28,10,18,27,12,15,6,0.461538461538462,75,9.33333333333333
"4132",2010,"Mount St. Mary's",NA,NA,NA,21,50,16,10,0,33,0,13,19,32,13,0,31,9,22,42,10,32,6,0.285714285714286,107,12.1495327102804
"4133",2010,"Murray State",NA,NA,NA,15,27,6,4,0,17,0,2,11,13,6,0,27,8,19,19,2,17,3,0.2,55,10.9090909090909
"4134",2010,"NC State",NA,NA,NA,257,443,255,166,0,330,1,159,137,296,179,0,495,159,336,284,93,191,55,0.214007782101167,1182,15.1438240270728
"4135",2010,"NJIT",NA,NA,NA,13,16,10,6,0,22,0,5,4,9,6,0,34,7,27,15,3,12,0,0,49,12.2448979591837
"4136",2010,"Nebraska",NA,NA,NA,334,737,515,334,0,392,1,256,85,341,214,0,724,289,435,546,187,359,96,0.287425149700599,1970,10.8629441624365
"4137",2010,"Nevada",NA,NA,NA,19,55,26,13,0,42,0,27,28,55,12,0,30,12,18,25,5,20,3,0.157894736842105,125,9.6
"4138",2010,"New Hampshire",NA,NA,NA,28,43,10,6,0,34,0,9,19,28,12,0,44,13,31,45,9,36,5,0.178571428571429,105,11.4285714285714
"4139",2010,"New Mexico",NA,NA,NA,42,64,39,27,0,47,0,32,31,63,25,0,42,10,32,70,19,51,3,0.0714285714285714,179,13.9664804469274
"4140",2010,"New Orleans",NA,NA,NA,8,28,5,2,0,21,0,2,6,8,2,0,24,7,17,7,4,3,2,0.25,50,4
"4141",2010,"Nicholls",NA,NA,NA,8,15,11,6,0,18,0,5,2,7,7,0,27,8,19,20,5,15,2,0.25,46,15.2173913043478
"4142",2010,"North Carolina A&T",NA,NA,NA,21,56,33,21,0,32,0,16,10,26,15,0,65,15,50,22,6,16,4,0.19047619047619,123,12.1951219512195
"4143",2010,"North Carolina Central",NA,NA,NA,43,78,44,24,0,66,0,18,19,37,25,0,103,28,75,71,20,51,6,0.13953488372093,200,12.5
"4144",2010,"North Dakota",NA,NA,NA,13,11,10,8,0,22,1,11,10,21,10,0,17,6,11,16,5,11,4,0.307692307692308,49,20.4081632653061
"4145",2010,"North Dakota State",NA,NA,NA,5,26,8,6,0,24,0,0,0,0,5,0,20,6,14,13,4,9,1,0.2,43,11.6279069767442
"4146",2010,"North Florida",NA,NA,NA,34,106,28,14,0,73,0,18,14,32,32,0,90,28,62,82,26,56,6,0.176470588235294,220,14.5454545454545
"4147",2010,"North Texas",NA,NA,NA,33,36,25,16,0,34,0,16,35,51,18,0,41,12,29,21,6,15,5,0.151515151515152,114,15.7894736842105
"4148",2010,"Northeastern",NA,NA,NA,7,12,8,5,0,15,0,1,2,3,7,0,24,5,19,30,5,25,0,0,32,21.875
"4149",2010,"Northern Colorado",NA,NA,NA,7,24,12,8,0,18,0,4,6,10,9,0,27,9,18,15,5,10,0,0,53,16.9811320754717
"4150",2010,"Northern Illinois",NA,NA,NA,32,46,19,13,0,38,1,15,7,22,20,0,67,15,52,31,11,20,8,0.25,125,16
"4151",2010,"Northern Iowa",NA,NA,NA,37,101,43,28,0,84,0,29,21,50,18,0,90,29,61,75,21,54,5,0.135135135135135,233,7.72532188841202
"4152",2010,"Northwestern",NA,NA,NA,40,99,44,31,0,45,0,24,9,33,25,0,110,40,70,65,20,45,13,0.325,232,10.7758620689655
"4153",2010,"Northwestern State",NA,NA,NA,24,58,25,19,0,44,0,16,9,25,11,0,53,13,40,38,12,26,10,0.416666666666667,130,8.46153846153846
"4154",2010,"Notre Dame",NA,NA,NA,384,678,441,290,0,453,0,442,283,725,373,0,620,212,408,383,130,253,110,0.286458333333333,1981,18.8288743059061
"4155",2010,"Oakland",NA,NA,NA,21,47,21,12,0,36,0,12,3,15,20,0,83,25,58,22,6,16,5,0.238095238095238,114,17.5438596491228
"4156",2010,"Ohio",NA,NA,NA,37,40,35,18,0,39,1,21,31,52,22,0,42,9,33,37,16,21,6,0.162162162162162,127,17.3228346456693
"4157",2010,"Ohio State",NA,NA,NA,425,953,504,350,0,443,1,402,263,665,278,0,815,309,506,548,216,332,123,0.289411764705882,2454,11.3284433577832
"4158",2010,"Oklahoma",NA,NA,NA,420,845,392,265,0,516,0,392,247,639,206,0,793,278,515,486,147,339,105,0.25,2201,9.35938209904589
"4159",2010,"Oklahoma State",NA,NA,NA,410,758,407,272,0,516,6,262,198,460,169,0,822,305,517,521,160,361,104,0.253658536585366,2015,8.38709677419355
"4160",2010,"Old Dominion",NA,NA,NA,58,92,75,45,0,79,0,39,31,70,25,0,96,32,64,57,13,44,13,0.224137931034483,253,9.88142292490119
"4161",2010,"Oral Roberts",NA,NA,NA,41,71,37,30,0,68,0,38,41,79,34,0,49,9,40,79,29,50,8,0.195121951219512,202,16.8316831683168
"4162",2010,"Oregon",NA,NA,NA,139,276,135,86,0,179,0,115,87,202,97,0,239,94,145,251,99,152,28,0.201438848920863,759,12.7799736495389
"4163",2010,"Oregon State",NA,NA,NA,70,106,45,26,0,79,0,44,31,75,36,0,140,28,112,59,18,41,15,0.214285714285714,277,12.9963898916967
"4164",2010,"Penn State",NA,NA,NA,117,203,114,73,0,141,0,70,71,141,58,0,225,88,137,85,22,63,33,0.282051282051282,535,10.8411214953271
"4165",2010,"Pepperdine",NA,NA,NA,30,36,25,16,0,26,0,13,24,37,16,0,66,14,52,31,7,24,7,0.233333333333333,109,14.6788990825688
"4166",2010,"Pittsburgh",NA,NA,NA,321,615,312,189,0,420,1,218,135,353,130,0,688,257,431,334,112,222,82,0.255451713395639,1600,8.125
"4167",2010,"Portland",NA,NA,NA,16,28,16,10,0,18,0,11,4,15,4,0,32,6,26,18,5,13,4,0.25,68,5.88235294117647
"4168",2010,"Portland State",NA,NA,NA,32,69,23,14,0,48,0,18,21,39,35,0,75,23,52,77,26,51,5,0.15625,175,20
"4169",2010,"Prairie View A&M",NA,NA,NA,33,73,45,24,0,48,1,28,15,43,25,0,84,22,62,26,10,16,7,0.212121212121212,180,13.8888888888889
"4170",2010,"Presbyterian",NA,NA,NA,34,86,57,31,0,78,0,31,18,49,31,0,63,18,45,64,13,51,9,0.264705882352941,197,15.7360406091371
"4171",2010,"Princeton",NA,NA,NA,36,46,29,19,0,34,0,17,18,35,15,0,51,11,40,24,4,20,5,0.138888888888889,119,12.6050420168067
"4172",2010,"Providence",NA,NA,NA,160,300,142,99,0,250,0,118,97,215,107,0,323,123,200,243,76,167,45,0.28125,816,13.1127450980392
"4173",2010,"Purdue",NA,NA,NA,107,249,143,88,0,171,0,40,37,77,80,0,291,126,165,157,41,116,27,0.252336448598131,600,13.3333333333333
"4174",2010,"Purdue Fort Wayne",NA,NA,NA,8,19,7,6,0,17,0,4,5,9,11,0,22,4,18,22,11,11,0,0,48,22.9166666666667
"4175",2010,"Quinnipiac",NA,NA,NA,31,54,18,13,0,37,0,18,19,37,15,0,45,13,32,44,17,27,11,0.354838709677419,137,10.9489051094891
"4176",2010,"Radford",NA,NA,NA,31,45,27,19,0,49,0,15,6,21,39,0,89,18,71,41,10,31,4,0.129032258064516,127,30.7086614173228
"4177",2010,"Rhode Island",NA,NA,NA,29,76,22,11,0,40,0,21,14,35,15,0,90,35,55,29,10,19,7,0.241379310344828,175,8.57142857142857
"4178",2010,"Rice",NA,NA,NA,9,23,15,9,0,26,0,4,6,10,7,0,19,8,11,15,4,11,3,0.333333333333333,52,13.4615384615385
"4179",2010,"Richmond",NA,NA,NA,36,70,36,24,0,70,0,39,15,54,45,0,95,29,66,66,21,45,8,0.222222222222222,208,21.6346153846154
"4180",2010,"Rider",NA,NA,NA,44,79,37,24,0,57,0,23,52,75,18,0,50,9,41,48,15,33,7,0.159090909090909,181,9.94475138121547
"4181",2010,"Robert Morris",NA,NA,NA,25,42,12,8,0,37,0,14,12,26,20,0,50,17,33,39,8,31,5,0.2,111,18.018018018018
"4182",2010,"Rutgers",NA,NA,NA,273,497,251,159,0,388,3,228,148,376,189,0,505,148,357,261,67,194,55,0.201465201465201,1285,14.7081712062257
"4183",2010,"SE Louisiana",NA,NA,NA,33,69,22,14,0,56,1,18,21,39,16,0,55,15,40,67,12,55,8,0.242424242424242,150,10.6666666666667
"4184",2010,"SMU",NA,NA,NA,19,29,14,9,0,16,0,13,17,30,4,0,14,5,9,20,6,14,3,0.157894736842105,75,5.33333333333333
"4185",2010,"Sacred Heart",NA,NA,NA,6,26,10,7,0,11,0,9,7,16,10,0,16,6,10,9,3,6,3,0.5,55,18.1818181818182
"4186",2010,"Saint Joseph's",NA,NA,NA,46,93,51,33,0,59,0,36,39,75,39,0,99,28,71,58,17,41,14,0.304347826086957,234,16.6666666666667
"4187",2010,"Saint Louis",NA,NA,NA,4,20,6,4,0,20,0,2,2,4,9,0,34,12,22,17,5,12,1,0.25,47,19.1489361702128
"4188",2010,"Saint Mary's",NA,NA,NA,13,25,9,7,0,20,0,10,6,16,6,0,23,8,15,17,5,12,6,0.461538461538462,63,9.52380952380952
"4189",2010,"Saint Peter's",NA,NA,NA,8,22,12,7,0,21,0,8,12,20,8,0,19,9,10,7,3,4,2,0.25,53,15.0943396226415
"4190",2010,"Sam Houston",NA,NA,NA,15,15,8,4,0,20,0,1,0,1,4,0,51,21,30,15,1,14,3,0.2,55,7.27272727272727
"4191",2010,"Samford",NA,NA,NA,28,85,31,18,0,63,0,33,26,59,22,0,45,18,27,98,30,68,8,0.285714285714286,203,10.8374384236453
"4192",2010,"San Diego",NA,NA,NA,11,18,14,7,0,16,0,9,10,19,8,0,25,7,18,14,7,7,5,0.454545454545455,55,14.5454545454545
"4193",2010,"San Diego State",NA,NA,NA,66,153,73,47,0,96,0,70,36,106,57,0,140,49,91,82,33,49,19,0.287878787878788,390,14.6153846153846
"4194",2010,"San Francisco",NA,NA,NA,28,40,14,5,0,29,0,2,2,4,14,0,69,18,51,39,7,32,4,0.142857142857143,98,14.2857142857143
"4195",2010,"Santa Clara",NA,NA,NA,70,126,48,29,0,97,0,43,35,78,30,0,131,44,87,105,28,77,9,0.128571428571429,323,9.28792569659443
"4196",2010,"Seattle U",NA,NA,NA,19,59,22,11,0,44,0,5,13,18,23,0,57,25,32,70,23,47,7,0.368421052631579,133,17.2932330827068
"4197",2010,"Seton Hall",NA,NA,NA,149,236,105,67,0,162,1,83,106,189,62,0,271,74,197,162,36,126,38,0.25503355704698,611,10.1472995090016
"4198",2010,"Siena",NA,NA,NA,19,49,39,26,0,32,0,10,15,25,9,0,27,6,21,31,12,19,2,0.105263157894737,103,8.7378640776699
"4199",2010,"South Alabama",NA,NA,NA,14,28,16,13,0,15,0,6,7,13,5,0,22,8,14,18,3,15,2,0.142857142857143,61,8.19672131147541
"4200",2010,"South Carolina State",NA,NA,NA,1,26,8,7,0,24,0,3,0,3,5,0,21,6,15,13,5,8,1,1,42,11.9047619047619
"4201",2010,"South Carolina Upstate",NA,NA,NA,26,23,12,8,0,19,0,13,21,34,10,0,31,10,21,11,2,9,6,0.230769230769231,76,13.1578947368421
"4202",2010,"South Dakota",NA,NA,NA,10,37,19,8,0,42,0,4,1,5,12,0,50,13,37,34,12,22,3,0.3,80,15
"4203",2010,"South Dakota State",NA,NA,NA,34,77,31,21,0,51,0,32,25,57,24,0,42,8,34,70,28,42,10,0.294117647058824,188,12.7659574468085
"4204",2010,"South Florida",NA,NA,NA,214,407,228,134,0,285,1,163,125,288,144,0,345,116,229,255,74,181,50,0.233644859813084,1030,13.9805825242718
"4205",2010,"Southern",NA,NA,NA,37,52,30,19,0,59,1,14,30,44,22,0,69,20,49,59,15,44,8,0.216216216216216,147,14.9659863945578
"4206",2010,"Southern Illinois",NA,NA,NA,18,45,33,21,0,46,0,17,11,28,14,0,36,10,26,34,12,22,2,0.111111111111111,112,12.5
"4207",2010,"Southern Miss",NA,NA,NA,50,80,42,25,0,62,1,18,11,29,28,0,119,37,82,65,21,44,9,0.18,212,13.2075471698113
"4208",2010,"Southern Utah",NA,NA,NA,17,19,9,5,0,19,0,9,15,24,3,0,22,4,18,9,1,8,4,0.235294117647059,53,5.66037735849057
"4209",2010,"St. Bonaventure",NA,NA,NA,12,41,21,16,0,35,1,25,19,44,8,0,33,10,23,25,9,16,3,0.25,104,7.69230769230769
"4210",2010,"St. Francis (PA)",NA,NA,NA,48,76,40,22,0,44,0,22,20,42,28,0,85,31,54,71,22,49,10,0.208333333333333,209,13.3971291866029
"4211",2010,"St. John's",NA,NA,NA,356,574,385,219,0,346,2,232,150,382,225,0,820,303,517,254,89,165,87,0.24438202247191,1641,13.7111517367459
"4212",2010,"Stanford",NA,NA,NA,433,878,379,253,0,361,1,404,233,637,149,0,602,226,376,512,172,340,113,0.260969976905312,2215,6.72686230248307
"4213",2010,"Stephen F. Austin",NA,NA,NA,34,35,18,13,0,49,0,8,19,27,17,0,66,21,45,50,13,37,5,0.147058823529412,117,14.5299145299145
"4214",2010,"Stetson",NA,NA,NA,31,57,38,20,0,58,0,18,17,35,16,0,65,20,45,46,16,30,8,0.258064516129032,150,10.6666666666667
"4215",2010,"Stony Brook",NA,NA,NA,29,50,27,18,0,46,0,6,11,17,14,0,81,24,57,17,2,15,4,0.137931034482759,116,12.0689655172414
"4216",2010,"Syracuse",NA,NA,NA,365,539,348,215,0,295,2,225,131,356,178,0,543,172,371,328,106,222,78,0.213698630136986,1496,11.8983957219251
"4217",2010,"TCU",NA,NA,NA,90,170,78,57,0,119,2,61,45,106,54,0,188,47,141,129,48,81,12,0.133333333333333,442,12.2171945701357
"4218",2010,"Temple",NA,NA,NA,129,191,119,66,0,153,0,83,72,155,98,0,195,61,134,181,59,122,29,0.224806201550388,549,17.8506375227687
"4219",2010,"Tennessee",NA,NA,NA,456,830,389,241,0,449,3,384,215,599,209,0,816,293,523,410,157,253,142,0.31140350877193,2237,9.34286991506482
"4220",2010,"Tennessee State",NA,NA,NA,16,26,10,3,0,19,0,11,7,18,6,0,35,5,30,12,4,8,3,0.1875,63,9.52380952380952
"4221",2010,"Tennessee Tech",NA,NA,NA,32,38,32,21,0,43,1,8,7,15,17,0,73,16,57,42,9,33,4,0.125,115,14.7826086956522
"4222",2010,"Texas",NA,NA,NA,389,781,432,271,0,466,1,308,205,513,230,0,707,238,469,468,172,296,106,0.272493573264781,1996,11.5230460921844
"4223",2010,"Texas A&M",NA,NA,NA,442,786,437,274,0,593,3,423,226,649,316,0,963,355,608,367,132,235,126,0.285067873303167,2254,14.019520851819
"4224",2010,"Texas A&M-Corpus Christi",NA,NA,NA,59,80,58,36,0,52,0,28,30,58,23,0,87,23,64,60,19,41,13,0.220338983050847,224,10.2678571428571
"4225",2010,"Texas Southern",NA,NA,NA,12,22,8,4,0,14,0,5,12,17,8,0,33,10,23,6,2,4,2,0.166666666666667,54,14.8148148148148
"4226",2010,"Texas State",NA,NA,NA,6,13,4,3,0,25,0,1,2,3,6,0,24,2,22,27,2,25,0,0,25,24
"4227",2010,"Texas Tech",NA,NA,NA,189,310,180,111,0,270,3,132,116,248,128,0,373,122,251,213,66,147,59,0.312169312169312,879,14.5620022753129
"4228",2010,"Toledo",NA,NA,NA,31,48,13,7,0,40,0,25,23,48,18,0,35,8,27,46,14,32,7,0.225806451612903,129,13.953488372093
"4229",2010,"Towson",NA,NA,NA,12,24,18,9,0,15,0,13,7,20,9,0,14,7,7,11,4,7,3,0.25,64,14.0625
"4230",2010,"Tulane",NA,NA,NA,47,62,48,26,0,53,0,32,34,66,31,0,63,21,42,62,18,44,12,0.25531914893617,192,16.1458333333333
"4231",2010,"UAB",NA,NA,NA,83,127,75,42,0,132,2,36,39,75,50,0,177,53,124,126,33,93,18,0.216867469879518,351,14.2450142450142
"4232",2010,"UC Davis",NA,NA,NA,16,23,28,20,0,28,0,17,12,29,13,0,34,14,20,23,8,15,4,0.25,87,14.9425287356322
"4233",2010,"UC Irvine",NA,NA,NA,18,41,34,20,0,42,0,22,30,52,16,0,30,10,20,20,10,10,2,0.111111111111111,109,14.6788990825688
"4234",2010,"UC Riverside",NA,NA,NA,31,89,27,18,0,83,0,22,15,37,28,0,82,31,51,89,29,60,7,0.225806451612903,208,13.4615384615385
"4235",2010,"UC Santa Barbara",NA,NA,NA,14,50,18,10,0,31,0,21,11,32,10,0,35,14,21,22,5,17,6,0.428571428571429,107,9.34579439252336
"4236",2010,"UCF",NA,NA,NA,41,56,30,19,0,63,0,26,33,59,23,0,65,25,40,27,8,19,8,0.195121951219512,165,13.9393939393939
"4237",2010,"UCLA",NA,NA,NA,159,242,131,81,0,215,1,146,104,250,111,0,258,80,178,119,36,83,35,0.220125786163522,698,15.9025787965616
"4238",2010,"UConn",NA,NA,NA,505,1211,519,340,0,469,2,642,271,913,356,0,772,323,449,658,231,427,137,0.271287128712871,3090,11.5210355987055
"4239",2010,"UIC",NA,NA,NA,40,65,27,15,0,59,0,9,3,12,28,0,114,33,81,57,19,38,9,0.225,171,16.374269005848
"4240",2010,"UMBC",NA,NA,NA,25,46,19,12,0,32,0,17,16,33,5,0,45,17,28,26,4,22,4,0.16,112,4.46428571428571
"4241",2010,"UMass",NA,NA,NA,59,125,54,36,0,61,0,39,53,92,24,0,76,21,55,96,27,69,13,0.220338983050847,288,8.33333333333333
"4242",2010,"UNC Greensboro",NA,NA,NA,11,18,1,1,0,16,0,9,6,15,4,0,30,6,24,16,8,8,3,0.272727272727273,52,7.69230769230769
"4243",2010,"UNC Wilmington",NA,NA,NA,17,29,17,11,0,16,0,14,1,15,14,0,34,12,22,5,1,4,5,0.294117647058824,79,17.7215189873418
"4244",2010,"UNLV",NA,NA,NA,22,25,18,9,0,24,1,3,21,24,7,0,16,9,7,30,10,20,3,0.136363636363636,72,9.72222222222222
"4245",2010,"USC",NA,NA,NA,92,148,76,49,0,115,0,60,56,116,59,0,187,50,137,117,39,78,18,0.195652173913043,413,14.2857142857143
"4246",2010,"UT Arlington",NA,NA,NA,41,65,27,16,0,57,0,18,25,43,20,0,92,20,72,59,19,40,9,0.219512195121951,173,11.5606936416185
"4247",2010,"UT Martin",NA,NA,NA,13,22,14,6,0,14,0,5,7,12,5,0,19,6,13,17,4,13,4,0.307692307692308,55,9.09090909090909
"4248",2010,"UT Rio Grande Valley",NA,NA,NA,28,40,18,7,0,42,0,8,7,15,10,0,76,19,57,29,5,24,4,0.142857142857143,103,9.70873786407767
"4249",2010,"UTSA",NA,NA,NA,33,44,32,17,0,38,0,12,14,26,13,0,52,16,36,39,9,30,6,0.181818181818182,122,10.655737704918
"4250",2010,"Utah",NA,NA,NA,20,39,12,9,0,31,0,16,15,31,6,0,46,14,32,24,9,15,6,0.3,103,5.8252427184466
"4251",2010,"Utah Valley",NA,NA,NA,9,24,9,5,0,13,0,7,6,13,7,0,17,1,16,12,4,8,2,0.222222222222222,47,14.8936170212766
"4252",2010,"Valparaiso",NA,NA,NA,30,67,32,22,0,53,0,18,24,42,13,0,62,14,48,60,16,44,4,0.133333333333333,150,8.66666666666667
"4253",2010,"Vanderbilt",NA,NA,NA,320,646,371,233,0,490,1,385,250,635,197,0,457,143,314,418,158,260,88,0.275,1753,11.2378779235596
"4254",2010,"Vermont",NA,NA,NA,95,191,113,75,0,138,2,74,78,152,67,0,215,65,150,135,42,93,24,0.252631578947368,496,13.508064516129
"4255",2010,"Villanova",NA,NA,NA,92,262,77,51,0,175,0,103,97,200,70,0,119,39,80,292,80,212,18,0.195652173913043,592,11.8243243243243
"4256",2010,"Virginia Tech",NA,NA,NA,258,424,246,140,0,252,1,206,158,364,118,0,430,121,309,211,71,140,67,0.25968992248062,1146,10.2966841186736
"4257",2010,"Wagner",NA,NA,NA,10,18,5,3,0,22,0,9,1,10,9,0,22,4,18,27,8,19,2,0.2,50,18
"4258",2010,"Wake Forest",NA,NA,NA,233,336,201,122,0,255,0,152,119,271,166,0,279,65,214,295,81,214,47,0.201716738197425,917,18.1025081788441
"4259",2010,"Washington",NA,NA,NA,66,121,67,38,0,98,0,48,39,87,47,0,145,48,97,45,14,31,13,0.196969696969697,318,14.7798742138365
"4260",2010,"Washington State",NA,NA,NA,71,92,39,19,0,85,0,31,24,55,42,0,155,43,112,118,27,91,16,0.225352112676056,276,15.2173913043478
"4261",2010,"West Virginia",NA,NA,NA,421,707,449,263,0,448,0,310,213,523,297,0,690,205,485,400,126,274,88,0.209026128266033,1884,15.7643312101911
"4262",2010,"Western Carolina",NA,NA,NA,12,19,15,8,0,16,0,3,8,11,3,0,27,10,17,13,3,10,0,0,50,6
"4263",2010,"Western Illinois",NA,NA,NA,11,40,9,5,0,38,0,4,7,11,20,0,60,21,39,25,6,19,2,0.181818181818182,85,23.5294117647059
"4264",2010,"Western Kentucky",NA,NA,NA,27,47,28,13,0,47,0,28,27,55,16,0,43,18,25,30,8,22,9,0.333333333333333,134,11.9402985074627
"4265",2010,"Western Michigan",NA,NA,NA,33,44,27,21,0,40,0,16,13,29,14,0,49,11,38,54,14,40,9,0.272727272727273,127,11.0236220472441
"4266",2010,"Winston Salem",NA,NA,NA,9,23,10,7,0,17,0,0,0,0,8,0,43,11,32,18,2,16,1,0.111111111111111,50,16
"4267",2010,"Winthrop",NA,NA,NA,32,43,30,14,0,30,0,13,9,22,13,0,41,8,33,36,8,28,6,0.1875,109,11.9266055045872
"4268",2010,"Wisconsin",NA,NA,NA,95,260,103,61,0,193,1,108,107,215,83,0,211,88,123,152,57,95,26,0.273684210526316,637,13.0298273155416
"4269",2010,"Wofford",NA,NA,NA,17,23,26,17,0,19,0,8,4,12,8,0,26,4,22,13,2,11,2,0.117647058823529,61,13.1147540983607
"4270",2010,"Wright State",NA,NA,NA,38,73,38,27,0,67,0,33,32,65,29,0,74,23,51,63,16,47,10,0.263157894736842,193,15.0259067357513
"4271",2010,"Wyoming",NA,NA,NA,10,34,17,12,0,12,0,9,0,9,5,0,23,5,18,24,7,17,1,0.1,71,7.04225352112676
"4272",2010,"Xavier",NA,NA,NA,370,708,316,195,0,330,2,325,225,550,184,0,462,167,295,443,152,291,96,0.259459459459459,1814,10.1433296582139
"4273",2010,"Yale",NA,NA,NA,10,11,14,10,0,21,0,7,20,27,9,0,15,2,13,12,4,8,1,0.1,38,23.6842105263158
"4274",2010,"Youngstown State",NA,NA,NA,17,37,15,8,0,27,0,2,0,2,15,0,69,24,45,37,12,25,5,0.294117647058824,96,15.625
"4275",2011,"Alabama",NA,NA,NA,66,109,61,40,0,106,0,33,27,60,43,0,173,43,130,72,16,56,12,0.181818181818182,281,15.3024911032028
"4276",2011,"Alabama A&M",NA,NA,NA,9,26,13,9,0,18,0,9,3,12,7,0,23,5,18,13,3,10,0,0,53,13.2075471698113
"4277",2011,"Alabama State",NA,NA,NA,14,26,14,8,0,25,0,5,6,11,5,0,35,4,31,14,3,11,2,0.142857142857143,55,9.09090909090909
"4278",2011,"Albany",NA,NA,NA,10,15,4,2,0,14,1,4,4,8,6,0,18,6,12,21,8,13,1,0.1,43,13.953488372093
"4279",2011,"American University",NA,NA,NA,7,19,3,1,0,16,0,6,6,12,10,0,16,3,13,21,7,14,0,0,43,23.2558139534884
"4280",2011,"Appalachian State",NA,NA,NA,15,29,4,2,0,16,0,19,8,27,7,0,26,5,21,5,1,4,6,0.4,70,10
"4281",2011,"Arizona",NA,NA,NA,70,128,73,43,0,91,0,72,76,148,44,0,120,40,80,107,39,68,14,0.2,361,12.1883656509695
"4282",2011,"Arizona State",NA,NA,NA,142,197,123,82,0,193,2,89,84,173,80,0,233,78,155,145,32,113,29,0.204225352112676,571,14.0105078809107
"4283",2011,"Arkansas",NA,NA,NA,130,280,138,82,0,191,0,106,53,159,105,0,323,97,226,192,69,123,21,0.161538461538462,717,14.6443514644351
"4284",2011,"Arkansas State",NA,NA,NA,8,25,6,3,0,18,0,10,11,21,8,0,14,5,9,16,4,12,2,0.25,54,14.8148148148148
"4285",2011,"Arkansas-Pine Bluff",NA,NA,NA,50,58,47,30,0,66,1,16,27,43,20,0,83,13,70,30,6,24,10,0.2,152,13.1578947368421
"4286",2011,"Auburn",NA,NA,NA,51,76,47,26,0,72,0,27,19,46,27,0,128,40,88,43,13,30,10,0.196078431372549,223,12.1076233183857
"4287",2011,"BYU",NA,NA,NA,11,26,11,7,0,27,0,1,9,10,11,0,22,7,15,29,9,20,2,0.181818181818182,57,19.2982456140351
"4288",2011,"Baylor",NA,NA,NA,438,965,574,383,1,418,4,340,187,527,247,0,927,387,540,389,149,240,118,0.269406392694064,2456,10.057003257329
"4289",2011,"Bethune-Cookman",NA,NA,NA,14,20,6,4,0,20,0,5,5,10,7,0,35,6,29,15,3,12,1,0.0714285714285714,48,14.5833333333333
"4290",2011,"Boston College",NA,NA,NA,161,321,123,91,0,209,1,172,115,287,93,0,202,74,128,245,86,159,38,0.236024844720497,853,10.9026963657679
"4291",2011,"Boston University",NA,NA,NA,43,72,16,10,0,62,1,19,10,29,18,0,98,25,73,63,12,51,7,0.162790697674419,176,10.2272727272727
"4292",2011,"Bowling Green",NA,NA,NA,28,63,33,26,0,48,0,30,32,62,18,0,44,14,30,48,17,31,6,0.214285714285714,161,11.1801242236025
"4293",2011,"Bradley",NA,NA,NA,12,26,13,8,0,24,0,11,0,11,4,0,28,4,24,18,4,14,0,0,59,6.77966101694915
"4294",2011,"Butler",NA,NA,NA,41,76,51,37,0,76,0,36,22,58,44,0,74,20,54,75,22,53,8,0.195121951219512,210,20.952380952381
"4295",2011,"Cal Poly",NA,NA,NA,32,42,15,10,0,39,0,16,24,40,17,0,49,15,34,35,10,25,8,0.25,120,14.1666666666667
"4296",2011,"Cal State Bakersfield",NA,NA,NA,16,27,7,6,0,20,1,7,11,18,11,0,23,6,17,26,8,18,2,0.125,65,16.9230769230769
"4297",2011,"Cal State Northridge",NA,NA,NA,22,42,18,8,0,38,0,3,5,8,13,0,70,21,49,34,7,27,3,0.136363636363636,96,13.5416666666667
"4298",2011,"California",NA,NA,NA,120,177,111,62,0,106,1,97,74,171,69,0,192,65,127,78,15,63,34,0.283333333333333,495,13.9393939393939
"4299",2011,"Canisius",NA,NA,NA,16,22,12,7,0,20,0,7,2,9,3,0,28,8,20,23,7,16,4,0.25,62,4.83870967741935
"4300",2011,"Central Arkansas",NA,NA,NA,6,18,11,6,0,19,0,11,7,18,5,0,15,4,11,13,4,9,2,0.333333333333333,45,11.1111111111111
"4301",2011,"Central Connecticut",NA,NA,NA,8,21,3,2,0,20,0,7,4,11,10,0,24,7,17,7,2,5,1,0.125,47,21.2765957446809
"4302",2011,"Central Michigan",NA,NA,NA,22,27,18,13,0,20,0,15,1,16,7,0,38,1,37,23,9,14,2,0.0909090909090909,78,8.97435897435897
"4303",2011,"Charleston",NA,NA,NA,25,28,13,7,0,21,0,0,0,0,9,0,45,11,34,24,5,19,5,0.2,72,12.5
"4304",2011,"Charlotte",NA,NA,NA,35,74,33,21,0,63,0,30,22,52,22,0,87,34,53,43,15,28,6,0.171428571428571,198,11.1111111111111
"4305",2011,"Chattanooga",NA,NA,NA,26,60,26,11,0,41,1,19,16,35,16,0,66,24,42,69,24,45,6,0.230769230769231,159,10.062893081761
"4306",2011,"Chicago State",NA,NA,NA,16,17,3,2,0,13,0,2,0,2,7,0,38,10,28,20,7,13,5,0.3125,53,13.2075471698113
"4307",2011,"Cincinnati",NA,NA,NA,81,135,50,29,0,81,2,43,47,90,38,0,119,26,93,143,47,96,16,0.197530864197531,339,11.2094395280236
"4308",2011,"Clemson",NA,NA,NA,98,160,52,27,0,117,0,52,65,117,47,0,150,42,108,157,48,109,25,0.255102040816327,410,11.4634146341463
"4309",2011,"Cleveland State",NA,NA,NA,10,24,11,8,0,16,0,14,8,22,3,0,17,3,14,11,2,9,2,0.2,56,5.35714285714286
"4310",2011,"Coastal Carolina",NA,NA,NA,17,23,14,8,0,22,0,0,0,0,4,0,51,9,42,15,3,12,4,0.235294117647059,56,7.14285714285714
"4311",2011,"Colorado",NA,NA,NA,86,166,73,48,0,136,1,48,56,104,48,0,149,42,107,149,48,101,15,0.174418604651163,405,11.8518518518519
"4312",2011,"Colorado State",NA,NA,NA,12,22,12,8,0,19,0,10,7,17,9,0,18,3,15,19,4,15,3,0.25,54,16.6666666666667
"4313",2011,"Columbia",NA,NA,NA,22,38,15,9,0,47,0,1,7,8,19,0,57,12,45,46,10,36,1,0.0454545454545455,89,21.3483146067416
"4314",2011,"Creighton",NA,NA,NA,18,21,5,5,0,22,0,12,9,21,5,0,22,7,15,24,8,16,4,0.222222222222222,67,7.46268656716418
"4315",2011,"Dartmouth",NA,NA,NA,11,23,6,5,0,15,0,6,16,22,5,0,14,3,11,13,2,11,3,0.272727272727273,48,10.4166666666667
"4316",2011,"Dayton",NA,NA,NA,66,161,50,35,0,105,1,62,59,121,30,0,131,44,87,119,45,74,11,0.166666666666667,393,7.63358778625954
"4317",2011,"DePaul",NA,NA,NA,288,466,243,147,0,338,0,204,136,340,198,0,493,187,306,423,148,275,63,0.21875,1358,14.580265095729
"4318",2011,"Delaware State",NA,NA,NA,14,18,7,5,0,24,0,2,15,17,7,0,22,4,18,9,3,6,2,0.142857142857143,42,16.6666666666667
"4319",2011,"Denver",NA,NA,NA,10,21,21,10,0,14,0,18,6,24,7,0,14,5,9,10,4,6,4,0.4,65,10.7692307692308
"4320",2011,"Detroit Mercy",NA,NA,NA,25,64,21,15,0,51,0,25,26,51,26,0,69,23,46,43,11,32,8,0.32,157,16.5605095541401
"4321",2011,"Drake",NA,NA,NA,22,44,12,8,0,38,0,11,7,18,13,0,79,34,45,34,5,29,8,0.363636363636364,120,10.8333333333333
"4322",2011,"Drexel",NA,NA,NA,6,20,8,6,0,14,0,7,0,7,4,0,20,5,15,18,4,14,0,0,45,8.88888888888889
"4323",2011,"Duke",NA,NA,NA,561,848,485,285,0,539,0,407,255,662,430,0,881,293,588,552,190,362,130,0.231729055258467,2427,17.7173465183354
"4324",2011,"Duquesne",NA,NA,NA,34,74,33,21,0,60,0,33,21,54,25,0,59,20,39,59,15,44,7,0.205882352941176,184,13.5869565217391
"4325",2011,"East Tennessee State",NA,NA,NA,46,69,20,11,0,60,0,10,21,31,22,0,110,30,80,60,17,43,8,0.173913043478261,175,12.5714285714286
"4326",2011,"Eastern Michigan",NA,NA,NA,73,96,48,27,0,63,0,41,63,104,35,0,72,15,57,82,22,60,17,0.232876712328767,260,13.4615384615385
"4327",2011,"Elon",NA,NA,NA,7,20,8,6,0,20,1,5,9,14,6,0,28,12,16,12,3,9,2,0.285714285714286,51,11.7647058823529
"4328",2011,"Florida",NA,NA,NA,123,196,92,56,0,135,0,72,82,154,57,0,211,74,137,117,38,79,25,0.203252032520325,531,10.7344632768362
"4329",2011,"Florida International",NA,NA,NA,12,13,4,2,0,17,0,3,1,4,6,0,22,6,16,23,5,18,1,0.0833333333333333,40,15
"4330",2011,"Florida State",NA,NA,NA,421,767,460,299,0,486,1,360,285,645,217,0,608,207,401,429,154,275,106,0.251781472684086,2027,10.7054760730143
"4331",2011,"Fordham",NA,NA,NA,14,20,4,2,0,13,0,4,11,15,10,0,15,3,12,40,12,28,3,0.214285714285714,53,18.8679245283019
"4332",2011,"Furman",NA,NA,NA,21,19,10,5,0,17,0,12,10,22,2,0,27,5,22,16,2,14,5,0.238095238095238,61,3.27868852459016
"4333",2011,"Gardner-Webb",NA,NA,NA,28,44,17,12,0,48,0,26,31,57,18,0,37,10,27,37,16,21,5,0.178571428571429,131,13.7404580152672
"4334",2011,"George Washington",NA,NA,NA,10,22,6,4,0,10,0,6,3,9,5,0,27,7,20,17,3,14,2,0.2,51,9.80392156862745
"4335",2011,"Georgetown",NA,NA,NA,274,415,237,151,0,402,2,161,126,287,210,0,412,128,284,424,144,280,47,0.171532846715328,1192,17.6174496644295
"4336",2011,"Georgia",NA,NA,NA,228,412,169,99,0,263,0,145,84,229,116,0,437,136,301,271,70,201,48,0.210526315789474,1043,11.1217641418984
"4337",2011,"Georgia Southern",NA,NA,NA,12,25,7,3,0,10,0,5,5,10,6,0,24,7,17,22,5,17,4,0.333333333333333,55,10.9090909090909
"4338",2011,"Georgia Tech",NA,NA,NA,249,326,191,117,0,284,1,142,102,244,164,0,421,139,282,225,67,158,55,0.220883534136546,977,16.7860798362334
"4339",2011,"Gonzaga",NA,NA,NA,170,299,167,111,0,200,0,160,83,243,147,0,409,172,237,169,52,117,46,0.270588235294118,905,16.2430939226519
"4340",2011,"Green Bay",NA,NA,NA,287,633,332,236,0,443,1,302,142,444,313,0,546,195,351,498,176,322,73,0.254355400696864,1685,18.5756676557864
"4341",2011,"Hampton",NA,NA,NA,54,79,50,32,0,49,0,35,47,82,20,0,50,15,35,46,15,31,7,0.12962962962963,207,9.66183574879227
"4342",2011,"Hartford",NA,NA,NA,14,46,21,14,0,26,0,5,3,8,14,0,61,23,38,33,9,24,4,0.285714285714286,103,13.5922330097087
"4343",2011,"Hawai'i",NA,NA,NA,26,44,18,9,0,34,0,8,6,14,11,0,63,25,38,30,10,20,6,0.230769230769231,117,9.4017094017094
"4344",2011,"Holy Cross",NA,NA,NA,21,24,16,11,0,30,1,15,16,31,10,0,41,8,33,43,13,30,4,0.19047619047619,88,11.3636363636364
"4345",2011,"Houston",NA,NA,NA,96,195,155,90,0,130,0,64,76,140,60,0,161,50,111,126,39,87,16,0.166666666666667,483,12.4223602484472
"4346",2011,"Howard",NA,NA,NA,31,51,24,16,0,60,0,20,22,42,17,0,61,13,48,52,11,41,3,0.0967741935483871,137,12.4087591240876
"4347",2011,"IUPUI",NA,NA,NA,7,21,6,4,0,19,0,3,3,6,1,0,23,4,19,15,3,12,0,0,39,2.56410256410256
"4348",2011,"Idaho",NA,NA,NA,9,33,20,13,0,17,0,11,7,18,11,0,23,5,18,16,3,13,1,0.111111111111111,67,16.4179104477612
"4349",2011,"Idaho State",NA,NA,NA,10,23,6,5,0,17,0,10,6,16,7,0,26,9,17,13,7,6,5,0.5,60,11.6666666666667
"4350",2011,"Illinois",NA,NA,NA,88,203,78,49,0,131,0,67,38,105,54,0,242,82,160,122,31,91,21,0.238636363636364,492,10.9756097560976
"4351",2011,"Indiana",NA,NA,NA,63,117,84,52,0,108,1,51,38,89,72,0,133,41,92,109,33,76,16,0.253968253968254,328,21.9512195121951
"4352",2011,"Iona",NA,NA,NA,21,26,15,8,0,16,0,5,15,20,5,0,19,3,16,20,6,14,2,0.0952380952380952,63,7.93650793650794
"4353",2011,"Iowa",NA,NA,NA,297,608,310,213,0,301,0,228,80,308,142,0,493,138,355,509,159,350,73,0.245791245791246,1531,9.2749836708034
"4354",2011,"Iowa State",NA,NA,NA,292,755,366,239,0,383,2,190,80,270,122,0,617,233,384,485,179,306,72,0.246575342465753,1743,6.99942627653471
"4355",2011,"Jacksonville State",NA,NA,NA,9,18,6,3,0,12,0,5,7,12,8,0,25,3,22,18,6,12,1,0.111111111111111,42,19.047619047619
"4356",2011,"James Madison",NA,NA,NA,27,44,30,20,0,43,0,24,14,38,18,0,46,18,28,47,5,42,9,0.333333333333333,128,14.0625
"4357",2011,"Kansas",NA,NA,NA,65,211,115,73,0,141,1,100,61,161,60,0,200,71,129,104,36,68,15,0.230769230769231,509,11.7878192534381
"4358",2011,"Kansas State",NA,NA,NA,106,225,109,66,0,186,1,75,39,114,66,0,244,79,165,212,71,141,22,0.207547169811321,584,11.3013698630137
"4359",2011,"Kennesaw State",NA,NA,NA,21,20,4,2,0,19,0,0,0,0,10,0,46,14,32,23,7,16,3,0.142857142857143,62,16.1290322580645
"4360",2011,"Kentucky",NA,NA,NA,421,573,428,272,0,477,1,319,252,571,272,0,561,147,414,467,144,323,84,0.199524940617577,1719,15.8231529959279
"4361",2011,"LSU",NA,NA,NA,90,212,104,57,0,122,0,58,28,86,34,0,210,65,145,134,41,93,14,0.155555555555556,492,6.91056910569106
"4362",2011,"La Salle",NA,NA,NA,20,42,25,16,0,32,0,12,11,23,17,0,34,7,27,56,11,45,4,0.2,98,17.3469387755102
"4363",2011,"Lamar",NA,NA,NA,15,25,12,8,0,13,0,7,9,16,12,0,25,7,18,21,5,16,2,0.133333333333333,61,19.672131147541
"4364",2011,"Lehigh",NA,NA,NA,7,14,3,2,0,10,0,7,12,19,2,0,12,3,9,16,5,11,1,0.142857142857143,37,5.4054054054054
"4365",2011,"Liberty",NA,NA,NA,31,37,22,14,0,43,0,10,6,16,10,0,57,17,40,31,10,21,7,0.225806451612903,109,9.1743119266055
"4366",2011,"Little Rock",NA,NA,NA,17,60,26,16,0,54,0,19,14,33,13,0,68,30,38,43,14,29,6,0.352941176470588,149,8.7248322147651
"4367",2011,"Longwood",NA,NA,NA,8,18,7,5,0,27,0,3,4,7,8,0,27,9,18,18,2,16,1,0.125,42,19.047619047619
"4368",2011,"Louisville",NA,NA,NA,145,257,137,94,0,208,3,137,86,223,134,0,238,70,168,213,73,140,34,0.23448275862069,724,18.5082872928177
"4369",2011,"Loyola Chicago",NA,NA,NA,16,74,26,17,0,51,1,18,10,28,33,0,63,24,39,50,8,42,3,0.1875,147,22.4489795918367
"4370",2011,"Loyola Maryland",NA,NA,NA,14,55,20,14,0,26,0,13,8,21,14,0,31,8,23,45,10,35,1,0.0714285714285714,105,13.3333333333333
"4371",2011,"Maine",NA,NA,NA,11,25,16,12,0,23,0,3,6,9,4,0,19,3,16,19,3,16,0,0,47,8.51063829787234
"4372",2011,"Marist",NA,NA,NA,96,274,113,77,0,155,0,101,79,180,83,0,174,53,121,204,65,139,19,0.197916666666667,616,13.474025974026
"4373",2011,"Marquette",NA,NA,NA,187,368,206,135,0,218,0,160,114,274,118,0,301,91,210,252,82,170,39,0.20855614973262,931,12.6745435016112
"4374",2011,"Marshall",NA,NA,NA,14,28,11,5,0,15,0,11,12,23,7,0,28,7,21,10,3,7,2,0.142857142857143,66,10.6060606060606
"4375",2011,"Maryland",NA,NA,NA,319,507,327,201,0,330,2,256,141,397,172,0,507,169,338,243,72,171,92,0.288401253918495,1407,12.2245913290689
"4376",2011,"McNeese",NA,NA,NA,10,24,11,7,0,17,0,12,6,18,4,0,24,13,11,11,4,7,3,0.3,64,6.25
"4377",2011,"Miami",NA,NA,NA,256,395,296,189,0,289,0,200,154,354,205,0,423,142,281,347,110,237,69,0.26953125,1184,17.3141891891892
"4378",2011,"Michigan",NA,NA,NA,49,164,83,57,0,94,0,63,45,108,56,0,104,30,74,148,49,99,13,0.26530612244898,379,14.7757255936675
"4379",2011,"Michigan State",NA,NA,NA,419,693,347,214,0,462,1,312,212,524,281,0,548,179,369,567,181,386,111,0.26491646778043,1874,14.9946638207044
"4380",2011,"Middle Tennessee",NA,NA,NA,42,63,29,17,0,57,0,19,13,32,15,0,68,21,47,67,17,50,9,0.214285714285714,173,8.67052023121387
"4381",2011,"Milwaukee",NA,NA,NA,24,57,41,25,0,54,0,12,17,29,26,0,58,20,38,48,15,33,5,0.208333333333333,136,19.1176470588235
"4382",2011,"Minnesota",NA,NA,NA,52,85,35,21,0,63,0,21,26,47,36,0,133,51,82,47,11,36,10,0.192307692307692,229,15.7205240174673
"4383",2011,"Mississippi State",NA,NA,NA,80,118,51,31,0,105,0,27,22,49,32,0,169,55,114,115,32,83,16,0.2,328,9.75609756097561
"4384",2011,"Mississippi Valley State",NA,NA,NA,26,42,22,12,0,39,0,10,18,28,18,0,50,10,40,42,14,28,4,0.153846153846154,107,16.8224299065421
"4385",2011,"Missouri",NA,NA,NA,98,223,124,69,0,147,0,82,55,137,46,0,187,61,126,159,43,116,23,0.23469387755102,540,8.51851851851852
"4386",2011,"Missouri State",NA,NA,NA,18,20,11,4,0,12,0,0,1,1,5,0,48,16,32,10,1,9,4,0.222222222222222,57,8.7719298245614
"4387",2011,"Monmouth",NA,NA,NA,10,22,9,4,0,16,0,12,1,13,4,0,28,8,20,15,4,11,5,0.5,58,6.89655172413793
"4388",2011,"Montana",NA,NA,NA,27,43,23,15,0,34,0,6,5,11,16,0,63,19,44,31,12,19,4,0.148148148148148,115,13.9130434782609
"4389",2011,"Montana State",NA,NA,NA,19,38,16,13,0,40,0,4,13,17,13,0,55,19,36,45,11,34,6,0.31578947368421,96,13.5416666666667
"4390",2011,"Morehead State",NA,NA,NA,26,46,27,15,0,51,0,5,1,6,15,0,28,4,24,28,4,24,2,0.0769230769230769,90,16.6666666666667
"4391",2011,"Morgan State",NA,NA,NA,8,36,15,12,0,16,0,6,9,15,5,0,10,3,7,24,11,13,2,0.25,66,7.57575757575758
"4392",2011,"Murray State",NA,NA,NA,13,22,6,5,0,14,0,0,0,0,7,0,30,3,27,19,3,16,1,0.0769230769230769,42,16.6666666666667
"4393",2011,"NJIT",NA,NA,NA,13,24,3,2,0,13,0,2,5,7,4,0,28,4,24,21,7,14,2,0.153846153846154,50,8
"4394",2011,"Navy",NA,NA,NA,20,52,18,9,0,18,0,14,7,21,9,0,26,9,17,36,10,26,6,0.3,106,8.49056603773585
"4395",2011,"Nebraska",NA,NA,NA,171,404,167,108,0,219,0,128,79,207,96,1,352,123,229,324,104,220,36,0.210526315789474,982,9.77596741344195
"4396",2011,"Nevada",NA,NA,NA,48,82,42,25,0,58,0,33,33,66,20,0,65,20,45,44,12,32,9,0.1875,208,9.61538461538462
"4397",2011,"Nicholls",NA,NA,NA,17,46,23,11,0,31,0,14,6,20,18,0,40,9,31,50,18,32,5,0.294117647058824,111,16.2162162162162
"4398",2011,"North Carolina",NA,NA,NA,564,991,538,340,0,550,0,210,161,371,346,0,1367,594,773,491,135,356,153,0.271276595744681,2649,13.0615326538316
"4399",2011,"North Carolina A&T",NA,NA,NA,30,48,29,19,0,42,0,27,31,58,21,0,44,12,32,29,10,19,7,0.233333333333333,133,15.7894736842105
"4400",2011,"North Carolina Central",NA,NA,NA,14,23,8,6,0,21,0,0,0,0,6,0,51,15,36,9,0,9,2,0.142857142857143,54,11.1111111111111
"4401",2011,"North Dakota State",NA,NA,NA,4,16,7,4,0,18,0,1,0,1,3,0,33,8,25,25,9,16,0,0,39,7.69230769230769
"4402",2011,"Northeastern",NA,NA,NA,23,49,11,5,0,36,0,23,13,36,13,0,48,16,32,53,14,39,5,0.217391304347826,128,10.15625
"4403",2011,"Northern Colorado",NA,NA,NA,12,22,9,5,0,21,0,5,8,13,14,1,35,14,21,13,3,10,1,0.0833333333333333,60,23.3333333333333
"4404",2011,"Northern Iowa",NA,NA,NA,28,82,33,24,0,52,0,19,5,24,19,0,79,31,48,62,20,42,5,0.178571428571429,187,10.1604278074866
"4405",2011,"Northwestern",NA,NA,NA,17,54,24,14,0,28,0,15,11,26,17,0,36,10,26,34,3,31,2,0.117647058823529,106,16.0377358490566
"4406",2011,"Northwestern State",NA,NA,NA,17,18,11,6,0,28,0,5,4,9,8,0,35,10,25,23,5,18,4,0.235294117647059,57,14.0350877192982
"4407",2011,"Notre Dame",NA,NA,NA,452,814,541,352,0,492,1,500,314,814,383,0,662,226,436,307,113,194,106,0.234513274336283,2242,17.0829616413916
"4408",2011,"Oakland",NA,NA,NA,7,27,4,3,0,14,0,9,13,22,8,0,13,5,8,17,7,10,3,0.428571428571429,56,14.2857142857143
"4409",2011,"Ohio State",NA,NA,NA,267,714,360,244,0,342,3,336,180,516,161,0,548,207,341,394,120,274,83,0.310861423220974,1738,9.26352128883775
"4410",2011,"Oklahoma",NA,NA,NA,420,837,439,308,0,606,0,392,304,696,260,0,673,245,428,642,230,412,92,0.219047619047619,2254,11.5350488021295
"4411",2011,"Ole Miss",NA,NA,NA,104,145,77,51,0,106,0,61,37,98,33,0,178,47,131,113,30,83,22,0.211538461538462,412,8.00970873786408
"4412",2011,"Omaha",NA,NA,NA,8,18,2,1,0,12,0,5,2,7,10,0,30,7,23,16,6,10,0,0,44,22.7272727272727
"4413",2011,"Oral Roberts",NA,NA,NA,24,21,23,18,0,18,1,15,23,38,19,0,21,6,15,15,7,8,6,0.25,81,23.4567901234568
"4414",2011,"Oregon",NA,NA,NA,105,179,107,61,0,140,0,68,57,125,57,0,160,39,121,190,48,142,19,0.180952380952381,465,12.258064516129
"4415",2011,"Oregon State",NA,NA,NA,57,103,62,32,0,68,0,32,22,54,53,0,93,32,61,96,19,77,13,0.228070175438596,257,20.6225680933852
"4416",2011,"Pacific",NA,NA,NA,9,17,6,4,0,17,0,4,7,11,5,0,18,5,13,24,6,18,1,0.111111111111111,42,11.9047619047619
"4417",2011,"Penn State",NA,NA,NA,120,230,121,84,0,146,0,87,69,156,84,0,257,90,167,143,56,87,25,0.208333333333333,625,13.44
"4418",2011,"Pittsburgh",NA,NA,NA,54,157,96,62,0,119,0,69,47,116,38,0,121,36,85,100,37,63,15,0.277777777777778,380,10
"4419",2011,"Portland",NA,NA,NA,8,18,12,8,0,10,0,12,12,24,6,0,10,3,7,23,10,13,0,0,56,10.7142857142857
"4420",2011,"Portland State",NA,NA,NA,12,23,11,8,0,18,0,2,0,2,4,0,26,14,12,28,5,23,2,0.166666666666667,60,6.66666666666667
"4421",2011,"Prairie View A&M",NA,NA,NA,61,131,75,53,0,105,0,41,31,72,60,0,184,51,133,67,20,47,13,0.213114754098361,333,18.018018018018
"4422",2011,"Princeton",NA,NA,NA,20,40,17,13,0,34,0,18,13,31,13,0,33,11,22,35,12,23,9,0.45,106,12.2641509433962
"4423",2011,"Providence",NA,NA,NA,93,142,47,29,0,119,0,45,56,101,50,0,198,56,142,90,21,69,24,0.258064516129032,372,13.4408602150538
"4424",2011,"Purdue",NA,NA,NA,56,183,96,66,0,143,0,49,38,87,66,0,202,81,121,106,32,74,12,0.214285714285714,428,15.4205607476636
"4425",2011,"Purdue Fort Wayne",NA,NA,NA,11,18,12,8,0,21,0,10,17,27,9,0,20,9,11,14,3,11,1,0.0909090909090909,54,16.6666666666667
"4426",2011,"Quinnipiac",NA,NA,NA,15,16,17,10,0,27,0,2,4,6,7,0,31,6,25,16,7,9,4,0.266666666666667,48,14.5833333333333
"4427",2011,"Rhode Island",NA,NA,NA,17,43,17,10,0,31,0,12,10,22,7,0,48,15,33,21,7,14,6,0.352941176470588,97,7.21649484536082
"4428",2011,"Richmond",NA,NA,NA,12,27,8,7,0,16,0,10,16,26,7,0,20,9,11,18,3,15,0,0,63,11.1111111111111
"4429",2011,"Rider",NA,NA,NA,6,20,17,10,0,14,0,5,10,15,11,0,13,4,9,15,7,8,2,0.333333333333333,45,24.4444444444444
"4430",2011,"Rutgers",NA,NA,NA,194,351,194,126,0,271,1,155,138,293,121,0,355,110,245,215,72,143,40,0.206185567010309,947,12.7771911298838
"4431",2011,"SE Louisiana",NA,NA,NA,12,16,5,2,0,19,0,3,7,10,5,0,31,9,22,17,2,15,1,0.0833333333333333,44,11.3636363636364
"4432",2011,"SMU",NA,NA,NA,20,24,15,9,0,31,0,5,7,12,8,0,51,13,38,21,8,13,6,0.3,76,10.5263157894737
"4433",2011,"Saint Joseph's",NA,NA,NA,7,29,11,7,0,12,0,9,10,19,7,0,32,6,26,12,4,8,1,0.142857142857143,59,11.864406779661
"4434",2011,"Saint Mary's",NA,NA,NA,24,80,37,25,0,41,0,29,20,49,18,0,61,16,45,52,16,36,4,0.166666666666667,174,10.3448275862069
"4435",2011,"Saint Peter's",NA,NA,NA,12,26,9,4,0,21,0,5,13,18,9,0,26,6,20,12,2,10,1,0.0833333333333333,54,16.6666666666667
"4436",2011,"Sam Houston",NA,NA,NA,13,25,8,4,0,16,1,11,21,32,10,0,17,3,14,22,4,18,2,0.153846153846154,60,16.6666666666667
"4437",2011,"Samford",NA,NA,NA,23,48,34,22,0,49,1,17,15,32,20,0,48,9,39,70,25,45,4,0.173913043478261,131,15.2671755725191
"4438",2011,"San Diego",NA,NA,NA,18,20,8,5,0,18,0,10,10,20,7,0,31,11,20,14,3,11,7,0.388888888888889,64,10.9375
"4439",2011,"San Diego State",NA,NA,NA,27,48,15,12,0,35,1,13,7,20,10,0,52,17,35,38,10,28,6,0.222222222222222,118,8.47457627118644
"4440",2011,"Seton Hall",NA,NA,NA,112,137,86,51,0,147,0,35,49,84,53,0,219,55,164,128,45,83,24,0.214285714285714,406,13.0541871921182
"4441",2011,"Siena",NA,NA,NA,20,47,21,15,0,32,0,8,18,26,13,0,55,12,43,26,10,16,4,0.2,103,12.621359223301
"4442",2011,"South Alabama",NA,NA,NA,14,20,9,7,0,17,0,3,9,12,8,0,17,6,11,30,12,18,2,0.142857142857143,57,14.0350877192982
"4443",2011,"South Carolina",NA,NA,NA,102,167,96,55,0,130,0,66,70,136,57,0,176,54,122,128,31,97,19,0.186274509803922,449,12.6948775055679
"4444",2011,"South Carolina Upstate",NA,NA,NA,8,27,9,5,0,22,0,13,14,27,5,0,27,8,19,15,2,13,1,0.125,61,8.19672131147541
"4445",2011,"South Dakota",NA,NA,NA,5,28,16,12,0,20,0,3,2,5,3,0,17,7,10,14,4,10,0,0,50,6
"4446",2011,"South Dakota State",NA,NA,NA,11,46,24,16,0,27,0,21,18,39,12,0,31,11,20,34,10,24,2,0.181818181818182,103,11.6504854368932
"4447",2011,"South Florida",NA,NA,NA,90,97,63,37,0,90,0,38,47,85,39,0,146,45,101,78,16,62,21,0.233333333333333,307,12.7035830618893
"4448",2011,"Southeast Missouri State",NA,NA,NA,12,42,3,2,0,38,0,5,7,12,10,0,33,6,27,55,12,43,1,0.0833333333333333,78,12.8205128205128
"4449",2011,"Southern",NA,NA,NA,25,46,19,9,0,43,0,13,21,34,17,0,56,19,37,27,7,20,6,0.24,115,14.7826086956522
"4450",2011,"Southern Miss",NA,NA,NA,35,47,20,12,0,35,0,6,9,15,18,0,80,28,52,29,6,23,7,0.2,129,13.953488372093
"4451",2011,"St. Bonaventure",NA,NA,NA,20,49,12,8,0,27,0,7,8,15,13,0,51,17,34,37,11,26,4,0.2,105,12.3809523809524
"4452",2011,"St. Francis (PA)",NA,NA,NA,37,65,38,22,0,50,0,25,28,53,25,0,69,23,46,43,15,28,9,0.243243243243243,171,14.6198830409357
"4453",2011,"St. John's",NA,NA,NA,357,593,378,223,0,368,0,212,145,357,258,0,868,287,581,246,84,162,75,0.210084033613445,1635,15.7798165137615
"4454",2011,"Stanford",NA,NA,NA,432,912,420,284,0,469,1,467,199,666,223,0,633,236,397,548,188,360,124,0.287037037037037,2338,9.53806672369547
"4455",2011,"Stephen F. Austin",NA,NA,NA,14,23,13,8,0,22,0,4,7,11,11,0,18,6,12,27,8,19,2,0.142857142857143,59,18.6440677966102
"4456",2011,"Stetson",NA,NA,NA,23,40,17,10,0,35,0,10,18,28,9,0,52,10,42,47,7,40,3,0.130434782608696,95,9.47368421052632
"4457",2011,"Syracuse",NA,NA,NA,159,266,163,106,0,167,0,80,78,158,69,0,260,95,165,173,48,125,39,0.245283018867925,689,10.0145137880987
"4458",2011,"TCU",NA,NA,NA,66,188,121,83,0,115,1,63,48,111,53,0,110,27,83,139,45,94,18,0.272727272727273,433,12.2401847575058
"4459",2011,"Temple",NA,NA,NA,62,90,41,25,0,71,1,39,35,74,42,0,105,27,78,70,27,43,19,0.306451612903226,254,16.5354330708661
"4460",2011,"Tennessee",NA,NA,NA,572,1049,552,332,0,530,2,413,201,614,256,0,955,373,582,615,232,383,148,0.258741258741259,2790,9.17562724014337
"4461",2011,"Tennessee State",NA,NA,NA,10,25,8,4,0,14,0,0,13,13,5,0,24,3,21,13,0,13,0,0,39,12.8205128205128
"4462",2011,"Texas",NA,NA,NA,317,484,307,195,0,321,3,195,134,329,167,0,516,163,353,360,122,238,68,0.214511041009464,1374,12.1542940320233
"4463",2011,"Texas A&M",NA,NA,NA,444,641,400,273,0,502,2,385,226,611,287,0,769,249,520,409,145,264,121,0.272522522522523,1983,14.4730206757438
"4464",2011,"Texas Southern",NA,NA,NA,15,15,10,5,0,22,0,1,4,5,3,0,45,16,29,12,1,11,6,0.4,51,5.88235294117647
"4465",2011,"Texas Tech",NA,NA,NA,104,204,83,54,0,155,2,71,55,126,70,0,225,76,149,109,33,76,21,0.201923076923077,513,13.64522417154
"4466",2011,"Tulane",NA,NA,NA,59,115,57,36,0,79,0,60,51,111,35,0,103,42,61,56,17,39,16,0.271186440677966,315,11.1111111111111
"4467",2011,"UC Davis",NA,NA,NA,6,41,25,20,0,30,0,21,12,33,10,0,29,9,20,28,11,17,1,0.166666666666667,98,10.2040816326531
"4468",2011,"UC Riverside",NA,NA,NA,12,33,17,9,0,22,0,11,9,20,12,0,12,4,8,27,9,18,2,0.166666666666667,74,16.2162162162162
"4469",2011,"UC Santa Barbara",NA,NA,NA,25,57,17,11,0,30,0,6,5,11,6,0,59,24,35,43,12,31,8,0.32,127,4.7244094488189
"4470",2011,"UCF",NA,NA,NA,52,73,35,23,0,57,0,26,21,47,26,0,92,33,59,56,16,40,11,0.211538461538462,204,12.7450980392157
"4471",2011,"UCLA",NA,NA,NA,293,456,283,165,0,308,1,225,168,393,230,0,547,212,335,164,42,122,69,0.235494880546075,1295,17.7606177606178
"4472",2011,"UConn",NA,NA,NA,462,1052,441,310,0,453,0,537,243,780,330,0,677,261,416,603,217,386,132,0.285714285714286,2681,12.3088399850802
"4473",2011,"UIC",NA,NA,NA,15,24,14,8,0,18,0,6,1,7,7,0,33,7,26,16,4,12,2,0.133333333333333,60,11.6666666666667
"4474",2011,"UMBC",NA,NA,NA,4,16,3,2,0,9,0,5,2,7,3,0,11,5,6,24,7,17,0,0,37,8.10810810810811
"4475",2011,"UNC Wilmington",NA,NA,NA,43,74,35,18,0,50,0,38,31,69,33,0,69,18,51,52,14,38,6,0.13953488372093,195,16.9230769230769
"4476",2011,"UNLV",NA,NA,NA,32,53,25,18,0,44,0,4,5,9,17,0,64,20,44,31,9,22,7,0.21875,120,14.1666666666667
"4477",2011,"USC",NA,NA,NA,153,297,199,128,0,194,1,86,90,176,79,0,369,129,240,173,63,110,35,0.22875816993464,776,10.180412371134
"4478",2011,"UT Martin",NA,NA,NA,19,49,20,12,0,36,0,7,3,10,3,0,38,12,26,43,11,32,4,0.210526315789474,102,2.94117647058824
"4479",2011,"UT Rio Grande Valley",NA,NA,NA,28,59,39,25,0,79,0,18,19,37,23,0,96,25,71,59,19,40,4,0.142857142857143,157,14.6496815286624
"4480",2011,"UTEP",NA,NA,NA,14,28,19,10,0,28,1,12,9,21,4,0,21,6,15,16,4,12,4,0.285714285714286,68,5.88235294117647
"4481",2011,"UTSA",NA,NA,NA,10,20,7,4,0,20,0,11,8,19,7,0,14,3,11,32,8,24,5,0.5,55,12.7272727272727
"4482",2011,"Utah",NA,NA,NA,31,77,20,15,0,48,0,21,23,44,17,0,60,19,41,63,18,45,7,0.225806451612903,171,9.94152046783626
"4483",2011,"Valparaiso",NA,NA,NA,30,60,26,15,0,51,0,13,21,34,18,0,62,23,39,52,15,37,6,0.2,148,12.1621621621622
"4484",2011,"Vanderbilt",NA,NA,NA,174,314,195,125,0,260,1,161,103,264,95,0,251,81,170,239,95,144,51,0.293103448275862,879,10.8077360637088
"4485",2011,"Vermont",NA,NA,NA,35,66,26,15,0,46,0,17,21,38,14,0,58,13,45,49,7,42,6,0.171428571428571,147,9.52380952380952
"4486",2011,"Villanova",NA,NA,NA,40,139,31,25,0,99,0,43,36,79,42,0,82,24,58,182,42,140,6,0.15,296,14.1891891891892
"4487",2011,"Virginia Tech",NA,NA,NA,78,119,65,31,0,103,0,40,52,92,49,0,162,49,113,74,22,52,16,0.205128205128205,324,15.1234567901235
"4488",2011,"Wake Forest",NA,NA,NA,116,205,108,63,0,190,0,80,63,143,80,0,241,61,180,165,46,119,23,0.198275862068966,534,14.9812734082397
"4489",2011,"Washington",NA,NA,NA,62,133,62,38,0,134,1,40,41,81,35,0,139,43,96,69,26,43,12,0.193548387096774,318,11.0062893081761
"4490",2011,"Washington State",NA,NA,NA,119,216,114,59,0,193,0,84,72,156,89,0,215,73,142,237,77,160,33,0.277310924369748,590,15.0847457627119
"4491",2011,"West Virginia",NA,NA,NA,439,690,483,298,0,552,2,382,261,643,313,0,571,162,409,436,133,303,92,0.209567198177677,1943,16.1091096242923
"4492",2011,"Western Carolina",NA,NA,NA,12,19,7,2,0,20,0,0,0,0,4,0,30,6,24,20,7,13,3,0.25,45,8.88888888888889
"4493",2011,"Western Illinois",NA,NA,NA,15,41,15,11,0,39,0,10,6,16,11,0,52,11,41,30,5,25,1,0.0666666666666667,87,12.6436781609195
"4494",2011,"Western Kentucky",NA,NA,NA,30,39,16,7,0,30,0,23,18,41,6,0,41,15,26,34,10,24,8,0.266666666666667,119,5.04201680672269
"4495",2011,"Western Michigan",NA,NA,NA,12,18,15,9,0,21,0,5,5,10,9,0,28,10,18,10,2,8,3,0.25,53,16.9811320754717
"4496",2011,"Whitman",NA,NA,NA,18,12,9,3,0,23,0,2,1,3,5,0,36,10,26,20,4,16,1,0.0555555555555556,47,10.6382978723404
"4497",2011,"Wisconsin",NA,NA,NA,41,147,55,36,0,100,0,66,63,129,28,0,83,25,58,96,28,68,7,0.170731707317073,318,8.80503144654088
"4498",2011,"Wright State",NA,NA,NA,33,77,54,34,0,44,3,21,9,30,16,0,83,25,58,48,11,37,10,0.303030303030303,180,8.88888888888889
"4499",2011,"Xavier",NA,NA,NA,292,626,299,184,0,269,0,290,178,468,156,0,446,155,291,360,116,244,82,0.280821917808219,1566,9.96168582375479
"4500",2011,"Yale",NA,NA,NA,9,26,27,15,0,21,0,16,15,31,8,0,12,7,5,19,8,11,3,0.333333333333333,76,10.5263157894737
"4501",2011,"Youngstown State",NA,NA,NA,13,35,19,12,0,33,0,12,2,14,18,0,51,14,37,22,5,17,2,0.153846153846154,85,21.1764705882353
"4502",2012,"Air Force",NA,NA,NA,54,106,49,29,0,81,2,12,13,25,25,0,162,60,102,30,10,20,9,0.166666666666667,252,9.92063492063492
"4503",2012,"Akron",NA,NA,NA,63,115,51,34,0,74,0,60,50,110,35,0,52,12,40,82,34,48,17,0.26984126984127,300,11.6666666666667
"4504",2012,"Alabama",NA,NA,NA,427,654,424,247,0,520,4,219,173,392,259,0,874,256,618,376,95,281,87,0.203747072599532,1758,14.7326507394767
"4505",2012,"Alabama A&M",NA,NA,NA,75,95,50,32,0,77,1,16,27,43,21,0,174,49,125,56,17,39,23,0.306666666666667,267,7.86516853932584
"4506",2012,"Alabama State",NA,NA,NA,40,39,23,13,0,50,2,8,14,22,13,0,52,7,45,40,7,33,3,0.075,106,12.2641509433962
"4507",2012,"Albany",NA,NA,NA,92,133,103,62,0,99,0,64,79,143,75,0,118,32,86,75,29,46,17,0.184782608695652,380,19.7368421052632
"4508",2012,"Alcorn State",NA,NA,NA,125,177,124,73,0,165,0,61,79,140,91,0,265,69,196,85,31,54,21,0.168,490,18.5714285714286
"4509",2012,"Appalachian State",NA,NA,NA,72,142,54,32,0,103,0,70,59,129,64,0,135,37,98,76,25,51,13,0.180555555555556,360,17.7777777777778
"4510",2012,"Arizona",NA,NA,NA,287,598,320,211,0,345,1,229,192,421,181,0,514,146,368,404,144,260,64,0.222996515679443,1483,12.2049898853675
"4511",2012,"Arizona State",NA,NA,NA,320,692,301,192,0,461,4,306,268,574,281,0,569,188,381,360,109,251,85,0.265625,1691,16.6173861620343
"4512",2012,"Arkansas State",NA,NA,NA,12,22,8,5,0,13,0,10,11,21,11,0,11,3,8,21,8,13,2,0.166666666666667,56,19.6428571428571
"4513",2012,"Arkansas-Pine Bluff",NA,NA,NA,70,127,62,37,0,128,2,30,41,71,41,0,147,29,118,70,22,48,12,0.171428571428571,288,14.2361111111111
"4514",2012,"Army",NA,NA,NA,35,73,32,18,0,45,1,26,27,53,25,0,74,23,51,38,7,31,8,0.228571428571429,170,14.7058823529412
"4515",2012,"Auburn",NA,NA,NA,356,528,301,176,0,410,1,197,159,356,232,0,634,180,454,334,114,220,83,0.23314606741573,1461,15.8795345653662
"4516",2012,"BYU",NA,NA,NA,77,187,72,50,0,100,1,49,24,73,47,0,175,73,102,137,46,91,14,0.181818181818182,455,10.3296703296703
"4517",2012,"Ball State",NA,NA,NA,18,64,35,21,0,44,0,14,11,25,12,0,35,8,27,41,9,32,5,0.277777777777778,120,10
"4518",2012,"Baylor",NA,NA,NA,560,1163,668,440,2,483,7,500,293,793,314,0,1021,440,581,416,140,276,172,0.307142857142857,2994,10.4876419505678
"4519",2012,"Belmont",NA,NA,NA,39,91,45,23,0,54,0,22,34,56,25,0,84,28,56,62,22,40,7,0.17948717948718,209,11.9617224880383
"4520",2012,"Bethune-Cookman",NA,NA,NA,9,18,14,9,0,14,0,8,14,22,8,0,17,2,15,11,1,10,3,0.333333333333333,41,19.5121951219512
"4521",2012,"Binghamton",NA,NA,NA,26,57,22,14,0,30,0,13,20,33,10,0,40,18,22,28,5,23,3,0.115384615384615,125,8
"4522",2012,"Boise State",NA,NA,NA,22,51,18,14,0,33,0,19,8,27,17,0,61,15,46,26,8,18,6,0.272727272727273,118,14.406779661017
"4523",2012,"Boston College",NA,NA,NA,249,527,248,165,0,372,1,202,165,367,161,0,508,153,355,383,115,268,70,0.281124497991968,1316,12.2340425531915
"4524",2012,"Boston University",NA,NA,NA,83,146,88,52,0,105,0,47,49,96,40,0,163,55,108,120,37,83,20,0.240963855421687,388,10.3092783505155
"4525",2012,"Bowling Green",NA,NA,NA,35,68,37,26,0,40,1,32,35,67,29,0,42,10,32,61,21,40,7,0.2,175,16.5714285714286
"4526",2012,"Bradley",NA,NA,NA,78,104,83,56,0,97,0,15,11,26,57,0,198,77,121,87,31,56,25,0.320512820512821,329,17.3252279635258
"4527",2012,"Bucknell",NA,NA,NA,6,24,8,6,0,15,0,4,5,9,7,0,21,6,15,9,0,9,0,0,41,17.0731707317073
"4528",2012,"Buffalo",NA,NA,NA,41,49,30,17,0,56,0,28,31,59,19,0,53,20,33,60,14,46,6,0.146341463414634,163,11.6564417177914
"4529",2012,"Butler",NA,NA,NA,46,86,56,34,0,60,0,25,43,68,42,0,73,21,52,68,17,51,12,0.260869565217391,210,20
"4530",2012,"Cal Poly",NA,NA,NA,39,79,34,21,0,51,0,42,40,82,27,0,67,22,45,56,24,32,9,0.230769230769231,216,12.5
"4531",2012,"Cal State Bakersfield",NA,NA,NA,40,75,33,22,0,58,0,44,32,76,28,0,68,18,50,100,31,69,7,0.175,219,12.7853881278539
"4532",2012,"Cal State Fullerton",NA,NA,NA,59,61,39,22,0,56,1,31,39,70,32,0,65,12,53,72,14,58,13,0.220338983050847,184,17.3913043478261
"4533",2012,"Cal State Northridge",NA,NA,NA,38,74,38,27,0,54,1,22,21,43,32,0,96,43,53,34,8,26,6,0.157894736842105,194,16.4948453608247
"4534",2012,"California",NA,NA,NA,328,560,334,186,0,356,5,265,191,456,175,0,594,194,400,235,74,161,83,0.253048780487805,1515,11.5511551155116
"4535",2012,"Campbell",NA,NA,NA,13,35,11,7,0,15,0,10,18,28,8,0,20,9,11,6,1,5,3,0.230769230769231,71,11.2676056338028
"4536",2012,"Canisius",NA,NA,NA,9,30,9,7,0,16,0,7,16,23,4,0,14,7,7,16,6,10,2,0.222222222222222,62,6.45161290322581
"4537",2012,"Central Arkansas",NA,NA,NA,49,69,39,25,0,38,0,26,42,68,19,0,33,12,21,73,17,56,9,0.183673469387755,179,10.6145251396648
"4538",2012,"Central Connecticut",NA,NA,NA,20,56,18,10,0,30,0,20,16,36,11,0,50,20,30,19,6,13,4,0.2,126,8.73015873015873
"4539",2012,"Central Michigan",NA,NA,NA,146,259,120,67,0,148,0,139,136,275,94,0,182,68,114,142,47,95,37,0.253424657534247,685,13.7226277372263
"4540",2012,"Charleston",NA,NA,NA,38,79,36,21,0,67,0,26,31,57,35,0,82,19,63,51,13,38,11,0.289473684210526,185,18.9189189189189
"4541",2012,"Charleston Southern",NA,NA,NA,47,79,37,20,0,66,0,50,45,95,45,0,37,6,31,115,35,80,9,0.191489361702128,225,20
"4542",2012,"Charlotte",NA,NA,NA,76,133,74,47,0,90,0,54,53,107,35,0,152,43,109,44,16,28,20,0.263157894736842,341,10.2639296187683
"4543",2012,"Chattanooga",NA,NA,NA,71,139,47,35,0,88,0,32,39,71,30,0,132,46,86,141,38,103,14,0.197183098591549,341,8.79765395894428
"4544",2012,"Chicago State",NA,NA,NA,31,32,23,14,0,22,0,7,15,22,20,0,53,18,35,39,10,29,3,0.0967741935483871,105,19.047619047619
"4545",2012,"Cincinnati",NA,NA,NA,218,415,202,121,0,290,1,215,162,377,173,0,333,97,236,351,104,247,38,0.174311926605505,1111,15.5715571557156
"4546",2012,"Clemson",NA,NA,NA,318,600,288,161,0,421,4,258,293,551,198,0,516,162,354,265,72,193,70,0.220125786163522,1480,13.3783783783784
"4547",2012,"Cleveland State",NA,NA,NA,23,67,30,19,0,51,0,34,30,64,22,0,50,17,33,42,16,26,5,0.217391304347826,163,13.4969325153374
"4548",2012,"Coastal Carolina",NA,NA,NA,19,51,9,7,0,33,1,15,4,19,12,0,75,22,53,27,6,21,5,0.263157894736842,115,10.4347826086957
"4549",2012,"Colgate",NA,NA,NA,14,17,2,2,0,16,0,6,3,9,5,0,29,5,24,22,2,20,1,0.0714285714285714,44,11.3636363636364
"4550",2012,"Colorado",NA,NA,NA,434,876,382,234,0,534,3,375,278,653,258,0,648,200,448,583,172,411,106,0.244239631336406,2167,11.9058606368251
"4551",2012,"Colorado State",NA,NA,NA,31,70,40,28,0,47,0,26,30,56,24,0,65,18,47,41,11,30,5,0.161290322580645,163,14.7239263803681
"4552",2012,"Coppin State",NA,NA,NA,68,108,91,49,0,79,6,42,59,101,39,0,86,21,65,43,7,36,9,0.132352941176471,265,14.7169811320755
"4553",2012,"Creighton",NA,NA,NA,64,162,63,45,0,87,0,40,26,66,63,0,173,56,117,138,43,95,16,0.25,386,16.3212435233161
"4554",2012,"Dartmouth",NA,NA,NA,23,70,25,18,0,46,1,10,16,26,19,0,63,11,52,54,11,43,3,0.130434782608696,132,14.3939393939394
"4555",2012,"Davidson",NA,NA,NA,48,77,45,30,0,53,0,36,38,74,29,0,60,17,43,41,9,32,10,0.208333333333333,201,14.4278606965174
"4556",2012,"Dayton",NA,NA,NA,82,177,74,47,0,127,0,64,61,125,43,0,152,53,99,140,38,102,23,0.280487804878049,440,9.77272727272727
"4557",2012,"DePaul",NA,NA,NA,359,745,322,215,0,464,0,355,222,577,288,0,623,228,395,662,224,438,111,0.309192200557103,2015,14.2928039702233
"4558",2012,"Delaware",NA,NA,NA,323,679,320,236,0,301,1,229,124,353,161,0,763,307,456,274,89,185,89,0.275541795665635,1735,9.27953890489914
"4559",2012,"Delaware State",NA,NA,NA,48,46,36,21,0,60,0,21,31,52,27,0,92,20,72,29,7,22,9,0.1875,150,18
"4560",2012,"Denver",NA,NA,NA,37,62,41,26,0,42,0,30,32,62,17,0,51,14,37,41,12,29,6,0.162162162162162,164,10.3658536585366
"4561",2012,"Detroit Mercy",NA,NA,NA,85,185,108,74,0,123,1,63,70,133,22,0,124,35,89,107,31,76,16,0.188235294117647,432,5.09259259259259
"4562",2012,"Drake",NA,NA,NA,65,127,48,29,0,86,0,18,9,27,32,0,202,86,116,69,21,48,17,0.261538461538462,331,9.66767371601208
"4563",2012,"Drexel",NA,NA,NA,63,132,60,45,0,86,2,44,33,77,40,0,145,55,90,99,29,70,18,0.285714285714286,338,11.8343195266272
"4564",2012,"Duke",NA,NA,NA,453,778,384,244,0,446,0,483,236,719,387,0,810,292,518,363,134,229,139,0.306843267108168,2243,17.2536781096745
"4565",2012,"Duquesne",NA,NA,NA,76,123,69,47,0,81,0,56,45,101,52,0,103,27,76,90,21,69,11,0.144736842105263,321,16.1993769470405
"4566",2012,"East Carolina",NA,NA,NA,16,48,20,13,0,29,0,13,10,23,15,0,53,12,41,34,7,27,6,0.375,99,15.1515151515152
"4567",2012,"East Tennessee State",NA,NA,NA,29,47,15,12,0,43,0,9,6,15,12,0,84,34,50,48,12,36,9,0.310344827586207,138,8.69565217391304
"4568",2012,"Eastern Illinois",NA,NA,NA,58,120,64,44,0,64,1,41,31,72,29,0,107,42,65,64,17,47,13,0.224137931034483,288,10.0694444444444
"4569",2012,"Eastern Kentucky",NA,NA,NA,24,58,42,29,0,38,1,18,21,39,18,0,37,12,25,36,10,26,4,0.166666666666667,133,13.5338345864662
"4570",2012,"Eastern Michigan",NA,NA,NA,82,97,68,43,0,69,0,68,96,164,53,0,94,24,70,55,14,41,14,0.170731707317073,303,17.4917491749175
"4571",2012,"Eastern Washington",NA,NA,NA,56,64,23,15,0,51,0,20,26,46,45,0,118,45,73,47,8,39,11,0.196428571428571,197,22.8426395939086
"4572",2012,"Elon",NA,NA,NA,17,46,21,13,0,24,0,15,16,31,9,0,38,3,35,30,5,25,1,0.0588235294117647,92,9.78260869565217
"4573",2012,"Evansville",NA,NA,NA,45,62,23,12,0,37,1,18,28,46,25,0,71,22,49,52,11,41,10,0.222222222222222,165,15.1515151515152
"4574",2012,"Fairfield",NA,NA,NA,34,71,30,19,0,53,0,28,18,46,20,0,78,24,54,74,22,52,5,0.147058823529412,187,10.6951871657754
"4575",2012,"Fairleigh Dickinson",NA,NA,NA,28,50,24,13,0,32,0,8,23,31,11,0,51,14,37,30,9,21,5,0.178571428571429,116,9.48275862068965
"4576",2012,"Florida A&M",NA,NA,NA,36,50,20,12,0,34,0,7,8,15,15,0,67,20,47,49,16,33,4,0.111111111111111,137,10.9489051094891
"4577",2012,"Florida Atlantic",NA,NA,NA,9,25,3,2,0,7,0,5,15,20,6,0,18,1,17,20,2,18,2,0.222222222222222,43,13.953488372093
"4578",2012,"Florida Gulf Coast",NA,NA,NA,61,145,68,51,0,87,0,57,47,104,53,0,43,8,35,184,67,117,15,0.245901639344262,355,14.9295774647887
"4579",2012,"Florida International",NA,NA,NA,51,88,47,32,0,64,0,42,40,82,21,0,88,39,49,57,12,45,10,0.196078431372549,243,8.64197530864197
"4580",2012,"Florida State",NA,NA,NA,356,696,379,239,0,391,3,380,295,675,142,0,475,187,288,285,88,197,92,0.258426966292135,1818,7.81078107810781
"4581",2012,"Fordham",NA,NA,NA,27,52,10,7,0,29,0,18,25,43,10,0,30,7,23,42,12,30,5,0.185185185185185,119,8.40336134453782
"4582",2012,"Fresno State",NA,NA,NA,98,160,78,48,5,114,0,92,63,155,77,0,62,10,52,229,70,159,19,0.193877551020408,458,16.8122270742358
"4583",2012,"Furman",NA,NA,NA,54,100,61,40,0,72,0,33,41,74,26,0,72,17,55,69,21,48,6,0.111111111111111,243,10.6995884773663
"4584",2012,"Gardner-Webb",NA,NA,NA,41,67,25,15,0,55,0,14,15,29,21,0,102,31,71,33,6,27,10,0.24390243902439,167,12.5748502994012
"4585",2012,"George Mason",NA,NA,NA,66,105,43,36,0,84,0,27,45,72,40,0,174,55,119,68,19,49,13,0.196969696969697,288,13.8888888888889
"4586",2012,"George Washington",NA,NA,NA,28,91,49,28,0,70,1,25,17,42,32,0,90,32,58,58,16,42,4,0.142857142857143,201,15.9203980099502
"4587",2012,"Georgetown",NA,NA,NA,263,401,228,141,0,305,1,169,143,312,206,0,420,101,319,298,90,208,46,0.174904942965779,1079,19.0917516218721
"4588",2012,"Georgia",NA,NA,NA,410,643,344,205,0,452,0,316,199,515,293,0,710,237,473,414,127,287,94,0.229268292682927,1833,15.9847244953628
"4589",2012,"Georgia Southern",NA,NA,NA,50,144,83,52,0,94,0,49,34,83,34,0,123,31,92,66,20,46,11,0.22,313,10.8626198083067
"4590",2012,"Georgia State",NA,NA,NA,61,108,91,49,0,98,1,55,39,94,48,0,156,46,110,51,11,40,15,0.245901639344262,307,15.6351791530945
"4591",2012,"Georgia Tech",NA,NA,NA,467,733,435,276,0,526,1,394,262,656,331,0,778,274,504,403,137,266,127,0.271948608137045,2131,15.5326137963397
"4592",2012,"Gonzaga",NA,NA,NA,376,611,294,194,0,361,1,245,165,410,240,0,812,311,501,322,108,214,89,0.236702127659574,1729,13.8808559861191
"4593",2012,"Grambling",NA,NA,NA,86,148,70,40,0,119,0,49,63,112,48,0,162,37,125,90,24,66,17,0.197674418604651,357,13.4453781512605
"4594",2012,"Green Bay",NA,NA,NA,300,594,347,237,0,478,1,370,243,613,337,0,394,145,249,509,173,336,86,0.286666666666667,1665,20.2402402402402
"4595",2012,"Hampton",NA,NA,NA,89,129,77,46,0,72,0,47,56,103,46,0,119,27,92,80,25,55,22,0.247191011235955,337,13.6498516320475
"4596",2012,"Hartford",NA,NA,NA,55,108,46,25,0,86,2,28,37,65,36,0,118,37,81,75,21,54,14,0.254545454545455,263,13.6882129277567
"4597",2012,"Harvard",NA,NA,NA,81,152,55,38,0,84,0,52,27,79,41,0,151,54,97,124,39,85,21,0.259259259259259,393,10.4325699745547
"4598",2012,"Hawai'i",NA,NA,NA,99,200,128,84,0,110,0,61,50,111,39,0,196,52,144,106,27,79,21,0.212121212121212,472,8.26271186440678
"4599",2012,"High Point",NA,NA,NA,135,197,140,84,0,140,1,86,77,163,81,0,246,67,179,113,40,73,27,0.2,552,14.6739130434783
"4600",2012,"Hofstra",NA,NA,NA,53,82,65,45,0,78,1,48,38,86,35,0,98,44,54,76,23,53,21,0.39622641509434,277,12.6353790613718
"4601",2012,"Holy Cross",NA,NA,NA,49,110,51,32,0,70,0,36,28,64,37,0,118,36,82,94,21,73,9,0.183673469387755,264,14.0151515151515
"4602",2012,"Houston",NA,NA,NA,44,70,64,35,0,59,2,20,16,36,14,0,106,29,77,40,7,33,5,0.113636363636364,181,7.73480662983425
"4603",2012,"Houston Christian",NA,NA,NA,14,48,26,17,0,28,0,8,7,15,17,0,48,12,36,36,10,26,5,0.357142857142857,97,17.5257731958763
"4604",2012,"Howard",NA,NA,NA,107,152,80,49,0,117,2,33,44,77,69,0,230,62,168,123,31,92,26,0.242990654205607,405,17.037037037037
"4605",2012,"IUPUI",NA,NA,NA,75,153,69,41,0,108,1,59,44,103,70,0,179,59,120,92,23,69,14,0.186666666666667,388,18.0412371134021
"4606",2012,"Idaho",NA,NA,NA,52,112,56,39,0,56,0,38,65,103,23,0,58,13,45,76,23,53,10,0.192307692307692,253,9.09090909090909
"4607",2012,"Idaho State",NA,NA,NA,59,145,57,37,0,68,0,43,44,87,30,0,99,25,74,87,27,60,12,0.203389830508475,320,9.375
"4608",2012,"Illinois",NA,NA,NA,263,407,253,158,0,335,0,163,92,255,186,0,622,214,408,225,67,158,73,0.277566539923954,1184,15.7094594594595
"4609",2012,"Illinois State",NA,NA,NA,77,164,64,41,0,73,0,32,39,71,54,0,210,73,137,127,42,85,16,0.207792207792208,403,13.3995037220844
"4610",2012,"Indiana",NA,NA,NA,301,452,225,148,0,311,2,143,189,332,145,0,569,180,389,256,72,184,61,0.20265780730897,1215,11.9341563786008
"4611",2012,"Indiana State",NA,NA,NA,26,68,32,19,0,44,0,23,21,44,25,0,53,17,36,51,13,38,5,0.192307692307692,154,16.2337662337662
"4612",2012,"Indianapolis",NA,NA,NA,11,28,13,9,0,6,0,11,11,22,6,0,11,1,10,18,4,14,4,0.363636363636364,60,10
"4613",2012,"Iona",NA,NA,NA,34,68,37,26,0,41,0,22,27,49,18,0,60,20,40,49,8,41,8,0.235294117647059,158,11.3924050632911
"4614",2012,"Iowa",NA,NA,NA,335,728,340,250,0,439,2,284,103,387,190,0,646,209,437,579,186,393,98,0.292537313432836,1844,10.3036876355748
"4615",2012,"Jackson State",NA,NA,NA,10,20,13,7,0,18,0,7,5,12,7,0,26,9,17,15,3,12,2,0.2,52,13.4615384615385
"4616",2012,"Jacksonville",NA,NA,NA,47,82,40,23,0,57,1,19,24,43,26,0,92,23,69,48,14,34,12,0.25531914893617,197,13.1979695431472
"4617",2012,"Jacksonville State",NA,NA,NA,24,40,22,9,0,30,0,9,8,17,7,0,48,6,42,24,6,18,4,0.166666666666667,90,7.77777777777778
"4618",2012,"James Madison",NA,NA,NA,131,216,141,90,0,148,1,74,71,145,63,0,217,65,152,127,33,94,33,0.251908396946565,559,11.2701252236136
"4619",2012,"Kansas City",NA,NA,NA,74,159,77,50,0,105,0,45,31,76,61,0,183,73,110,106,34,72,27,0.364864864864865,405,15.0617283950617
"4620",2012,"Kansas State",NA,NA,NA,294,567,253,155,0,412,0,218,191,409,210,0,560,186,374,502,139,363,55,0.187074829931973,1477,14.218009478673
"4621",2012,"Kennesaw State",NA,NA,NA,38,55,32,19,0,53,0,19,23,42,28,0,67,25,42,61,17,44,10,0.263157894736842,162,17.283950617284
"4622",2012,"Kentucky",NA,NA,NA,594,663,526,323,0,618,2,332,267,599,383,0,747,220,527,620,197,423,105,0.176767676767677,2141,17.8888369920598
"4623",2012,"LIU Brooklyn",NA,NA,NA,35,49,35,23,0,29,0,23,11,34,16,0,63,16,47,18,3,15,6,0.171428571428571,135,11.8518518518519
"4624",2012,"LSU",NA,NA,NA,368,716,393,255,0,451,4,266,149,415,234,0,745,270,475,288,84,204,90,0.244565217391304,1802,12.9855715871254
"4625",2012,"La Salle",NA,NA,NA,75,104,58,35,0,89,0,32,29,61,41,0,146,38,108,75,18,57,6,0.08,281,14.5907473309609
"4626",2012,"Lafayette",NA,NA,NA,33,64,24,14,0,58,0,15,10,25,20,0,105,42,63,37,8,29,13,0.393939393939394,165,12.1212121212121
"4627",2012,"Lamar",NA,NA,NA,46,79,59,38,0,58,0,33,29,62,35,0,92,25,67,56,7,49,11,0.239130434782609,205,17.0731707317073
"4628",2012,"Lehigh",NA,NA,NA,7,19,14,9,0,12,0,2,8,10,6,0,7,1,6,24,7,17,0,0,41,14.6341463414634
"4629",2012,"Liberty",NA,NA,NA,164,179,131,78,0,88,0,91,88,179,59,0,143,34,109,91,23,68,40,0.24390243902439,523,11.2810707456979
"4630",2012,"Lipscomb",NA,NA,NA,11,20,10,5,0,24,0,5,2,7,7,0,22,3,19,24,6,18,3,0.272727272727273,49,14.2857142857143
"4631",2012,"Little Rock",NA,NA,NA,41,70,32,18,0,45,0,23,21,44,10,0,85,27,58,39,12,27,8,0.195121951219512,185,5.4054054054054
"4632",2012,"Long Beach State",NA,NA,NA,30,42,20,13,0,35,0,8,15,23,25,0,59,19,40,42,5,37,6,0.2,111,22.5225225225225
"4633",2012,"Longwood",NA,NA,NA,31,51,29,17,0,44,0,18,25,43,22,0,68,21,47,33,7,26,4,0.129032258064516,136,16.1764705882353
"4634",2012,"Louisiana",NA,NA,NA,16,26,5,3,0,8,0,1,1,2,14,0,38,6,32,20,6,14,4,0.25,55,25.4545454545455
"4635",2012,"Louisiana Tech",NA,NA,NA,62,152,78,48,0,117,0,61,56,117,37,0,118,42,76,90,28,62,13,0.209677419354839,367,10.0817438692098
"4636",2012,"Louisville",NA,NA,NA,383,666,353,229,0,445,2,312,172,484,249,0,578,168,410,496,157,339,92,0.240208877284595,1777,14.0123804164322
"4637",2012,"Loyola Chicago",NA,NA,NA,51,118,53,34,0,87,0,33,32,65,36,0,125,40,85,69,32,37,12,0.235294117647059,295,12.2033898305085
"4638",2012,"Loyola Maryland",NA,NA,NA,35,63,43,30,0,64,0,31,36,67,30,0,46,13,33,49,12,37,5,0.142857142857143,166,18.0722891566265
"4639",2012,"Loyola Marymount",NA,NA,NA,60,101,59,35,0,68,0,23,35,58,18,0,116,37,79,79,28,51,8,0.133333333333333,263,6.84410646387833
"4640",2012,"Maine",NA,NA,NA,18,24,12,6,0,17,0,9,22,31,1,0,10,6,4,13,2,11,3,0.166666666666667,62,1.61290322580645
"4641",2012,"Manhattan",NA,NA,NA,34,65,8,7,0,34,0,19,20,39,35,0,59,24,35,62,22,40,11,0.323529411764706,165,21.2121212121212
"4642",2012,"Marist",NA,NA,NA,40,145,61,44,0,62,0,65,36,101,39,0,60,17,43,92,34,58,6,0.15,323,12.0743034055728
"4643",2012,"Marquette",NA,NA,NA,248,505,284,170,0,357,0,170,143,313,180,1,425,126,299,302,93,209,41,0.165322580645161,1206,14.9253731343284
"4644",2012,"Marshall",NA,NA,NA,47,70,40,28,0,52,0,21,32,53,36,0,48,11,37,67,18,49,8,0.170212765957447,177,20.3389830508475
"4645",2012,"Marygrove College",NA,NA,NA,10,17,14,7,0,17,0,11,12,23,14,0,23,6,17,7,0,7,4,0.4,46,30.4347826086957
"4646",2012,"Maryland",NA,NA,NA,540,941,501,342,0,488,1,445,232,677,237,0,1003,378,625,357,131,226,161,0.298148148148148,2607,9.09090909090909
"4647",2012,"Maryland-Eastern Shore",NA,NA,NA,17,64,37,20,0,29,1,14,18,32,15,0,47,11,36,18,7,11,1,0.0588235294117647,124,12.0967741935484
"4648",2012,"McNeese",NA,NA,NA,92,133,85,55,0,116,0,47,50,97,45,0,163,52,111,110,31,79,20,0.217391304347826,370,12.1621621621622
"4649",2012,"Memphis",NA,NA,NA,92,125,100,56,0,73,1,58,56,114,51,0,117,32,85,82,18,64,23,0.25,351,14.5299145299145
"4650",2012,"Mercer",NA,NA,NA,19,32,9,5,0,24,0,4,4,8,8,0,36,11,25,16,2,14,2,0.105263157894737,70,11.4285714285714
"4651",2012,"Miami",NA,NA,NA,260,385,203,139,0,267,1,189,132,321,157,0,394,133,261,321,96,225,61,0.234615384615385,1123,13.9804096170971
"4652",2012,"Miami (OH)",NA,NA,NA,37,60,40,30,0,30,1,24,22,46,10,0,40,10,30,35,7,28,10,0.27027027027027,150,6.66666666666667
"4653",2012,"Michigan",NA,NA,NA,244,595,258,179,0,307,0,240,167,407,193,0,490,174,316,485,156,329,66,0.270491803278689,1472,13.1114130434783
"4654",2012,"Michigan State",NA,NA,NA,341,624,304,182,0,409,1,321,264,585,223,0,405,133,272,441,145,296,85,0.249266862170088,1647,13.5397692774742
"4655",2012,"Middle Tennessee",NA,NA,NA,80,109,57,34,0,91,1,49,36,85,33,0,99,19,80,105,30,75,13,0.1625,305,10.8196721311475
"4656",2012,"Milwaukee",NA,NA,NA,68,158,92,56,0,120,0,57,83,140,46,0,83,27,56,125,33,92,16,0.235294117647059,364,12.6373626373626
"4657",2012,"Minnesota",NA,NA,NA,334,693,352,241,0,440,0,113,92,205,217,0,1045,435,610,256,91,165,92,0.275449101796407,1758,12.3435722411832
"4658",2012,"Mississippi State",NA,NA,NA,403,656,301,175,0,449,2,213,140,353,254,0,840,251,589,400,105,295,89,0.220843672456576,1700,14.9411764705882
"4659",2012,"Mississippi Valley State",NA,NA,NA,96,171,73,45,0,142,1,56,41,97,68,0,169,47,122,152,46,106,18,0.1875,434,15.668202764977
"4660",2012,"Missouri",NA,NA,NA,153,388,176,116,0,240,1,106,87,193,71,0,296,87,209,300,93,207,39,0.254901960784314,868,8.17972350230415
"4661",2012,"Missouri State",NA,NA,NA,130,204,123,74,0,153,3,52,46,98,74,0,230,89,141,155,33,122,24,0.184615384615385,538,13.7546468401487
"4662",2012,"Monmouth",NA,NA,NA,37,48,20,14,0,31,0,19,15,34,17,0,57,14,43,32,9,23,9,0.243243243243243,129,13.1782945736434
"4663",2012,"Montana",NA,NA,NA,15,26,17,11,0,13,0,8,16,24,5,0,22,6,16,17,5,12,2,0.133333333333333,66,7.57575757575758
"4664",2012,"Montana State",NA,NA,NA,33,75,24,17,0,58,0,24,39,63,23,0,55,25,30,65,16,49,7,0.212121212121212,185,12.4324324324324
"4665",2012,"Morgan State",NA,NA,NA,23,52,18,11,0,36,0,15,13,28,16,0,64,14,50,40,12,28,3,0.130434782608696,119,13.4453781512605
"4666",2012,"Mount St. Mary's",NA,NA,NA,36,71,27,16,0,51,0,24,27,51,22,0,54,15,39,62,12,50,9,0.25,164,13.4146341463415
"4667",2012,"Murray State",NA,NA,NA,91,156,90,52,0,123,0,69,47,116,53,0,150,49,101,151,41,110,18,0.197802197802198,435,12.183908045977
"4668",2012,"NC State",NA,NA,NA,556,813,448,275,0,547,2,354,329,683,317,0,801,246,555,578,193,385,129,0.232014388489209,2287,13.8609532138172
"4669",2012,"NJIT",NA,NA,NA,11,23,6,4,0,15,0,0,0,0,6,0,38,13,25,19,5,14,4,0.363636363636364,53,11.3207547169811
"4670",2012,"Navy",NA,NA,NA,19,54,16,10,0,27,0,13,10,23,15,0,42,12,30,45,12,33,5,0.263157894736842,115,13.0434782608696
"4671",2012,"Nevada",NA,NA,NA,45,74,37,23,0,41,0,18,24,42,23,0,89,37,52,53,19,34,11,0.244444444444444,205,11.219512195122
"4672",2012,"New Hampshire",NA,NA,NA,21,48,15,10,0,43,0,15,9,24,15,0,55,17,38,32,11,21,4,0.19047619047619,114,13.1578947368421
"4673",2012,"New Mexico",NA,NA,NA,38,95,44,27,0,55,0,23,15,38,20,0,114,34,80,55,17,38,9,0.236842105263158,218,9.1743119266055
"4674",2012,"New Mexico State",NA,NA,NA,37,72,41,26,0,59,1,24,21,45,15,0,59,16,43,42,13,29,5,0.135135135135135,169,8.87573964497041
"4675",2012,"Niagara",NA,NA,NA,37,64,33,24,0,60,0,21,28,49,28,0,72,22,50,51,12,39,8,0.216216216216216,166,16.8674698795181
"4676",2012,"Nicholls",NA,NA,NA,32,65,40,27,0,55,1,25,14,39,20,0,70,14,56,63,23,40,11,0.34375,170,11.7647058823529
"4677",2012,"Norfolk State",NA,NA,NA,10,30,8,4,0,22,1,11,11,22,4,0,22,6,16,8,0,8,3,0.3,60,6.66666666666667
"4678",2012,"North Carolina",NA,NA,NA,388,640,385,228,0,353,1,110,88,198,280,0,928,391,537,358,116,242,110,0.283505154639175,1755,15.954415954416
"4679",2012,"North Carolina A&T",NA,NA,NA,39,51,64,37,0,58,2,30,30,60,36,0,71,21,50,40,13,27,6,0.153846153846154,167,21.5568862275449
"4680",2012,"North Carolina Central",NA,NA,NA,32,65,34,20,0,47,0,14,23,37,29,0,81,22,59,44,11,33,9,0.28125,151,19.205298013245
"4681",2012,"North Dakota State",NA,NA,NA,54,105,60,33,0,63,2,28,40,68,23,0,89,24,65,61,15,46,5,0.0925925925925926,241,9.54356846473029
"4682",2012,"North Florida",NA,NA,NA,17,38,18,8,0,32,0,18,15,33,10,0,36,12,24,27,6,21,3,0.176470588235294,95,10.5263157894737
"4683",2012,"North Texas",NA,NA,NA,55,74,54,33,0,60,0,29,26,55,20,0,72,14,58,49,19,30,13,0.236363636363636,206,9.70873786407767
"4684",2012,"Northeastern",NA,NA,NA,52,95,56,35,0,75,1,46,30,76,31,0,82,25,57,104,31,73,15,0.288461538461538,263,11.787072243346
"4685",2012,"Northern Colorado",NA,NA,NA,33,66,44,29,0,47,0,21,33,54,36,0,50,9,41,38,11,27,7,0.212121212121212,150,24
"4686",2012,"Northern Illinois",NA,NA,NA,51,122,50,34,0,79,0,39,52,91,25,0,129,47,82,59,24,35,10,0.196078431372549,297,8.41750841750842
"4687",2012,"Northern Iowa",NA,NA,NA,36,99,45,32,0,84,0,30,22,52,39,0,117,47,70,105,37,68,8,0.222222222222222,260,15
"4688",2012,"Northwestern",NA,NA,NA,143,361,201,128,0,230,2,148,121,269,98,0,265,87,178,244,70,174,22,0.153846153846154,869,11.277330264672
"4689",2012,"Northwestern State",NA,NA,NA,14,26,12,7,0,17,1,6,3,9,7,0,30,10,20,17,3,14,6,0.428571428571429,61,11.4754098360656
"4690",2012,"Notre Dame",NA,NA,NA,508,785,485,332,0,496,0,525,329,854,420,0,719,236,483,400,141,259,130,0.255905511811024,2334,17.9948586118252
"4691",2012,"Oakland",NA,NA,NA,34,78,27,19,0,40,0,27,17,44,27,0,74,27,47,52,10,42,11,0.323529411764706,183,14.7540983606557
"4692",2012,"Ohio",NA,NA,NA,37,66,38,24,0,44,2,30,34,64,19,0,60,21,39,51,13,38,6,0.162162162162162,176,10.7954545454545
"4693",2012,"Ohio State",NA,NA,NA,355,742,385,258,0,401,2,389,221,610,241,0,685,247,438,437,160,277,88,0.247887323943662,1995,12.0802005012531
"4694",2012,"Oklahoma",NA,NA,NA,359,814,410,277,0,519,0,320,238,558,209,0,661,240,421,489,171,318,95,0.264623955431755,2025,10.320987654321
"4695",2012,"Oklahoma State",NA,NA,NA,362,835,370,232,0,464,0,317,245,562,226,0,673,247,426,518,162,356,89,0.24585635359116,2031,11.1275233874938
"4696",2012,"Old Dominion",NA,NA,NA,101,181,81,53,0,132,1,70,59,129,42,0,210,74,136,110,29,81,21,0.207920792079208,476,8.82352941176471
"4697",2012,"Ole Miss",NA,NA,NA,400,611,302,170,0,369,4,270,214,484,173,0,644,170,474,352,99,253,93,0.2325,1629,10.6200122774708
"4698",2012,"Omaha",NA,NA,NA,5,24,9,5,0,19,0,7,4,11,4,0,17,7,10,11,4,7,2,0.4,49,8.16326530612245
"4699",2012,"Oral Roberts",NA,NA,NA,57,121,45,31,0,88,2,50,45,95,64,0,141,44,97,71,25,46,14,0.245614035087719,308,20.7792207792208
"4700",2012,"Oregon",NA,NA,NA,334,672,351,221,0,332,3,202,213,415,247,0,522,162,360,588,187,401,46,0.137724550898204,1642,15.0426309378806
"4701",2012,"Oregon State",NA,NA,NA,54,227,93,64,0,121,0,67,57,124,47,0,146,58,88,150,52,98,13,0.240740740740741,487,9.65092402464066
"4702",2012,"Pacific",NA,NA,NA,73,116,78,53,0,93,1,47,56,103,54,0,97,32,65,84,34,50,15,0.205479452054795,321,16.8224299065421
"4703",2012,"Penn State",NA,NA,NA,360,720,406,268,0,451,3,277,200,477,239,0,841,320,521,335,112,223,83,0.230555555555556,1886,12.6723223753977
"4704",2012,"Pennsylvania",NA,NA,NA,16,52,6,4,0,36,0,14,13,27,11,0,33,5,28,38,8,30,4,0.25,97,11.340206185567
"4705",2012,"Pepperdine",NA,NA,NA,104,166,103,66,0,156,2,69,71,140,81,0,215,38,177,133,37,96,16,0.153846153846154,435,18.6206896551724
"4706",2012,"Pittsburgh",NA,NA,NA,366,628,355,208,0,405,1,273,244,517,165,0,692,194,498,275,71,204,79,0.215846994535519,1624,10.1600985221675
"4707",2012,"Portland",NA,NA,NA,58,109,56,38,0,80,0,33,39,72,49,0,107,36,71,106,38,68,10,0.172413793103448,290,16.8965517241379
"4708",2012,"Portland State",NA,NA,NA,32,49,22,17,0,26,0,6,14,20,12,0,67,24,43,43,15,28,7,0.21875,131,9.16030534351145
"4709",2012,"Prairie View A&M",NA,NA,NA,74,147,65,44,0,94,1,42,32,74,52,0,185,56,129,77,22,55,15,0.202702702702703,358,14.5251396648045
"4710",2012,"Presbyterian",NA,NA,NA,25,63,28,17,0,45,0,13,11,24,26,0,84,25,59,34,11,23,2,0.08,144,18.0555555555556
"4711",2012,"Princeton",NA,NA,NA,70,102,56,36,0,63,0,53,58,111,33,0,94,32,62,53,10,43,21,0.3,282,11.7021276595745
"4712",2012,"Providence",NA,NA,NA,279,444,228,132,0,345,2,209,197,406,161,0,452,117,335,289,79,210,59,0.211469534050179,1191,13.5180520570949
"4713",2012,"Purdue Fort Wayne",NA,NA,NA,32,60,36,25,0,61,0,17,28,45,18,0,53,14,39,63,16,47,0,0,147,12.2448979591837
"4714",2012,"Quinnipiac",NA,NA,NA,28,64,42,23,0,31,0,25,30,55,17,0,35,11,24,28,5,23,11,0.392857142857143,147,11.5646258503401
"4715",2012,"Radford",NA,NA,NA,36,41,20,11,0,48,1,15,19,34,17,0,56,14,42,36,12,24,4,0.111111111111111,121,14.0495867768595
"4716",2012,"Rice",NA,NA,NA,48,64,49,28,0,51,0,22,21,43,27,0,73,19,54,63,15,48,14,0.291666666666667,178,15.1685393258427
"4717",2012,"Richmond",NA,NA,NA,46,107,34,22,0,80,0,44,38,82,26,0,88,28,60,58,20,38,12,0.260869565217391,253,10.2766798418972
"4718",2012,"Rider",NA,NA,NA,18,33,13,6,0,20,0,12,16,28,10,0,23,8,15,12,4,8,7,0.388888888888889,78,12.8205128205128
"4719",2012,"Robert Morris",NA,NA,NA,12,20,9,7,0,11,0,14,12,26,10,0,7,1,6,26,4,22,0,0,52,19.2307692307692
"4720",2012,"Rutgers",NA,NA,NA,314,564,299,185,0,406,5,311,245,556,212,0,509,152,357,273,73,200,65,0.207006369426752,1506,14.0770252324037
"4721",2012,"SE Louisiana",NA,NA,NA,53,98,51,32,0,71,0,33,29,62,27,0,112,37,75,64,14,50,15,0.283018867924528,248,10.8870967741935
"4722",2012,"SIU Edwardsville",NA,NA,NA,65,85,35,23,0,61,0,29,42,71,29,0,91,35,56,84,21,63,20,0.307692307692308,244,11.8852459016393
"4723",2012,"SMU",NA,NA,NA,47,94,38,22,0,66,1,37,44,81,33,0,94,32,62,49,18,31,7,0.148936170212766,236,13.9830508474576
"4724",2012,"Sacramento State",NA,NA,NA,36,72,42,23,0,50,1,29,29,58,37,0,62,16,46,71,20,51,9,0.25,183,20.2185792349727
"4725",2012,"Sacred Heart",NA,NA,NA,32,60,28,17,0,43,0,30,36,66,37,0,53,21,32,48,14,34,5,0.15625,166,22.289156626506
"4726",2012,"Saint Joseph's",NA,NA,NA,64,175,93,54,0,115,1,50,45,95,35,0,217,80,137,86,28,58,17,0.265625,424,8.25471698113208
"4727",2012,"Saint Louis",NA,NA,NA,75,105,62,36,0,70,0,34,54,88,21,0,137,40,97,30,9,21,16,0.213333333333333,279,7.52688172043011
"4728",2012,"Saint Mary's",NA,NA,NA,126,264,161,111,0,163,1,70,54,124,72,0,242,91,151,132,52,80,23,0.182539682539683,644,11.1801242236025
"4729",2012,"Saint Peter's",NA,NA,NA,39,77,52,35,0,46,0,23,33,56,34,0,83,19,64,36,8,28,5,0.128205128205128,180,18.8888888888889
"4730",2012,"Sam Houston",NA,NA,NA,38,77,23,13,0,41,0,25,22,47,25,0,94,27,67,51,17,34,10,0.263157894736842,189,13.2275132275132
"4731",2012,"Samford",NA,NA,NA,34,148,67,46,0,95,0,47,53,100,44,0,77,27,50,115,42,73,4,0.117647058823529,315,13.968253968254
"4732",2012,"San Diego",NA,NA,NA,132,214,129,86,0,137,0,69,72,141,65,0,279,87,192,101,29,72,26,0.196969696969697,565,11.5044247787611
"4733",2012,"San Diego State",NA,NA,NA,85,146,94,54,0,112,1,65,24,89,52,0,177,64,113,84,18,66,24,0.282352941176471,403,12.9032258064516
"4734",2012,"San Francisco",NA,NA,NA,31,110,54,36,0,71,0,49,60,109,30,0,99,30,69,83,28,55,7,0.225806451612903,262,11.4503816793893
"4735",2012,"San José State",NA,NA,NA,10,23,11,8,0,16,0,13,20,33,7,0,13,3,10,15,6,9,4,0.4,57,12.280701754386
"4736",2012,"Santa Clara",NA,NA,NA,21,46,11,5,0,34,0,19,14,33,12,0,34,13,21,51,18,33,9,0.428571428571429,119,10.0840336134454
"4737",2012,"Savannah State",NA,NA,NA,35,55,23,12,0,59,0,10,23,33,23,0,95,24,71,32,5,27,4,0.114285714285714,134,17.1641791044776
"4738",2012,"Seattle U",NA,NA,NA,28,41,15,10,0,32,0,15,19,34,13,0,49,16,33,42,9,33,3,0.107142857142857,114,11.4035087719298
"4739",2012,"Seton Hall",NA,NA,NA,331,540,248,159,0,449,0,187,192,379,146,0,560,172,388,365,108,257,79,0.238670694864048,1396,10.458452722063
"4740",2012,"Siena",NA,NA,NA,33,35,16,9,0,27,0,16,31,47,17,0,25,8,17,30,7,23,2,0.0606060606060606,103,16.504854368932
"4741",2012,"South Alabama",NA,NA,NA,43,38,21,12,0,37,0,8,25,33,15,0,44,10,34,52,11,41,5,0.116279069767442,114,13.1578947368421
"4742",2012,"South Carolina",NA,NA,NA,464,628,376,208,0,448,2,272,181,453,233,0,748,249,499,472,131,341,127,0.273706896551724,1846,12.6218851570964
"4743",2012,"South Carolina State",NA,NA,NA,57,98,70,43,0,72,0,37,38,75,32,0,109,25,84,58,11,47,11,0.192982456140351,241,13.2780082987552
"4744",2012,"South Carolina Upstate",NA,NA,NA,27,61,30,18,0,49,0,12,11,23,24,0,66,19,47,72,14,58,5,0.185185185185185,142,16.9014084507042
"4745",2012,"South Dakota State",NA,NA,NA,59,137,65,40,0,80,0,59,58,117,30,0,61,26,35,111,49,62,15,0.254237288135593,349,8.59598853868195
"4746",2012,"South Florida",NA,NA,NA,342,596,339,211,0,464,5,267,299,566,293,0,535,164,371,460,126,334,83,0.242690058479532,1581,18.5325743200506
"4747",2012,"Southeast Missouri State",NA,NA,NA,11,23,10,5,0,17,0,7,7,14,6,0,20,2,18,17,1,16,1,0.0909090909090909,45,13.3333333333333
"4748",2012,"Southern",NA,NA,NA,24,41,15,11,0,32,0,11,13,24,8,0,63,16,47,18,5,13,6,0.25,100,8
"4749",2012,"Southern Illinois",NA,NA,NA,20,45,33,22,0,41,1,9,7,16,12,0,45,17,28,45,16,29,5,0.25,114,10.5263157894737
"4750",2012,"Southern Miss",NA,NA,NA,51,91,66,44,0,79,1,43,37,80,30,0,79,29,50,68,21,47,10,0.196078431372549,255,11.7647058823529
"4751",2012,"Southern Utah",NA,NA,NA,23,50,25,15,0,39,0,13,17,30,9,0,63,24,39,13,4,9,4,0.173913043478261,118,7.6271186440678
"4752",2012,"Southern Wesleyan",NA,NA,NA,9,24,13,8,0,18,0,4,2,6,6,0,30,7,23,15,2,13,3,0.333333333333333,48,12.5
"4753",2012,"St. Bonaventure",NA,NA,NA,94,257,135,93,0,156,1,72,68,140,51,0,224,79,145,149,46,103,23,0.24468085106383,583,8.74785591766724
"4754",2012,"St. Francis (PA)",NA,NA,NA,48,67,29,20,0,60,0,14,33,47,20,0,77,24,53,61,12,49,12,0.25,175,11.4285714285714
"4755",2012,"St. John's",NA,NA,NA,267,477,273,174,0,289,0,190,158,348,162,0,641,235,406,163,48,115,59,0.220973782771536,1284,12.6168224299065
"4756",2012,"Stanford",NA,NA,NA,489,984,446,313,0,468,0,492,255,747,224,0,770,277,493,564,176,388,150,0.306748466257669,2550,8.7843137254902
"4757",2012,"Stephen F. Austin",NA,NA,NA,51,93,45,29,0,74,0,36,18,54,22,0,69,22,47,82,27,55,15,0.294117647058824,240,9.16666666666667
"4758",2012,"Stetson",NA,NA,NA,78,123,63,41,0,69,0,55,81,136,37,0,78,23,55,95,19,76,21,0.269230769230769,313,11.8210862619808
"4759",2012,"Stony Brook",NA,NA,NA,34,34,31,18,0,46,0,13,19,32,18,0,82,21,61,21,2,19,5,0.147058823529412,110,16.3636363636364
"4760",2012,"Syracuse",NA,NA,NA,572,768,480,330,0,468,4,323,265,588,268,0,821,262,559,424,115,309,141,0.246503496503497,2172,12.3388581952118
"4761",2012,"TCU",NA,NA,NA,72,109,42,24,0,83,1,44,45,89,43,0,112,27,85,117,38,79,12,0.166666666666667,296,14.527027027027
"4762",2012,"Temple",NA,NA,NA,113,152,83,53,0,105,0,63,80,143,57,0,161,52,109,122,38,84,23,0.20353982300885,434,13.1336405529954
"4763",2012,"Tennessee",NA,NA,NA,578,952,538,345,0,503,5,435,271,706,281,0,880,303,577,547,183,364,145,0.250865051903114,2609,10.7704101188195
"4764",2012,"Tennessee State",NA,NA,NA,36,48,24,16,0,47,0,22,23,45,17,0,55,7,48,38,8,30,8,0.222222222222222,127,13.3858267716535
"4765",2012,"Tennessee Tech",NA,NA,NA,64,126,64,43,0,92,0,52,37,89,39,0,133,57,76,78,22,56,21,0.328125,334,11.6766467065868
"4766",2012,"Texas",NA,NA,NA,426,750,390,248,0,503,5,312,223,535,281,0,844,261,583,421,137,284,88,0.206572769953052,1990,14.1206030150754
"4767",2012,"Texas A&M",NA,NA,NA,495,695,462,277,0,536,0,404,266,670,274,0,903,293,610,328,102,226,126,0.254545454545455,2130,12.8638497652582
"4768",2012,"Texas A&M-Corpus Christi",NA,NA,NA,20,29,21,12,0,18,0,9,12,21,4,0,34,9,25,14,2,12,4,0.2,75,5.33333333333333
"4769",2012,"Texas Southern",NA,NA,NA,64,108,47,26,0,85,0,28,39,67,28,0,124,35,89,70,15,55,12,0.1875,258,10.8527131782946
"4770",2012,"Texas State",NA,NA,NA,40,76,34,26,0,40,0,33,24,57,28,0,73,18,55,68,21,47,7,0.175,199,14.070351758794
"4771",2012,"Texas Tech",NA,NA,NA,213,361,179,107,0,252,3,133,134,267,121,0,359,104,255,220,71,149,49,0.230046948356808,921,13.1378935939197
"4772",2012,"Toledo",NA,NA,NA,104,199,117,70,0,121,1,105,92,197,62,0,110,34,76,129,51,78,28,0.269230769230769,516,12.015503875969
"4773",2012,"Towson",NA,NA,NA,56,69,33,19,0,54,0,39,35,74,30,0,133,36,97,33,8,25,14,0.25,217,13.8248847926267
"4774",2012,"Troy",NA,NA,NA,11,19,13,8,0,12,0,6,11,17,6,0,17,6,11,12,4,8,4,0.363636363636364,48,12.5
"4775",2012,"Tulane",NA,NA,NA,76,131,71,44,0,77,0,39,47,86,43,0,95,35,60,98,33,65,14,0.184210526315789,329,13.0699088145897
"4776",2012,"UAB",NA,NA,NA,65,84,67,36,0,63,0,44,31,75,43,0,77,19,58,60,14,46,12,0.184615384615385,240,17.9166666666667
"4777",2012,"UC Davis",NA,NA,NA,35,107,47,27,0,84,0,42,40,82,44,0,67,19,48,130,41,89,10,0.285714285714286,255,17.2549019607843
"4778",2012,"UC Irvine",NA,NA,NA,13,21,11,8,0,14,0,14,6,20,15,0,15,4,11,25,8,17,2,0.153846153846154,64,23.4375
"4779",2012,"UC Riverside",NA,NA,NA,25,67,36,26,0,49,0,19,20,39,39,0,78,28,50,39,12,27,6,0.24,162,24.0740740740741
"4780",2012,"UC Santa Barbara",NA,NA,NA,28,43,10,7,0,44,0,6,14,20,8,0,68,20,48,34,6,28,5,0.178571428571429,108,7.40740740740741
"4781",2012,"UCF",NA,NA,NA,70,98,62,33,0,75,1,34,37,71,30,0,115,21,94,38,6,32,13,0.185714285714286,242,12.396694214876
"4782",2012,"UCLA",NA,NA,NA,170,266,133,83,0,228,2,134,92,226,111,0,346,111,235,158,40,118,50,0.294117647058824,762,14.5669291338583
"4783",2012,"UConn",NA,NA,NA,489,994,423,292,0,497,1,491,255,746,385,0,630,242,388,694,233,461,142,0.29038854805726,2578,14.9340574088441
"4784",2012,"UIC",NA,NA,NA,27,44,32,17,0,33,0,27,24,51,18,0,32,8,24,29,9,20,6,0.222222222222222,125,14.4
"4785",2012,"UMBC",NA,NA,NA,42,65,42,25,0,42,0,41,33,74,17,0,66,22,44,40,12,28,12,0.285714285714286,188,9.04255319148936
"4786",2012,"UMass",NA,NA,NA,7,24,6,2,0,15,0,6,9,15,8,0,6,2,4,18,6,12,0,0,45,17.7777777777778
"4787",2012,"UNC Asheville",NA,NA,NA,8,18,10,8,0,18,0,5,11,16,6,0,17,8,9,17,4,13,1,0.125,47,12.7659574468085
"4788",2012,"UNC Greensboro",NA,NA,NA,40,41,15,9,0,39,0,13,12,25,18,0,78,18,60,29,6,23,7,0.175,126,14.2857142857143
"4789",2012,"UNC Wilmington",NA,NA,NA,83,131,68,39,0,96,1,40,24,64,51,0,195,51,144,103,40,63,14,0.168674698795181,366,13.9344262295082
"4790",2012,"UNLV",NA,NA,NA,116,133,87,55,0,101,0,46,37,83,61,0,181,50,131,95,24,71,22,0.189655172413793,383,15.9268929503916
"4791",2012,"USC",NA,NA,NA,340,694,375,237,0,398,5,207,205,412,153,0,690,216,474,403,131,272,74,0.217647058823529,1698,9.01060070671378
"4792",2012,"UT Arlington",NA,NA,NA,13,22,3,2,0,15,0,9,6,15,8,0,24,3,21,13,2,11,2,0.153846153846154,50,16
"4793",2012,"UT Martin",NA,NA,NA,98,202,71,50,0,120,0,79,78,157,55,0,159,54,105,194,71,123,19,0.193877551020408,519,10.597302504817
"4794",2012,"UT Rio Grande Valley",NA,NA,NA,31,59,29,14,0,42,0,14,23,37,28,0,99,20,79,35,8,27,4,0.129032258064516,138,20.2898550724638
"4795",2012,"UTEP",NA,NA,NA,61,147,92,62,0,95,0,55,34,89,36,0,107,36,71,69,23,46,21,0.344262295081967,348,10.3448275862069
"4796",2012,"UTSA",NA,NA,NA,10,24,30,15,0,30,1,14,9,23,10,0,20,4,16,14,1,13,2,0.2,64,15.625
"4797",2012,"University of Sciences",NA,NA,NA,6,17,6,4,0,5,0,2,6,8,9,0,29,11,18,14,4,10,3,0.5,42,21.4285714285714
"4798",2012,"Utah",NA,NA,NA,299,828,319,209,0,437,4,255,141,396,161,0,684,224,460,525,161,364,70,0.234113712374582,1856,8.67456896551724
"4799",2012,"Utah State",NA,NA,NA,25,49,20,18,0,30,0,27,16,43,18,0,53,7,46,28,7,21,5,0.2,121,14.8760330578512
"4800",2012,"Utah Valley",NA,NA,NA,9,17,16,9,0,16,0,5,7,12,4,0,22,5,17,13,5,8,1,0.111111111111111,44,9.09090909090909
"4801",2012,"VCU",NA,NA,NA,76,107,70,39,0,91,0,48,27,75,38,0,175,61,114,59,17,42,20,0.263157894736842,324,11.7283950617284
"4802",2012,"Valparaiso",NA,NA,NA,61,141,65,37,0,88,0,37,51,88,39,0,95,36,59,85,21,64,15,0.245901639344262,316,12.3417721518987
"4803",2012,"Vanderbilt",NA,NA,NA,340,631,353,231,0,422,2,319,215,534,206,0,542,200,342,392,140,252,93,0.273529411764706,1711,12.0397428404442
"4804",2012,"Vermont",NA,NA,NA,54,95,33,21,0,82,0,28,42,70,33,0,83,17,66,84,29,55,7,0.12962962962963,228,14.4736842105263
"4805",2012,"Villanova",NA,NA,NA,185,602,178,115,0,307,0,193,158,351,135,0,336,111,225,584,198,386,50,0.27027027027027,1341,10.0671140939597
"4806",2012,"Virginia Tech",NA,NA,NA,286,451,222,121,0,393,2,171,171,342,165,0,594,163,431,305,76,229,68,0.237762237762238,1197,13.7844611528822
"4807",2012,"Virginia Union",NA,NA,NA,16,19,6,3,0,30,1,7,17,24,10,0,27,7,20,12,2,10,5,0.3125,52,19.2307692307692
"4808",2012,"Wagner",NA,NA,NA,29,40,14,8,0,39,0,10,22,32,10,0,39,7,32,46,12,34,3,0.103448275862069,100,10
"4809",2012,"Wake Forest",NA,NA,NA,399,660,380,229,0,502,5,343,233,576,281,0,641,169,472,434,131,303,86,0.215538847117794,1796,15.6458797327394
"4810",2012,"Washington",NA,NA,NA,371,750,440,266,0,444,2,204,152,356,173,0,830,273,557,344,120,224,101,0.272237196765499,1823,9.48985189248491
"4811",2012,"Washington State",NA,NA,NA,294,533,264,159,0,365,3,190,192,382,201,0,566,180,386,381,109,272,50,0.170068027210884,1375,14.6181818181818
"4812",2012,"Weber State",NA,NA,NA,40,76,34,14,0,42,0,18,24,42,22,0,90,27,63,72,30,42,6,0.15,197,11.1675126903553
"4813",2012,"West Virginia",NA,NA,NA,416,733,440,270,0,499,2,314,226,540,230,0,533,157,376,402,127,275,94,0.225961538461538,1859,12.3722431414739
"4814",2012,"Western Carolina",NA,NA,NA,36,61,33,20,0,48,0,14,20,34,27,0,69,21,48,43,14,29,6,0.166666666666667,151,17.8807947019868
"4815",2012,"Western Illinois",NA,NA,NA,34,75,46,29,0,45,0,19,13,32,26,0,79,19,60,61,21,40,4,0.117647058823529,177,14.6892655367232
"4816",2012,"Western Kentucky",NA,NA,NA,23,52,31,15,0,31,0,23,11,34,18,0,45,17,28,20,9,11,2,0.0869565217391304,132,13.6363636363636
"4817",2012,"Western Michigan",NA,NA,NA,25,40,27,16,0,32,0,18,28,46,25,0,32,7,25,29,7,22,4,0.16,103,24.2718446601942
"4818",2012,"Wichita State",NA,NA,NA,61,121,62,36,0,79,0,36,37,73,52,0,168,60,108,32,13,19,16,0.262295081967213,310,16.7741935483871
"4819",2012,"William & Mary",NA,NA,NA,33,73,23,14,0,47,0,23,26,49,8,0,87,29,58,44,19,25,4,0.121212121212121,181,4.41988950276243
"4820",2012,"Winthrop",NA,NA,NA,24,35,14,9,0,8,0,11,15,26,10,0,22,6,16,29,12,17,6,0.25,92,10.8695652173913
"4821",2012,"Wisconsin",NA,NA,NA,262,557,234,158,0,365,0,176,153,329,145,0,578,209,369,438,152,286,73,0.278625954198473,1429,10.146955913226
"4822",2012,"Wofford",NA,NA,NA,17,24,22,12,0,16,0,10,13,23,4,0,13,4,9,21,6,15,2,0.117647058823529,66,6.06060606060606
"4823",2012,"Wright State",NA,NA,NA,37,96,40,26,0,45,1,29,19,48,19,0,74,26,48,63,18,45,10,0.27027027027027,217,8.75576036866359
"4824",2012,"Wyoming",NA,NA,NA,24,48,28,17,0,25,0,9,5,14,7,0,55,14,41,33,14,19,7,0.291666666666667,118,5.93220338983051
"4825",2012,"Xavier",NA,NA,NA,83,169,83,55,0,89,0,56,46,102,16,0,128,35,93,97,27,70,15,0.180722891566265,391,4.0920716112532
"4826",2012,"Yale",NA,NA,NA,25,27,25,15,0,33,0,8,18,26,17,0,54,14,40,54,18,36,8,0.32,101,16.8316831683168
"4827",2012,"Youngstown State",NA,NA,NA,31,59,34,19,0,50,0,25,29,54,24,0,34,10,24,71,19,52,6,0.193548387096774,153,15.6862745098039
"4828",2013,"Air Force",NA,NA,NA,86,132,62,37,0,109,2,36,26,62,38,0,195,57,138,79,13,66,13,0.151162790697674,340,11.1764705882353
"4829",2013,"Akron",NA,NA,NA,108,244,103,78,0,107,0,105,105,210,57,0,130,41,89,194,72,122,20,0.185185185185185,595,9.57983193277311
"4830",2013,"Alabama A&M",NA,NA,NA,49,71,31,20,0,64,0,22,28,50,27,0,112,34,78,59,17,42,8,0.163265306122449,197,13.7055837563452
"4831",2013,"Alabama State",NA,NA,NA,70,96,54,27,0,85,1,39,13,52,44,0,111,36,75,83,20,63,21,0.3,271,16.2361623616236
"4832",2013,"Albany",NA,NA,NA,78,119,87,55,0,80,0,65,67,132,46,0,83,19,64,64,15,49,19,0.243589743589744,319,14.4200626959248
"4833",2013,"Alcorn State",NA,NA,NA,72,78,56,33,0,88,0,36,38,74,51,0,139,32,107,43,7,36,16,0.222222222222222,236,21.6101694915254
"4834",2013,"Appalachian State",NA,NA,NA,85,153,85,61,0,134,0,78,61,139,69,0,145,48,97,102,34,68,20,0.235294117647059,425,16.2352941176471
"4835",2013,"Arkansas",NA,NA,NA,433,741,423,260,0,484,2,297,184,481,281,0,819,276,543,493,142,351,102,0.235565819861432,2008,13.9940239043825
"4836",2013,"Arkansas State",NA,NA,NA,60,108,71,46,0,69,0,60,67,127,45,0,74,20,54,63,19,44,15,0.25,284,15.8450704225352
"4837",2013,"Arkansas-Pine Bluff",NA,NA,NA,63,102,73,41,0,73,0,36,41,77,37,0,83,22,61,52,19,33,11,0.174603174603175,261,14.176245210728
"4838",2013,"Army",NA,NA,NA,11,26,4,2,0,16,0,8,6,14,8,0,33,9,24,14,3,11,5,0.454545454545455,58,13.7931034482759
"4839",2013,"Auburn",NA,NA,NA,474,760,401,235,0,538,1,357,218,575,373,0,993,347,646,349,108,241,135,0.284810126582278,2152,17.3327137546468
"4840",2013,"Austin Peay",NA,NA,NA,65,100,41,26,0,88,0,41,36,77,40,0,136,38,98,101,31,70,21,0.323076923076923,287,13.9372822299652
"4841",2013,"BYU",NA,NA,NA,63,199,77,51,0,109,1,59,39,98,48,0,135,32,103,154,49,105,10,0.158730158730159,426,11.2676056338028
"4842",2013,"Ball State",NA,NA,NA,76,183,89,53,0,112,3,51,55,106,56,0,150,40,110,125,30,95,14,0.184210526315789,404,13.8613861386139
"4843",2013,"Baylor",NA,NA,NA,464,1059,545,334,10,407,1,516,231,747,334,0,1068,465,603,321,115,206,149,0.321120689655172,2796,11.9456366237482
"4844",2013,"Belmont",NA,NA,NA,69,208,78,53,0,136,1,55,58,113,38,0,195,69,126,130,36,94,18,0.260869565217391,456,8.33333333333333
"4845",2013,"Bethune-Cookman",NA,NA,NA,10,17,9,5,0,17,0,6,6,12,7,0,31,13,18,7,0,7,2,0.2,47,14.8936170212766
"4846",2013,"Binghamton",NA,NA,NA,61,165,76,43,0,101,0,52,74,126,42,0,152,41,111,87,26,61,8,0.131147540983607,368,11.4130434782609
"4847",2013,"Boise State",NA,NA,NA,16,52,15,10,0,29,0,11,7,18,10,0,51,16,35,35,11,24,6,0.375,110,9.09090909090909
"4848",2013,"Boston University",NA,NA,NA,87,200,73,41,0,105,0,49,55,104,54,0,186,62,124,152,51,101,21,0.241379310344828,469,11.5138592750533
"4849",2013,"Bowling Green",NA,NA,NA,142,333,153,103,0,159,2,115,99,214,97,0,181,52,129,224,69,155,30,0.211267605633803,748,12.9679144385027
"4850",2013,"Bradley",NA,NA,NA,109,174,88,60,0,110,0,77,86,163,64,0,160,44,116,119,33,86,23,0.211009174311927,466,13.7339055793991
"4851",2013,"Brown",NA,NA,NA,14,32,10,6,0,19,0,8,7,15,5,0,23,5,18,22,7,15,4,0.285714285714286,67,7.46268656716418
"4852",2013,"Bryant",NA,NA,NA,24,57,28,16,0,37,0,23,28,51,17,0,42,11,31,22,5,17,6,0.25,128,13.28125
"4853",2013,"Bucknell",NA,NA,NA,41,77,41,23,0,34,0,33,31,64,15,0,65,14,51,37,13,24,12,0.292682926829268,193,7.7720207253886
"4854",2013,"Buffalo",NA,NA,NA,97,197,110,70,0,136,2,96,80,176,71,0,128,37,91,151,44,107,23,0.237113402061856,500,14.2
"4855",2013,"Butler",NA,NA,NA,45,90,43,27,0,66,0,38,35,73,34,0,67,14,53,70,21,49,6,0.133333333333333,218,15.5963302752294
"4856",2013,"Cal Poly",NA,NA,NA,100,176,94,61,0,107,0,68,60,128,36,0,181,50,131,105,36,69,22,0.22,457,7.87746170678337
"4857",2013,"Cal State Bakersfield",NA,NA,NA,24,50,24,14,0,40,0,17,22,39,17,0,19,8,11,54,17,37,4,0.166666666666667,123,13.8211382113821
"4858",2013,"Cal State Fullerton",NA,NA,NA,97,144,78,51,0,95,0,37,52,89,56,0,160,50,110,100,21,79,16,0.164948453608247,373,15.0134048257373
"4859",2013,"Cal State Northridge",NA,NA,NA,83,206,82,52,0,134,0,90,95,185,88,0,131,33,98,140,44,96,20,0.240963855421687,475,18.5263157894737
"4860",2013,"California",NA,NA,NA,614,881,585,336,0,521,5,451,289,740,302,0,925,314,611,485,148,337,164,0.267100977198697,2577,11.7190531625922
"4861",2013,"Campbell",NA,NA,NA,70,94,58,34,0,75,1,66,58,124,74,0,112,33,79,82,28,54,15,0.214285714285714,308,24.025974025974
"4862",2013,"Canisius",NA,NA,NA,113,194,79,55,0,104,0,79,115,194,57,0,132,39,93,138,46,92,28,0.247787610619469,492,11.5853658536585
"4863",2013,"Central Arkansas",NA,NA,NA,11,25,14,10,0,19,0,7,12,19,5,0,16,6,10,11,6,5,2,0.181818181818182,61,8.19672131147541
"4864",2013,"Central Connecticut",NA,NA,NA,120,181,121,63,0,128,0,53,64,117,75,0,218,69,149,81,21,60,19,0.158333333333333,471,15.9235668789809
"4865",2013,"Central Michigan",NA,NA,NA,144,260,149,98,0,171,1,153,130,283,136,0,166,46,120,257,85,172,35,0.243055555555556,727,18.707015130674
"4866",2013,"Charleston",NA,NA,NA,107,152,58,33,0,126,0,51,76,127,41,0,210,68,142,132,34,98,29,0.271028037383178,428,9.57943925233645
"4867",2013,"Charleston Southern",NA,NA,NA,26,47,25,15,0,31,3,17,20,37,20,0,27,8,19,55,14,41,4,0.153846153846154,119,16.8067226890756
"4868",2013,"Charlotte",NA,NA,NA,171,240,113,73,0,139,1,176,97,273,77,0,238,67,171,111,24,87,51,0.298245614035088,716,10.7541899441341
"4869",2013,"Chattanooga",NA,NA,NA,160,292,133,80,0,177,1,117,97,214,112,0,258,105,153,264,82,182,47,0.29375,787,14.2312579415502
"4870",2013,"Chicago State",NA,NA,NA,56,83,63,39,0,73,0,29,25,54,37,0,126,35,91,44,7,37,11,0.196428571428571,220,16.8181818181818
"4871",2013,"Clemson",NA,NA,NA,319,602,320,195,0,420,4,298,303,601,227,0,573,165,408,251,68,183,74,0.231974921630094,1541,14.7306943543154
"4872",2013,"Cleveland State",NA,NA,NA,20,50,18,12,0,30,0,17,6,23,14,0,58,19,39,36,14,22,10,0.5,123,11.3821138211382
"4873",2013,"Coastal Carolina",NA,NA,NA,41,73,38,24,0,52,0,20,32,52,37,0,101,28,73,27,6,21,9,0.219512195121951,175,21.1428571428571
"4874",2013,"Colgate",NA,NA,NA,38,64,26,15,0,39,0,10,23,33,17,0,71,17,54,51,12,39,3,0.0789473684210526,149,11.4093959731544
"4875",2013,"Colorado",NA,NA,NA,461,769,384,243,0,468,1,314,302,616,271,0,709,238,471,385,119,266,104,0.225596529284165,2006,13.5094715852443
"4876",2013,"Colorado State",NA,NA,NA,27,109,48,39,0,55,0,40,32,72,43,0,88,25,63,79,27,52,6,0.222222222222222,241,17.8423236514523
"4877",2013,"Columbia",NA,NA,NA,38,68,24,13,0,40,0,16,33,49,25,0,66,14,52,45,12,33,1,0.0263157894736842,157,15.9235668789809
"4878",2013,"Coppin State",NA,NA,NA,80,94,63,37,0,88,1,40,43,83,42,0,135,23,112,69,24,45,7,0.0875,276,15.2173913043478
"4879",2013,"Cornell",NA,NA,NA,51,111,62,34,0,62,0,43,25,68,37,0,104,27,77,83,18,65,5,0.0980392156862745,267,13.8576779026217
"4880",2013,"Creighton",NA,NA,NA,120,313,96,65,0,178,0,96,51,147,87,0,226,76,150,304,106,198,32,0.266666666666667,738,11.7886178861789
"4881",2013,"Dartmouth",NA,NA,NA,42,93,37,25,0,56,0,33,28,61,22,0,87,22,65,58,21,37,10,0.238095238095238,219,10.0456621004566
"4882",2013,"Davidson",NA,NA,NA,122,280,111,73,0,154,0,119,94,213,102,0,224,83,141,171,50,121,31,0.254098360655738,688,14.8255813953488
"4883",2013,"DePaul",NA,NA,NA,462,786,358,222,0,462,0,369,261,630,245,0,638,224,414,726,216,510,128,0.277056277056277,2160,11.3425925925926
"4884",2013,"Delaware",NA,NA,NA,415,678,388,264,0,359,0,258,222,480,192,0,755,271,484,316,109,207,112,0.269879518072289,1845,10.4065040650407
"4885",2013,"Delaware State",NA,NA,NA,43,74,26,13,0,61,1,36,31,67,22,0,69,18,51,25,5,20,8,0.186046511627907,181,12.1546961325967
"4886",2013,"Denver",NA,NA,NA,78,170,96,61,0,106,0,73,60,133,46,0,164,51,113,106,32,74,19,0.243589743589744,426,10.7981220657277
"4887",2013,"Detroit Mercy",NA,NA,NA,105,229,125,84,0,141,2,99,85,184,51,0,124,49,75,187,65,122,31,0.295238095238095,586,8.70307167235495
"4888",2013,"Drake",NA,NA,NA,65,155,85,50,0,93,0,42,33,75,59,0,162,56,106,106,29,77,15,0.230769230769231,365,16.1643835616438
"4889",2013,"Drexel",NA,NA,NA,87,218,64,42,0,114,0,50,36,86,49,0,210,68,142,182,63,119,19,0.218390804597701,505,9.7029702970297
"4890",2013,"Duke",NA,NA,NA,514,916,404,277,0,484,1,447,294,741,392,0,889,314,575,460,185,275,148,0.287937743190661,2492,15.7303370786517
"4891",2013,"East Carolina",NA,NA,NA,57,92,36,24,0,77,0,45,32,77,49,0,106,37,69,79,20,59,11,0.192982456140351,261,18.7739463601533
"4892",2013,"East Tennessee State",NA,NA,NA,84,130,48,30,0,94,0,42,29,71,41,0,178,52,126,81,13,68,10,0.119047619047619,337,12.1661721068249
"4893",2013,"Eastern Illinois",NA,NA,NA,86,159,63,42,0,90,0,58,33,91,51,0,205,62,143,121,39,82,23,0.267441860465116,420,12.1428571428571
"4894",2013,"Eastern Kentucky",NA,NA,NA,73,174,64,40,0,125,1,54,55,109,48,0,138,41,97,117,28,89,16,0.219178082191781,392,12.2448979591837
"4895",2013,"Eastern Michigan",NA,NA,NA,131,199,79,42,0,138,0,99,107,206,96,0,215,61,154,119,29,90,27,0.206106870229008,539,17.8107606679035
"4896",2013,"Eastern Washington",NA,NA,NA,11,40,6,4,0,25,0,1,3,4,17,0,65,33,32,39,17,22,2,0.181818181818182,104,16.3461538461538
"4897",2013,"Elon",NA,NA,NA,113,229,92,59,0,163,2,91,70,161,80,0,239,89,150,131,42,89,29,0.256637168141593,586,13.6518771331058
"4898",2013,"Evansville",NA,NA,NA,50,112,58,41,0,73,1,42,42,84,30,0,86,30,56,84,25,59,9,0.18,278,10.7913669064748
"4899",2013,"Fairfield",NA,NA,NA,102,238,98,55,0,131,0,116,50,166,62,0,154,40,114,198,60,138,34,0.333333333333333,580,10.6896551724138
"4900",2013,"Fairleigh Dickinson",NA,NA,NA,27,39,21,12,0,43,1,14,21,35,12,0,43,7,36,29,10,19,5,0.185185185185185,101,11.8811881188119
"4901",2013,"Florida",NA,NA,NA,468,884,459,278,0,560,1,405,236,641,288,0,907,306,601,492,168,324,122,0.260683760683761,2365,12.1775898520085
"4902",2013,"Florida A&M",NA,NA,NA,31,46,17,10,0,35,0,16,8,24,20,0,67,22,45,48,14,34,5,0.161290322580645,135,14.8148148148148
"4903",2013,"Florida Atlantic",NA,NA,NA,72,97,41,26,0,118,2,57,43,100,69,0,147,35,112,115,31,84,15,0.208333333333333,303,22.7722772277228
"4904",2013,"Florida Gulf Coast",NA,NA,NA,84,209,105,76,0,169,0,126,92,218,105,0,26,6,20,267,82,185,17,0.202380952380952,536,19.589552238806
"4905",2013,"Florida International",NA,NA,NA,94,142,59,41,0,102,0,63,50,113,35,0,177,59,118,66,10,56,27,0.287234042553192,381,9.18635170603675
"4906",2013,"Florida State",NA,NA,NA,422,765,474,304,0,431,3,437,287,724,308,0,875,315,560,320,110,210,115,0.272511848341232,2173,14.1739530602853
"4907",2013,"Fordham",NA,NA,NA,102,226,82,59,0,108,0,68,72,140,63,0,192,71,121,170,45,125,20,0.196078431372549,537,11.731843575419
"4908",2013,"Fresno State",NA,NA,NA,125,167,72,52,0,107,0,94,87,181,88,0,154,41,113,200,67,133,26,0.208,513,17.1539961013645
"4909",2013,"Furman",NA,NA,NA,73,128,71,45,0,111,0,49,35,84,27,0,151,27,124,72,22,50,16,0.219178082191781,320,8.4375
"4910",2013,"Gardner-Webb",NA,NA,NA,53,76,54,28,0,51,0,34,50,84,21,0,42,11,31,49,18,31,14,0.264150943396226,205,10.2439024390244
"4911",2013,"George Mason",NA,NA,NA,78,110,57,38,0,80,0,25,41,66,38,0,159,45,114,45,13,32,18,0.230769230769231,285,13.3333333333333
"4912",2013,"Georgetown",NA,NA,NA,203,306,184,112,0,248,3,159,90,249,168,0,364,103,261,221,65,156,56,0.275862068965517,877,19.1562143671608
"4913",2013,"Georgia",NA,NA,NA,519,840,438,262,0,491,1,382,276,658,352,0,823,265,558,548,150,398,125,0.240847784200385,2279,15.4453707766564
"4914",2013,"Georgia Southern",NA,NA,NA,33,95,39,28,0,57,0,26,36,62,22,0,72,21,51,64,21,43,9,0.272727272727273,204,10.7843137254902
"4915",2013,"Georgia State",NA,NA,NA,82,134,71,43,0,105,0,63,65,128,52,0,151,47,104,79,19,60,18,0.219512195121951,365,14.2465753424658
"4916",2013,"Georgia Tech",NA,NA,NA,454,572,334,201,0,495,1,277,238,515,275,0,724,216,508,389,110,279,106,0.233480176211454,1721,15.979081929111
"4917",2013,"Gonzaga",NA,NA,NA,143,231,99,51,0,148,0,104,70,174,111,0,285,83,202,172,55,117,32,0.223776223776224,636,17.4528301886792
"4918",2013,"Grambling",NA,NA,NA,80,130,77,40,0,106,0,55,75,130,58,0,134,38,96,114,34,80,15,0.1875,356,16.2921348314607
"4919",2013,"Green Bay",NA,NA,NA,107,292,134,91,0,186,0,139,97,236,106,0,95,26,69,306,111,195,26,0.242990654205607,714,14.8459383753501
"4920",2013,"Hampton",NA,NA,NA,116,192,120,71,0,132,0,92,77,169,68,0,179,59,120,101,24,77,23,0.198275862068966,516,13.1782945736434
"4921",2013,"Hartford",NA,NA,NA,105,220,98,63,0,151,0,74,72,146,82,0,225,74,151,157,48,109,19,0.180952380952381,547,14.9908592321755
"4922",2013,"Harvard",NA,NA,NA,91,185,70,46,0,95,0,86,64,150,70,0,142,42,100,116,52,64,35,0.384615384615385,473,14.7991543340381
"4923",2013,"Hawai'i",NA,NA,NA,139,306,173,109,0,219,0,90,66,156,58,0,338,118,220,143,39,104,35,0.251798561151079,731,7.9343365253078
"4924",2013,"High Point",NA,NA,NA,54,108,49,26,0,68,0,47,36,83,40,0,90,31,59,57,22,35,16,0.296296296296296,274,14.5985401459854
"4925",2013,"Hofstra",NA,NA,NA,108,228,98,56,0,133,2,87,64,151,79,0,208,60,148,122,30,92,26,0.240740740740741,535,14.7663551401869
"4926",2013,"Holy Cross",NA,NA,NA,69,155,56,35,0,84,0,55,58,113,30,0,98,30,68,108,36,72,17,0.246376811594203,361,8.31024930747922
"4927",2013,"Houston",NA,NA,NA,94,132,90,47,0,100,0,70,57,127,63,0,119,33,86,90,19,71,23,0.24468085106383,371,16.9811320754717
"4928",2013,"Houston Christian",NA,NA,NA,19,49,28,15,0,30,0,32,17,49,24,0,34,6,28,18,4,14,4,0.210526315789474,116,20.6896551724138
"4929",2013,"Howard",NA,NA,NA,93,133,82,49,0,97,0,34,51,85,47,0,144,42,102,98,31,67,19,0.204301075268817,353,13.314447592068
"4930",2013,"Huston-Tillotson",NA,NA,NA,13,26,11,5,0,15,0,11,10,21,8,0,20,6,14,19,6,13,2,0.153846153846154,66,12.1212121212121
"4931",2013,"IUPUI",NA,NA,NA,64,73,60,34,0,67,0,38,48,86,33,0,75,33,42,67,13,54,17,0.265625,237,13.9240506329114
"4932",2013,"Idaho",NA,NA,NA,90,234,90,55,0,133,0,63,66,129,36,0,147,50,97,195,59,136,22,0.244444444444444,519,6.9364161849711
"4933",2013,"Idaho State",NA,NA,NA,69,148,82,55,0,116,1,47,48,95,41,0,131,34,97,89,34,55,14,0.202898550724638,350,11.7142857142857
"4934",2013,"Illinois",NA,NA,NA,219,437,292,191,0,341,2,188,102,290,276,0,545,183,362,365,108,257,62,0.28310502283105,1214,22.7347611202636
"4935",2013,"Illinois State",NA,NA,NA,143,334,123,77,0,166,0,95,53,148,96,0,398,138,260,169,45,124,41,0.286713286713287,783,12.2605363984674
"4936",2013,"Indiana",NA,NA,NA,305,633,224,139,0,398,3,215,205,420,149,0,607,184,423,429,141,288,73,0.239344262295082,1529,9.74493132766514
"4937",2013,"Indiana State",NA,NA,NA,78,153,83,54,0,116,1,47,32,79,45,0,208,67,141,68,18,50,19,0.243589743589744,391,11.5089514066496
"4938",2013,"Iona",NA,NA,NA,115,265,113,69,0,149,0,87,94,181,67,0,229,78,151,158,57,101,29,0.252173913043478,636,10.5345911949686
"4939",2013,"Iowa",NA,NA,NA,372,822,347,236,0,500,1,328,120,448,238,0,822,250,572,539,178,361,87,0.233870967741935,2037,11.6838487972509
"4940",2013,"Iowa State",NA,NA,NA,300,818,314,238,0,406,4,202,66,268,169,0,587,230,357,650,219,431,72,0.24,1860,9.08602150537634
"4941",2013,"Jackson State",NA,NA,NA,33,40,30,16,0,37,0,14,9,23,10,0,76,14,62,26,11,15,8,0.242424242424242,116,8.62068965517241
"4942",2013,"Jacksonville",NA,NA,NA,103,170,74,51,0,97,0,70,90,160,44,0,186,54,132,87,25,62,28,0.271844660194175,448,9.82142857142857
"4943",2013,"Jacksonville State",NA,NA,NA,44,82,46,27,0,70,1,27,24,51,22,0,89,28,61,38,11,27,11,0.25,202,10.8910891089109
"4944",2013,"James Madison",NA,NA,NA,179,249,126,82,0,173,0,68,85,153,67,0,345,110,235,169,51,118,41,0.229050279329609,696,9.6264367816092
"4945",2013,"Kansas",NA,NA,NA,423,853,433,279,0,524,0,436,241,677,261,0,795,269,526,512,164,348,110,0.260047281323877,2267,11.5130127922364
"4946",2013,"Kansas City",NA,NA,NA,40,81,39,29,0,70,0,17,20,37,22,0,120,42,78,43,15,28,12,0.3,205,10.7317073170732
"4947",2013,"Kennesaw State",NA,NA,NA,71,83,50,31,0,46,0,33,56,89,29,0,83,20,63,66,14,52,13,0.183098591549296,232,12.5
"4948",2013,"Kent State",NA,NA,NA,21,52,21,15,0,36,0,18,30,48,13,0,31,8,23,27,6,21,1,0.0476190476190476,111,11.7117117117117
"4949",2013,"Kentucky",NA,NA,NA,549,775,454,289,0,601,3,351,214,565,405,0,886,297,589,693,225,468,99,0.180327868852459,2326,17.4118658641445
"4950",2013,"LIU Brooklyn",NA,NA,NA,89,144,71,41,0,87,1,55,66,121,40,0,147,44,103,59,14,45,22,0.247191011235955,364,10.989010989011
"4951",2013,"LSU",NA,NA,NA,396,749,425,273,0,458,2,338,182,520,247,0,864,305,559,313,93,220,104,0.262626262626263,2002,12.3376623376623
"4952",2013,"La Salle",NA,NA,NA,101,160,83,55,0,114,3,42,48,90,65,0,242,75,167,82,19,63,26,0.257425742574257,413,15.7384987893462
"4953",2013,"Lafayette",NA,NA,NA,56,113,43,25,0,63,0,32,30,62,31,0,128,37,91,76,25,51,15,0.267857142857143,278,11.1510791366906
"4954",2013,"Lamar",NA,NA,NA,39,120,71,45,0,96,0,58,33,91,44,0,81,22,59,100,30,70,12,0.307692307692308,284,15.4929577464789
"4955",2013,"Lehigh",NA,NA,NA,36,111,44,27,0,63,0,35,32,67,21,0,78,25,53,64,14,50,9,0.25,234,8.97435897435897
"4956",2013,"Liberty",NA,NA,NA,114,214,129,80,0,141,0,101,76,177,78,0,123,37,86,121,39,82,24,0.210526315789474,543,14.3646408839779
"4957",2013,"Lipscomb",NA,NA,NA,73,214,82,49,0,129,0,50,42,92,37,0,156,52,104,165,43,122,14,0.191780821917808,445,8.31460674157303
"4958",2013,"Little Rock",NA,NA,NA,87,148,79,48,0,119,2,65,44,109,49,0,190,54,136,63,22,41,17,0.195402298850575,400,12.25
"4959",2013,"Long Beach State",NA,NA,NA,50,93,39,19,0,62,0,31,43,74,33,0,88,27,61,72,16,56,12,0.24,227,14.5374449339207
"4960",2013,"Longwood",NA,NA,NA,110,232,135,84,0,200,3,83,96,179,86,0,181,53,128,226,73,153,29,0.263636363636364,585,14.7008547008547
"4961",2013,"Louisiana",NA,NA,NA,26,42,21,15,0,40,0,15,18,33,7,0,35,9,26,48,17,31,6,0.230769230769231,118,5.93220338983051
"4962",2013,"Louisiana Tech",NA,NA,NA,89,214,128,73,0,148,0,78,80,158,48,0,183,59,124,85,21,64,20,0.224719101123595,482,9.95850622406639
"4963",2013,"Louisville",NA,NA,NA,486,801,483,312,0,540,4,448,258,706,407,0,733,261,472,642,202,440,129,0.265432098765432,2341,17.385732592909
"4964",2013,"Loyola (LA)",NA,NA,NA,11,18,8,4,0,11,0,6,7,13,6,0,21,7,14,13,3,10,2,0.181818181818182,46,13.0434782608696
"4965",2013,"Loyola Chicago",NA,NA,NA,78,196,91,60,0,101,0,80,64,144,68,0,168,57,111,136,34,102,14,0.17948717948718,474,14.3459915611814
"4966",2013,"Loyola Maryland",NA,NA,NA,94,200,89,54,0,129,0,71,77,148,83,0,149,38,111,182,52,130,19,0.202127659574468,473,17.5475687103594
"4967",2013,"Loyola Marymount",NA,NA,NA,108,163,90,59,0,146,0,64,65,129,73,0,252,92,160,95,22,73,27,0.25,469,15.5650319829424
"4968",2013,"Maine",NA,NA,NA,50,125,42,26,0,85,0,26,24,50,37,0,132,48,84,95,26,69,8,0.16,285,12.9824561403509
"4969",2013,"Manhattan",NA,NA,NA,48,127,46,29,0,87,0,52,56,108,47,0,114,33,81,77,20,57,5,0.104166666666667,294,15.9863945578231
"4970",2013,"Marist",NA,NA,NA,106,235,111,77,0,139,0,101,86,187,86,0,147,45,102,248,81,167,26,0.245283018867925,604,14.2384105960265
"4971",2013,"Marquette",NA,NA,NA,352,556,313,198,0,380,1,233,188,421,148,0,509,169,340,324,97,227,73,0.207386363636364,1504,9.84042553191489
"4972",2013,"Marshall",NA,NA,NA,37,77,36,18,0,52,0,34,32,66,19,0,48,12,36,44,14,30,11,0.297297297297297,184,10.3260869565217
"4973",2013,"Maryland",NA,NA,NA,377,694,301,196,0,393,1,335,197,532,166,0,647,233,414,323,113,210,118,0.312997347480106,1846,8.99241603466956
"4974",2013,"Maryland-Eastern Shore",NA,NA,NA,17,32,11,7,0,26,0,9,20,29,5,0,10,2,8,17,4,13,4,0.235294117647059,65,7.69230769230769
"4975",2013,"McNeese",NA,NA,NA,112,218,115,76,0,164,3,79,60,139,57,0,233,87,146,178,63,115,27,0.241071428571429,593,9.61214165261383
"4976",2013,"Memphis",NA,NA,NA,99,177,96,62,0,133,0,71,40,111,68,0,213,75,138,115,35,80,28,0.282828282828283,483,14.0786749482402
"4977",2013,"Mercer",NA,NA,NA,104,169,52,35,0,102,0,54,51,105,41,0,253,83,170,82,17,65,34,0.326923076923077,444,9.23423423423423
"4978",2013,"Miami",NA,NA,NA,481,818,443,280,0,517,0,380,303,683,276,0,665,191,474,453,127,326,112,0.232848232848233,2112,13.0681818181818
"4979",2013,"Miami (OH)",NA,NA,NA,85,165,69,47,0,83,1,54,31,85,43,0,146,50,96,104,35,69,19,0.223529411764706,406,10.5911330049261
"4980",2013,"Michigan",NA,NA,NA,317,758,284,189,0,334,0,209,135,344,194,0,704,302,402,548,193,355,84,0.264984227129338,1845,10.5149051490515
"4981",2013,"Michigan State",NA,NA,NA,414,823,318,196,0,431,2,358,334,692,227,0,598,208,390,517,163,354,97,0.234299516908213,2044,11.105675146771
"4982",2013,"Middle Tennessee",NA,NA,NA,128,239,154,99,0,120,1,95,61,156,60,0,175,46,129,126,39,87,25,0.1953125,577,10.3986135181976
"4983",2013,"Milwaukee",NA,NA,NA,73,120,38,25,0,80,0,47,49,96,22,0,104,28,76,120,37,83,17,0.232876712328767,315,6.98412698412698
"4984",2013,"Mississippi State",NA,NA,NA,348,657,348,217,0,522,2,206,146,352,199,0,844,252,592,278,85,193,82,0.235632183908046,1642,12.1193666260658
"4985",2013,"Mississippi Valley State",NA,NA,NA,44,90,41,27,0,65,0,35,43,78,41,0,98,20,78,70,27,43,7,0.159090909090909,224,18.3035714285714
"4986",2013,"Missouri",NA,NA,NA,321,847,324,203,0,515,1,333,223,556,200,0,452,146,306,731,245,486,80,0.249221183800623,1986,10.0704934541793
"4987",2013,"Missouri State",NA,NA,NA,104,130,91,49,0,124,0,64,44,108,56,0,174,52,122,108,28,80,20,0.192307692307692,403,13.8957816377171
"4988",2013,"Monmouth",NA,NA,NA,88,163,71,44,0,105,0,48,69,117,42,0,128,34,94,98,31,67,19,0.215909090909091,377,11.1405835543767
"4989",2013,"Montana",NA,NA,NA,89,144,52,38,0,69,0,9,8,17,50,0,213,76,137,87,33,54,21,0.235955056179775,367,13.6239782016349
"4990",2013,"Montana State",NA,NA,NA,25,49,21,11,0,28,0,9,3,12,17,0,70,33,37,31,6,25,5,0.2,128,13.28125
"4991",2013,"Morehead State",NA,NA,NA,27,79,24,18,0,56,0,34,16,50,21,0,50,12,38,94,36,58,9,0.333333333333333,194,10.8247422680412
"4992",2013,"Morgan State",NA,NA,NA,41,105,54,34,0,80,0,29,33,62,30,0,88,19,69,86,28,58,9,0.219512195121951,233,12.8755364806867
"4993",2013,"Mount St. Mary's",NA,NA,NA,56,142,56,36,0,101,1,47,69,116,45,0,103,41,62,107,42,65,15,0.267857142857143,344,13.0813953488372
"4994",2013,"Murray State",NA,NA,NA,98,238,143,92,0,139,0,62,59,121,73,0,184,54,130,181,45,136,11,0.112244897959184,539,13.543599257885
"4995",2013,"NC State",NA,NA,NA,412,709,339,209,0,462,2,300,262,562,234,0,628,220,408,459,164,295,116,0.281553398058252,1895,12.3482849604222
"4996",2013,"NJIT",NA,NA,NA,48,146,47,26,0,100,2,37,38,75,38,0,156,48,108,72,19,53,7,0.145833333333333,304,12.5
"4997",2013,"Navy",NA,NA,NA,78,166,60,29,0,88,0,55,37,92,46,0,138,51,87,163,50,113,17,0.217948717948718,414,11.1111111111111
"4998",2013,"Nebraska",NA,NA,NA,406,843,352,240,0,387,0,297,159,456,228,0,793,260,533,620,197,423,97,0.238916256157635,2100,10.8571428571429
"4999",2013,"Nevada",NA,NA,NA,94,166,98,54,0,81,1,58,43,101,68,0,176,51,125,76,19,57,19,0.202127659574468,410,16.5853658536585
"5000",2013,"New Hampshire",NA,NA,NA,27,78,25,17,0,54,0,29,17,46,14,0,66,18,48,42,15,27,6,0.222222222222222,174,8.04597701149425
"5001",2013,"New Mexico",NA,NA,NA,99,158,79,50,0,109,0,67,62,129,62,0,179,43,136,84,23,61,28,0.282828282828283,412,15.0485436893204
"5002",2013,"New Mexico State",NA,NA,NA,64,120,43,32,0,60,0,25,32,57,19,0,92,23,69,100,28,72,13,0.203125,270,7.03703703703704
"5003",2013,"New Orleans",NA,NA,NA,21,27,18,11,0,23,0,15,17,32,20,0,39,10,29,34,10,24,4,0.19047619047619,88,22.7272727272727
"5004",2013,"Newman",NA,NA,NA,11,14,15,8,0,15,0,7,6,13,11,0,28,8,20,16,8,8,3,0.272727272727273,51,21.5686274509804
"5005",2013,"Niagara",NA,NA,NA,92,165,58,40,0,102,0,37,62,99,48,0,191,68,123,89,25,64,26,0.282608695652174,398,12.0603015075377
"5006",2013,"Nicholls",NA,NA,NA,40,64,24,15,0,49,0,21,10,31,22,0,87,34,53,60,21,39,10,0.25,189,11.6402116402116
"5007",2013,"Norfolk State",NA,NA,NA,62,84,42,22,0,76,0,30,34,64,22,0,103,28,75,33,3,30,11,0.17741935483871,214,10.2803738317757
"5008",2013,"North Carolina",NA,NA,NA,541,880,606,350,0,628,8,195,147,342,436,0,1182,449,733,486,144,342,127,0.234750462107209,2351,18.5452998723947
"5009",2013,"North Carolina A&T",NA,NA,NA,38,89,45,26,0,57,0,31,44,75,39,0,65,21,44,58,22,36,7,0.184210526315789,211,18.4834123222749
"5010",2013,"North Carolina Central",NA,NA,NA,38,74,37,22,0,35,0,10,13,23,19,0,95,19,76,16,4,12,8,0.210526315789474,155,12.258064516129
"5011",2013,"North Dakota",NA,NA,NA,51,120,77,46,0,80,1,27,16,43,48,0,156,45,111,73,20,53,10,0.196078431372549,287,16.7247386759582
"5012",2013,"North Dakota State",NA,NA,NA,30,45,7,6,0,27,0,18,22,40,7,0,45,15,30,39,11,28,9,0.3,119,5.88235294117647
"5013",2013,"North Florida",NA,NA,NA,91,189,94,55,0,110,0,49,68,117,56,0,152,41,111,137,32,105,19,0.208791208791209,426,13.1455399061033
"5014",2013,"North Texas",NA,NA,NA,35,78,41,27,0,65,2,31,33,64,28,0,47,12,35,65,25,40,12,0.342857142857143,192,14.5833333333333
"5015",2013,"Northeastern",NA,NA,NA,49,85,33,24,0,69,2,33,36,69,35,0,78,19,59,85,26,59,8,0.163265306122449,222,15.7657657657658
"5016",2013,"Northern Arizona",NA,NA,NA,18,53,10,8,0,32,0,24,11,35,13,0,41,18,23,35,6,29,4,0.222222222222222,123,10.5691056910569
"5017",2013,"Northern Colorado",NA,NA,NA,44,91,55,39,0,83,0,25,24,49,34,0,98,34,64,62,17,45,8,0.181818181818182,220,15.4545454545455
"5018",2013,"Northern Illinois",NA,NA,NA,63,126,55,29,0,95,0,30,36,66,34,0,138,38,100,67,18,49,12,0.19047619047619,285,11.9298245614035
"5019",2013,"Northern Iowa",NA,NA,NA,109,273,111,75,0,185,1,62,43,105,41,0,219,60,159,270,81,189,23,0.211009174311927,617,6.645056726094
"5020",2013,"Northern Kentucky",NA,NA,NA,43,120,40,25,0,46,0,46,55,101,32,0,59,23,36,82,32,50,12,0.27906976744186,272,11.7647058823529
"5021",2013,"Northwestern",NA,NA,NA,221,584,249,163,0,365,3,206,197,403,169,0,459,161,298,332,96,236,49,0.221719457013575,1333,12.6781695423856
"5022",2013,"Northwestern State",NA,NA,NA,72,140,65,39,0,130,1,57,52,109,32,0,155,49,106,94,28,66,22,0.305555555555556,363,8.81542699724518
"5023",2013,"Oakland",NA,NA,NA,30,72,26,16,0,41,0,25,42,67,25,0,74,17,57,75,20,55,8,0.266666666666667,170,14.7058823529412
"5024",2013,"Oakwood",NA,NA,NA,10,12,13,6,0,17,0,3,4,7,2,0,14,4,10,16,3,13,2,0.2,34,5.88235294117647
"5025",2013,"Ohio",NA,NA,NA,62,100,63,38,0,71,0,24,26,50,33,0,148,48,100,88,22,66,9,0.145161290322581,268,12.3134328358209
"5026",2013,"Oklahoma",NA,NA,NA,382,914,468,311,0,516,1,350,278,628,188,0,592,199,393,686,251,435,101,0.264397905759162,2231,8.42671447781264
"5027",2013,"Oklahoma State",NA,NA,NA,410,700,301,209,0,391,1,331,189,520,274,0,839,300,539,357,119,238,127,0.309756097560976,1950,14.0512820512821
"5028",2013,"Old Dominion",NA,NA,NA,61,112,66,45,0,83,1,49,45,94,43,0,112,32,80,76,28,48,19,0.311475409836066,305,14.0983606557377
"5029",2013,"Ole Miss",NA,NA,NA,420,625,380,242,0,455,1,274,271,545,220,0,675,196,479,452,125,327,88,0.20952380952381,1734,12.6874279123414
"5030",2013,"Omaha",NA,NA,NA,21,42,17,11,0,27,0,9,19,28,17,0,50,21,29,27,9,18,7,0.333333333333333,107,15.8878504672897
"5031",2013,"Oral Roberts",NA,NA,NA,94,168,106,67,0,124,0,73,49,122,56,0,233,82,151,126,40,86,23,0.24468085106383,494,11.336032388664
"5032",2013,"Oregon State",NA,NA,NA,278,674,214,125,0,406,3,223,237,460,131,0,429,149,280,434,136,298,66,0.237410071942446,1519,8.62409479921001
"5033",2013,"Pacific",NA,NA,NA,86,148,100,56,0,149,2,73,71,144,61,0,157,42,115,119,37,82,23,0.267441860465116,417,14.6282973621103
"5034",2013,"Penn State",NA,NA,NA,370,662,348,228,0,471,0,269,256,525,277,0,742,274,468,310,125,185,104,0.281081081081081,1800,15.3888888888889
"5035",2013,"Pennsylvania",NA,NA,NA,101,202,129,80,0,136,1,87,91,178,65,0,144,43,101,161,46,115,13,0.128712871287129,511,12.720156555773
"5036",2013,"Pepperdine",NA,NA,NA,54,138,63,39,0,107,0,47,38,85,42,0,167,50,117,85,24,61,18,0.333333333333333,330,12.7272727272727
"5037",2013,"Portland",NA,NA,NA,98,182,90,54,0,123,0,64,79,143,81,0,139,49,90,162,41,121,20,0.204081632653061,456,17.7631578947368
"5038",2013,"Prairie View A&M",NA,NA,NA,41,73,40,22,0,76,0,21,22,43,33,0,125,42,83,53,20,33,6,0.146341463414634,208,15.8653846153846
"5039",2013,"Presbyterian",NA,NA,NA,50,166,71,42,0,97,1,54,60,114,50,0,114,35,79,88,32,56,8,0.16,351,14.2450142450142
"5040",2013,"Princeton",NA,NA,NA,117,218,94,52,0,133,0,101,89,190,67,0,166,54,112,119,39,80,30,0.256410256410256,562,11.9217081850534
"5041",2013,"Purdue",NA,NA,NA,367,779,387,270,0,447,3,338,270,608,242,0,592,203,389,456,165,291,83,0.226158038147139,1964,12.3217922606925
"5042",2013,"Purdue Fort Wayne",NA,NA,NA,75,151,99,72,0,126,0,73,64,137,62,0,96,30,66,179,53,126,11,0.146666666666667,412,15.0485436893204
"5043",2013,"Quinnipiac",NA,NA,NA,108,182,87,54,0,115,2,85,91,176,91,0,144,37,107,144,44,100,19,0.175925925925926,481,18.9189189189189
"5044",2013,"Radford",NA,NA,NA,132,163,81,51,0,123,0,66,83,149,66,0,184,47,137,105,23,82,27,0.204545454545455,454,14.5374449339207
"5045",2013,"Rhode Island",NA,NA,NA,70,139,59,34,0,101,0,50,68,118,22,0,135,32,103,49,20,29,12,0.171428571428571,320,6.875
"5046",2013,"Rice",NA,NA,NA,86,135,71,45,0,83,0,37,33,70,26,0,206,62,144,60,13,47,19,0.22093023255814,351,7.40740740740741
"5047",2013,"Richmond",NA,NA,NA,121,253,118,73,0,172,0,101,116,217,95,0,201,56,145,170,57,113,18,0.148760330578512,620,15.3225806451613
"5048",2013,"Rider",NA,NA,NA,100,169,108,76,0,121,0,76,76,152,67,0,136,34,102,100,29,71,21,0.21,436,15.3669724770642
"5049",2013,"Robert Morris",NA,NA,NA,69,120,59,34,0,73,0,33,34,67,30,0,130,29,101,75,25,50,14,0.202898550724638,293,10.2389078498294
"5050",2013,"Rutgers",NA,NA,NA,341,568,312,179,0,444,1,284,230,514,262,0,541,167,374,249,64,185,75,0.219941348973607,1511,17.3395102581072
"5051",2013,"SE Louisiana",NA,NA,NA,21,40,46,27,0,46,0,25,19,44,13,0,42,14,28,21,3,18,5,0.238095238095238,113,11.5044247787611
"5052",2013,"SIU Edwardsville",NA,NA,NA,93,100,82,47,0,93,2,53,56,109,49,0,133,34,99,62,18,44,20,0.21505376344086,318,15.4088050314465
"5053",2013,"SMU",NA,NA,NA,40,61,25,16,0,52,1,33,37,70,37,0,62,15,47,59,30,29,12,0.3,184,20.1086956521739
"5054",2013,"Sacramento State",NA,NA,NA,21,59,22,14,0,25,0,7,3,10,23,0,71,18,53,54,22,32,3,0.142857142857143,135,17.037037037037
"5055",2013,"Sacred Heart",NA,NA,NA,58,125,44,34,0,69,0,43,56,99,57,0,103,40,63,93,22,71,12,0.206896551724138,299,19.0635451505017
"5056",2013,"Saint Joseph's",NA,NA,NA,132,240,112,74,0,170,0,109,96,205,58,0,236,68,168,145,39,106,31,0.234848484848485,621,9.33977455716586
"5057",2013,"Saint Louis",NA,NA,NA,71,138,59,33,0,95,0,57,64,121,30,0,127,37,90,81,18,63,17,0.23943661971831,339,8.84955752212389
"5058",2013,"Saint Mary's",NA,NA,NA,111,252,162,106,0,136,1,70,73,143,43,0,207,69,138,107,30,77,20,0.18018018018018,573,7.5043630017452
"5059",2013,"Saint Peter's",NA,NA,NA,45,74,18,12,0,49,0,18,35,53,34,0,70,20,50,69,17,52,6,0.133333333333333,179,18.9944134078212
"5060",2013,"Sam Houston",NA,NA,NA,77,137,61,41,0,86,0,42,76,118,41,0,94,33,61,85,22,63,11,0.142857142857143,322,12.7329192546584
"5061",2013,"Samford",NA,NA,NA,50,255,69,48,0,145,1,73,79,152,46,0,141,40,101,207,75,132,9,0.18,506,9.09090909090909
"5062",2013,"San Diego",NA,NA,NA,134,180,114,65,0,110,1,98,92,190,67,0,229,77,152,53,15,38,42,0.313432835820896,529,12.6654064272212
"5063",2013,"San Diego State",NA,NA,NA,178,283,121,78,0,180,0,133,94,227,77,0,279,83,196,200,64,136,44,0.247191011235955,777,9.90990990990991
"5064",2013,"San Francisco",NA,NA,NA,26,49,24,13,0,28,0,12,18,30,16,0,43,11,32,44,18,26,6,0.230769230769231,121,13.2231404958678
"5065",2013,"San José State",NA,NA,NA,32,63,36,25,0,35,1,35,36,71,21,0,24,6,18,34,11,23,6,0.1875,160,13.125
"5066",2013,"Santa Clara",NA,NA,NA,40,94,39,25,0,67,2,32,43,75,29,0,89,27,62,56,22,34,4,0.1,226,12.8318584070796
"5067",2013,"Savannah State",NA,NA,NA,37,67,56,33,0,69,1,21,20,41,32,0,118,37,81,38,11,27,8,0.216216216216216,188,17.0212765957447
"5068",2013,"Seattle U",NA,NA,NA,64,126,62,36,0,63,0,62,58,120,48,0,74,26,48,57,20,37,15,0.234375,312,15.3846153846154
"5069",2013,"Seton Hall",NA,NA,NA,367,628,269,170,0,515,4,257,303,560,236,0,570,161,409,437,133,304,83,0.226158038147139,1623,14.5409735058534
"5070",2013,"Siena",NA,NA,NA,112,171,115,77,0,132,0,71,112,183,67,0,121,37,84,110,32,78,23,0.205357142857143,453,14.7902869757174
"5071",2013,"South Alabama",NA,NA,NA,52,105,51,29,0,59,0,36,44,80,23,0,46,9,37,89,23,66,17,0.326923076923077,241,9.54356846473029
"5072",2013,"South Carolina",NA,NA,NA,573,816,606,322,0,464,2,332,206,538,288,0,870,274,596,442,112,330,135,0.235602094240838,2249,12.8056914184082
"5073",2013,"South Carolina State",NA,NA,NA,61,90,50,33,0,87,2,36,45,81,39,0,87,27,60,50,13,37,13,0.213114754098361,242,16.1157024793388
"5074",2013,"South Carolina Upstate",NA,NA,NA,69,174,67,45,0,121,2,61,67,128,52,0,147,55,92,99,27,72,12,0.173913043478261,404,12.8712871287129
"5075",2013,"South Dakota",NA,NA,NA,82,179,94,66,0,119,1,69,57,126,48,0,151,52,99,113,37,76,17,0.207317073170732,448,10.7142857142857
"5076",2013,"South Dakota State",NA,NA,NA,94,226,105,74,0,140,0,92,76,168,76,0,168,55,113,148,43,105,26,0.276595744680851,541,14.0480591497227
"5077",2013,"South Florida",NA,NA,NA,500,828,426,261,0,558,3,277,312,589,297,0,783,259,524,597,197,400,119,0.238,2169,13.6929460580913
"5078",2013,"Southeast Missouri State",NA,NA,NA,28,52,22,12,0,30,0,14,21,35,13,0,48,11,37,35,14,21,8,0.285714285714286,125,10.4
"5079",2013,"Southern",NA,NA,NA,48,76,36,18,0,78,0,19,28,47,29,0,135,47,88,50,17,33,6,0.125,214,13.5514018691589
"5080",2013,"Southern Illinois",NA,NA,NA,46,72,27,17,0,52,0,14,12,26,19,0,110,31,79,59,18,41,6,0.130434782608696,183,10.3825136612022
"5081",2013,"Southern Miss",NA,NA,NA,40,42,28,15,0,32,0,17,8,25,16,0,94,33,61,22,5,17,8,0.2,143,11.1888111888112
"5082",2013,"Southern Utah",NA,NA,NA,14,21,14,8,0,20,0,21,13,34,7,0,20,6,14,12,2,10,8,0.571428571428571,67,10.4477611940298
"5083",2013,"St. Bonaventure",NA,NA,NA,49,140,78,42,0,105,0,50,53,103,32,0,108,23,85,88,32,56,13,0.26530612244898,310,10.3225806451613
"5084",2013,"St. Francis (PA)",NA,NA,NA,86,193,87,52,0,152,0,55,56,111,61,0,174,62,112,173,45,128,19,0.22093023255814,459,13.2897603485839
"5085",2013,"St. Francis Brooklyn",NA,NA,NA,17,55,16,11,0,13,0,14,13,27,6,0,27,6,21,32,12,20,2,0.117647058823529,108,5.55555555555556
"5086",2013,"St. Martins",NA,NA,NA,13,20,11,7,0,14,0,3,7,10,3,0,26,4,22,19,4,15,0,0,47,6.38297872340426
"5087",2013,"Stanford",NA,NA,NA,445,1033,396,260,0,454,1,419,229,648,208,0,828,322,506,580,184,396,142,0.319101123595506,2505,8.30339321357286
"5088",2013,"Stephen F. Austin",NA,NA,NA,37,63,44,27,0,56,1,22,34,56,12,0,53,18,35,47,16,31,12,0.324324324324324,165,7.27272727272727
"5089",2013,"Stetson",NA,NA,NA,74,178,68,45,0,114,0,63,55,118,57,0,152,49,103,150,43,107,22,0.297297297297297,431,13.2250580046404
"5090",2013,"Stony Brook",NA,NA,NA,53,96,37,23,0,58,0,43,63,106,33,0,77,18,59,48,16,32,10,0.188679245283019,235,14.0425531914894
"5091",2013,"TCU",NA,NA,NA,351,604,295,185,0,383,1,200,253,453,221,0,509,149,360,600,192,408,80,0.227920227920228,1580,13.9873417721519
"5092",2013,"Temple",NA,NA,NA,133,275,88,54,0,145,1,76,80,156,71,0,237,69,168,155,47,108,24,0.180451127819549,622,11.4147909967846
"5093",2013,"Tennessee",NA,NA,NA,482,943,455,314,0,487,2,418,221,639,299,0,974,349,625,479,168,311,127,0.263485477178423,2495,11.9839679358717
"5094",2013,"Tennessee State",NA,NA,NA,46,54,44,26,0,65,0,22,30,52,28,0,66,19,47,52,17,35,7,0.152173913043478,169,16.5680473372781
"5095",2013,"Tennessee Tech",NA,NA,NA,46,82,40,28,0,69,1,31,26,57,25,0,110,45,65,77,25,52,15,0.326086956521739,239,10.4602510460251
"5096",2013,"Texas",NA,NA,NA,420,690,330,194,0,434,2,275,198,473,187,0,696,220,476,330,93,237,96,0.228571428571429,1784,10.4820627802691
"5097",2013,"Texas A&M",NA,NA,NA,459,921,411,259,0,495,4,484,289,773,307,0,1015,364,651,324,114,210,130,0.28322440087146,2466,12.4493106244931
"5098",2013,"Texas A&M-Corpus Christi",NA,NA,NA,61,91,46,26,0,85,0,29,38,67,49,0,102,23,79,109,26,83,9,0.147540983606557,242,20.2479338842975
"5099",2013,"Texas Southern",NA,NA,NA,59,117,71,43,0,75,0,52,44,96,38,0,81,22,59,67,18,49,11,0.186440677966102,286,13.2867132867133
"5100",2013,"Texas State",NA,NA,NA,23,46,16,9,0,29,0,21,23,44,12,0,38,9,29,40,14,26,1,0.0434782608695652,115,10.4347826086957
"5101",2013,"Texas Tech",NA,NA,NA,172,269,192,123,0,234,0,129,104,233,133,0,298,89,209,196,60,136,39,0.226744186046512,761,17.4770039421813
"5102",2013,"Toledo",NA,NA,NA,113,213,60,36,0,130,0,108,98,206,72,0,151,52,99,137,36,101,26,0.230088495575221,535,13.4579439252336
"5103",2013,"Towson",NA,NA,NA,51,73,31,19,0,41,1,19,23,42,21,0,80,24,56,42,10,32,11,0.215686274509804,184,11.4130434782609
"5104",2013,"Troy",NA,NA,NA,87,173,79,53,0,120,1,66,76,142,55,0,122,43,79,121,27,94,16,0.183908045977011,413,13.317191283293
"5105",2013,"Tulane",NA,NA,NA,118,216,115,73,0,129,0,90,76,166,82,0,187,59,128,111,33,78,27,0.228813559322034,545,15.045871559633
"5106",2013,"Tulsa",NA,NA,NA,33,75,33,21,0,51,1,28,18,46,23,0,74,26,48,53,12,41,8,0.242424242424242,184,12.5
"5107",2013,"UAB",NA,NA,NA,33,91,35,22,0,64,0,38,28,66,32,0,87,25,62,73,25,48,7,0.212121212121212,223,14.3497757847534
"5108",2013,"UC Davis",NA,NA,NA,54,130,53,36,0,104,0,55,67,122,45,0,67,15,52,142,44,98,15,0.277777777777778,314,14.3312101910828
"5109",2013,"UC Irvine",NA,NA,NA,38,67,32,18,0,35,0,18,15,33,28,0,79,15,64,57,15,42,6,0.157894736842105,158,17.7215189873418
"5110",2013,"UC Riverside",NA,NA,NA,44,101,46,30,0,72,1,36,33,69,36,0,114,39,75,48,9,39,11,0.25,241,14.9377593360996
"5111",2013,"UC Santa Barbara",NA,NA,NA,64,194,71,48,0,109,0,50,53,103,26,0,208,77,131,48,18,30,17,0.265625,416,6.25
"5112",2013,"UCF",NA,NA,NA,32,54,30,18,0,34,0,19,21,40,16,0,43,16,27,41,9,32,6,0.1875,134,11.9402985074627
"5113",2013,"UCLA",NA,NA,NA,524,892,453,285,0,566,2,446,347,793,326,0,910,308,602,312,94,218,122,0.232824427480916,2388,13.6515912897822
"5114",2013,"UConn",NA,NA,NA,522,1101,413,286,0,483,4,545,249,794,401,0,740,303,437,819,313,506,142,0.272030651340996,2920,13.7328767123288
"5115",2013,"UIC",NA,NA,NA,48,88,55,31,0,75,0,38,39,77,37,0,84,30,54,68,16,52,13,0.270833333333333,238,15.546218487395
"5116",2013,"UL Monroe",NA,NA,NA,78,117,72,43,0,110,0,69,71,140,47,0,113,25,88,58,13,45,17,0.217948717948718,321,14.6417445482866
"5117",2013,"UMBC",NA,NA,NA,53,135,66,41,0,69,1,47,57,104,40,0,98,29,69,65,19,46,10,0.188679245283019,302,13.2450331125828
"5118",2013,"UMass",NA,NA,NA,43,92,38,23,0,69,0,40,37,77,25,0,76,20,56,53,18,35,10,0.232558139534884,224,11.1607142857143
"5119",2013,"UNC Asheville",NA,NA,NA,48,82,43,26,0,69,0,16,23,39,31,0,104,23,81,69,21,48,9,0.1875,197,15.7360406091371
"5120",2013,"UNC Greensboro",NA,NA,NA,110,128,67,40,0,82,0,43,65,108,53,0,174,51,123,107,29,78,20,0.181818181818182,380,13.9473684210526
"5121",2013,"UNC Wilmington",NA,NA,NA,40,117,44,26,0,69,2,43,48,91,39,0,72,23,49,89,29,60,9,0.225,264,14.7727272727273
"5122",2013,"UNLV",NA,NA,NA,115,206,139,91,0,149,2,85,69,154,95,0,206,66,140,138,38,100,25,0.217391304347826,546,17.3992673992674
"5123",2013,"USC",NA,NA,NA,405,729,456,291,0,506,2,255,256,511,207,0,717,225,492,422,125,297,91,0.224691358024691,1862,11.1170784103115
"5124",2013,"UT Arlington",NA,NA,NA,23,42,26,14,0,38,0,18,27,45,12,0,40,10,30,25,7,18,5,0.217391304347826,107,11.214953271028
"5125",2013,"UT Martin",NA,NA,NA,107,253,129,91,0,175,1,113,83,196,85,0,214,79,135,276,86,190,27,0.252336448598131,674,12.6112759643917
"5126",2013,"UT Rio Grande Valley",NA,NA,NA,87,150,60,29,0,86,2,46,71,117,45,0,127,38,89,124,37,87,14,0.160919540229885,371,12.1293800539084
"5127",2013,"UTEP",NA,NA,NA,37,57,41,24,0,31,0,19,20,39,10,0,53,10,43,24,7,17,10,0.27027027027027,139,7.19424460431655
"5128",2013,"UTSA",NA,NA,NA,50,73,43,23,0,70,0,34,46,80,25,0,45,8,37,72,19,53,11,0.22,194,12.8865979381443
"5129",2013,"Utah",NA,NA,NA,263,825,326,214,0,439,3,260,164,424,165,0,661,224,437,449,151,298,65,0.247148288973384,1802,9.15649278579356
"5130",2013,"Utah State",NA,NA,NA,50,113,68,47,0,103,0,53,52,105,54,0,102,30,72,127,49,78,12,0.24,318,16.9811320754717
"5131",2013,"Utah Valley",NA,NA,NA,24,54,29,19,0,24,0,20,19,39,9,0,42,6,36,38,12,26,4,0.166666666666667,123,7.31707317073171
"5132",2013,"VCU",NA,NA,NA,102,143,71,42,0,101,0,56,65,121,57,0,138,34,104,107,23,84,22,0.215686274509804,372,15.3225806451613
"5133",2013,"Valparaiso",NA,NA,NA,75,161,70,45,0,105,0,51,55,106,45,0,117,34,83,135,35,100,15,0.2,369,12.1951219512195
"5134",2013,"Vanderbilt",NA,NA,NA,370,796,391,262,0,470,0,319,182,501,186,0,714,248,466,404,141,263,99,0.267567567567568,1982,9.38446014127144
"5135",2013,"Vermont",NA,NA,NA,118,204,90,50,0,147,0,71,97,168,41,0,153,39,114,107,29,78,16,0.135593220338983,481,8.52390852390852
"5136",2013,"Virginia Tech",NA,NA,NA,332,654,276,153,0,497,2,176,172,348,180,0,851,274,577,299,85,214,82,0.246987951807229,1581,11.3851992409867
"5137",2013,"Wagner",NA,NA,NA,48,100,41,26,0,92,0,32,39,71,29,0,86,24,62,105,26,79,6,0.125,245,11.8367346938776
"5138",2013,"Washington",NA,NA,NA,337,696,327,205,0,342,7,182,255,437,249,0,646,208,438,655,216,439,73,0.216617210682493,1719,14.4851657940663
"5139",2013,"Weber State",NA,NA,NA,50,93,53,29,0,62,0,17,33,50,41,0,128,33,95,49,14,35,6,0.12,221,18.552036199095
"5140",2013,"West Virginia",NA,NA,NA,363,551,299,172,0,469,1,261,203,464,226,0,593,182,411,387,121,266,88,0.242424242424242,1553,14.5524790727624
"5141",2013,"Western Carolina",NA,NA,NA,48,79,39,26,0,64,0,18,20,38,25,0,120,42,78,41,11,30,12,0.25,208,12.0192307692308
"5142",2013,"Western Kentucky",NA,NA,NA,127,211,123,81,0,145,0,104,77,181,73,0,233,76,157,129,43,86,26,0.204724409448819,592,12.3310810810811
"5143",2013,"Western Michigan",NA,NA,NA,39,129,51,31,0,64,0,40,30,70,28,0,130,48,82,71,22,49,7,0.17948717948718,295,9.49152542372881
"5144",2013,"Wichita State",NA,NA,NA,83,188,81,52,0,143,0,69,32,101,71,0,287,110,177,106,34,72,23,0.27710843373494,508,13.9763779527559
"5145",2013,"William & Mary",NA,NA,NA,64,156,54,36,0,99,1,71,46,117,65,0,123,40,83,115,32,83,13,0.203125,379,17.1503957783641
"5146",2013,"Winthrop",NA,NA,NA,75,129,48,32,0,76,0,68,73,141,45,0,87,25,62,93,23,70,13,0.173333333333333,332,13.5542168674699
"5147",2013,"Wisconsin",NA,NA,NA,305,712,278,198,0,387,1,259,173,432,191,0,582,183,399,497,142,355,81,0.265573770491803,1677,11.3893858079905
"5148",2013,"Wofford",NA,NA,NA,63,129,60,35,0,74,0,44,40,84,42,0,106,34,72,72,16,56,11,0.174603174603175,302,13.9072847682119
"5149",2013,"Wright State",NA,NA,NA,50,92,42,25,0,60,0,22,24,46,22,0,110,35,75,89,32,57,10,0.2,242,9.09090909090909
"5150",2013,"Wyoming",NA,NA,NA,60,110,46,31,0,44,0,29,28,57,13,0,94,29,65,65,24,41,15,0.25,265,4.90566037735849
"5151",2013,"Xavier",NA,NA,NA,108,242,102,62,0,139,0,109,114,223,44,0,154,35,119,143,48,95,25,0.231481481481481,567,7.76014109347443
"5152",2013,"Yale",NA,NA,NA,29,40,17,11,0,28,0,19,19,38,19,0,47,15,32,48,17,31,5,0.172413793103448,125,15.2
"5153",2013,"Youngstown State",NA,NA,NA,72,163,88,60,0,107,3,40,54,94,55,0,125,38,87,175,47,128,18,0.25,388,14.1752577319588
"5154",2014,"Abilene Christian",NA,NA,NA,30,39,20,12,0,33,0,15,26,41,18,48,14,3,11,56,20,36,4,0.133333333333333,158,11.3924050632911
"5155",2014,"Air Force",NA,NA,NA,26,40,16,8,0,40,0,5,2,7,9,43,56,12,44,45,12,33,4,0.153846153846154,139,6.47482014388489
"5156",2014,"Akron",NA,NA,NA,57,111,49,35,0,55,0,49,39,88,25,46,98,29,69,78,29,49,15,0.263157894736842,329,7.59878419452887
"5157",2014,"Alabama A&M",NA,NA,NA,53,105,65,38,0,91,1,45,24,69,54,111,132,31,101,74,19,55,9,0.169811320754717,378,14.2857142857143
"5158",2014,"Alabama State",NA,NA,NA,62,81,47,28,0,86,3,17,19,36,26,85,105,27,78,55,14,41,9,0.145161290322581,294,8.84353741496599
"5159",2014,"Albany",NA,NA,NA,60,117,84,48,0,101,0,78,60,138,46,93,92,40,52,33,9,24,22,0.366666666666667,419,10.9785202863962
"5160",2014,"Alcorn State",NA,NA,NA,61,80,72,40,0,88,0,14,27,41,32,85,147,41,106,42,8,34,14,0.229508196721311,308,10.3896103896104
"5161",2014,"American University",NA,NA,NA,16,22,9,5,0,15,0,10,6,16,3,11,17,6,11,22,4,18,5,0.3125,72,4.16666666666667
"5162",2014,"Appalachian State",NA,NA,NA,43,54,28,20,0,69,0,16,18,34,22,64,99,31,68,37,7,30,12,0.27906976744186,221,9.95475113122172
"5163",2014,"Arizona",NA,NA,NA,264,665,287,180,0,449,1,270,267,537,179,413,704,224,480,266,94,172,75,0.284090909090909,1988,9.00402414486922
"5164",2014,"Arizona State",NA,NA,NA,461,771,577,358,0,636,1,365,294,659,259,547,753,268,485,431,144,287,137,0.297180043383948,2681,9.66057441253264
"5165",2014,"Arkansas",NA,NA,NA,395,690,428,265,0,511,1,298,194,492,277,397,728,233,495,508,177,331,101,0.255696202531646,2295,12.0697167755991
"5166",2014,"Arkansas State",NA,NA,NA,102,195,125,79,0,158,0,90,78,168,51,137,190,64,126,91,25,66,23,0.225490196078431,647,7.88253477588872
"5167",2014,"Arkansas-Pine Bluff",NA,NA,NA,53,116,52,29,0,92,0,18,8,26,26,76,173,42,131,56,23,33,15,0.283018867924528,339,7.66961651917404
"5168",2014,"Army",NA,NA,NA,29,68,28,18,0,48,1,15,12,27,12,45,55,18,37,70,20,50,6,0.206896551724138,199,6.03015075376884
"5169",2014,"Austin Peay",NA,NA,NA,36,51,20,12,0,36,0,20,21,41,5,37,62,19,43,40,9,31,12,0.333333333333333,176,2.84090909090909
"5170",2014,"Ball State",NA,NA,NA,80,222,134,90,0,147,1,94,83,177,55,135,83,15,68,182,72,110,24,0.3,642,8.56697819314642
"5171",2014,"Belmont",NA,NA,NA,72,170,74,49,0,110,0,42,33,75,37,89,179,60,119,144,38,106,18,0.25,480,7.70833333333333
"5172",2014,"Bethune-Cookman",NA,NA,NA,12,22,21,9,0,27,0,9,10,19,3,27,27,12,15,12,4,8,5,0.416666666666667,92,3.26086956521739
"5173",2014,"Binghamton",NA,NA,NA,10,40,17,9,0,29,0,7,17,24,7,32,51,14,37,25,9,16,2,0.2,114,6.14035087719298
"5174",2014,"Boise State",NA,NA,NA,17,53,10,6,0,36,0,25,19,44,21,36,48,16,32,28,6,22,7,0.411764705882353,156,13.4615384615385
"5175",2014,"Boston College",NA,NA,NA,235,538,204,143,0,395,0,229,197,426,164,361,343,126,217,503,177,326,61,0.259574468085106,1719,9.54043048283886
"5176",2014,"Boston University",NA,NA,NA,30,109,36,16,0,62,0,15,36,51,19,52,70,20,50,96,27,69,3,0.1,259,7.33590733590734
"5177",2014,"Bowling Green",NA,NA,NA,89,169,76,49,0,106,2,73,78,151,37,88,110,33,77,136,47,89,20,0.224719101123595,516,7.17054263565892
"5178",2014,"Bradley",NA,NA,NA,36,70,45,30,0,54,1,29,15,44,24,50,111,29,82,40,11,29,4,0.111111111111111,237,10.126582278481
"5179",2014,"Bucknell",NA,NA,NA,34,55,19,13,0,25,0,37,40,77,15,38,28,8,20,31,3,28,6,0.176470588235294,181,8.28729281767956
"5180",2014,"Buffalo",NA,NA,NA,36,61,31,16,0,43,0,22,23,45,15,27,35,11,24,52,12,40,6,0.166666666666667,175,8.57142857142857
"5181",2014,"Butler",NA,NA,NA,20,87,37,23,0,55,0,34,27,61,14,46,46,19,27,55,14,41,4,0.2,230,6.08695652173913
"5182",2014,"Cal Poly",NA,NA,NA,71,142,65,45,0,100,0,55,50,105,22,76,146,45,101,84,26,58,19,0.267605633802817,431,5.10440835266821
"5183",2014,"Cal State Bakersfield",NA,NA,NA,78,121,78,47,0,104,0,45,55,100,44,73,147,50,97,96,17,79,17,0.217948717948718,403,10.9181141439206
"5184",2014,"Cal State Fullerton",NA,NA,NA,37,55,32,22,0,55,0,18,7,25,23,51,59,18,41,85,20,65,7,0.189189189189189,207,11.1111111111111
"5185",2014,"Cal State Northridge",NA,NA,NA,83,188,65,39,0,126,0,92,85,177,52,90,137,39,98,135,45,90,17,0.204819277108434,548,9.48905109489051
"5186",2014,"California",NA,NA,NA,443,900,542,332,0,553,1,383,274,657,233,464,843,272,571,436,125,311,115,0.259593679458239,2726,8.54732208363903
"5187",2014,"Campbell",NA,NA,NA,24,59,9,6,0,33,0,23,15,38,14,32,50,16,34,33,15,18,9,0.375,171,8.18713450292398
"5188",2014,"Canisius",NA,NA,NA,14,34,16,12,0,36,0,22,27,49,18,32,29,3,26,37,15,22,1,0.0714285714285714,122,14.7540983606557
"5189",2014,"Central Arkansas",NA,NA,NA,23,76,36,24,0,48,0,41,37,78,18,40,56,23,33,34,6,28,3,0.130434782608696,221,8.1447963800905
"5190",2014,"Central Michigan",NA,NA,NA,115,156,90,47,0,136,0,94,87,181,41,121,142,51,91,165,47,118,34,0.295652173913043,599,6.84474123539232
"5191",2014,"Charleston",NA,NA,NA,48,113,60,35,0,88,0,22,35,57,25,51,162,46,116,52,13,39,11,0.229166666666667,301,8.30564784053156
"5192",2014,"Charleston Southern",NA,NA,NA,33,36,26,15,0,41,0,10,7,17,11,47,61,18,43,48,13,35,8,0.242424242424242,160,6.875
"5193",2014,"Charlotte",NA,NA,NA,37,88,59,43,0,100,0,21,24,45,28,57,143,52,91,50,10,40,4,0.108108108108108,283,9.89399293286219
"5194",2014,"Chattanooga",NA,NA,NA,85,167,80,48,0,114,0,81,76,157,48,76,136,54,82,129,47,82,27,0.317647058823529,526,9.1254752851711
"5195",2014,"Chicago State",NA,NA,NA,8,22,9,4,0,17,0,6,8,14,9,15,23,7,16,20,4,16,0,0,64,14.0625
"5196",2014,"Cincinnati",NA,NA,NA,96,180,79,47,0,122,2,50,53,103,41,169,177,56,121,133,33,100,21,0.21875,599,6.84474123539232
"5197",2014,"Clemson",NA,NA,NA,349,681,392,226,0,527,0,362,352,714,215,484,611,211,400,346,111,235,99,0.283667621776504,2278,9.43810359964881
"5198",2014,"Cleveland State",NA,NA,NA,15,33,28,16,0,43,0,27,15,42,15,28,25,8,17,45,18,27,3,0.2,136,11.0294117647059
"5199",2014,"Coastal Carolina",NA,NA,NA,50,75,46,31,0,58,0,30,19,49,31,60,108,30,78,47,16,31,10,0.2,271,11.4391143911439
"5200",2014,"Colgate",NA,NA,NA,36,67,22,13,0,59,0,21,37,58,18,48,83,23,60,47,3,44,7,0.194444444444444,204,8.82352941176471
"5201",2014,"Colorado",NA,NA,NA,468,932,562,349,0,732,1,419,361,780,277,553,733,264,469,483,144,339,141,0.301282051282051,2883,9.60804717308359
"5202",2014,"Coppin State",NA,NA,NA,102,126,104,55,0,136,1,37,41,78,50,144,206,61,145,66,17,49,21,0.205882352941176,510,9.80392156862745
"5203",2014,"Cornell",NA,NA,NA,16,20,6,4,0,15,0,5,2,7,11,29,26,8,18,24,5,19,3,0.1875,84,13.0952380952381
"5204",2014,"Dartmouth",NA,NA,NA,15,22,15,9,0,20,0,5,3,8,2,22,20,6,14,25,4,21,4,0.266666666666667,79,2.53164556962025
"5205",2014,"Davidson",NA,NA,NA,51,130,76,47,0,71,0,46,52,98,32,71,89,24,65,80,34,46,10,0.196078431372549,378,8.46560846560847
"5206",2014,"DePaul",NA,NA,NA,180,275,204,129,0,223,0,164,112,276,124,174,202,75,127,299,96,203,44,0.244444444444444,1011,12.2650840751731
"5207",2014,"Delaware",NA,NA,NA,48,97,56,35,0,58,0,25,24,49,16,55,98,26,72,26,6,20,14,0.291666666666667,272,5.88235294117647
"5208",2014,"Delaware State",NA,NA,NA,33,55,34,24,0,65,0,26,20,46,26,72,80,18,62,45,10,35,8,0.242424242424242,221,11.7647058823529
"5209",2014,"Denver",NA,NA,NA,44,111,83,57,0,76,0,46,39,85,17,54,85,22,63,49,21,28,9,0.204545454545455,321,5.29595015576324
"5210",2014,"Detroit Mercy",NA,NA,NA,20,53,35,23,0,36,0,17,10,27,15,29,50,13,37,47,13,34,5,0.25,156,9.61538461538462
"5211",2014,"Drake",NA,NA,NA,61,160,63,38,0,92,0,34,26,60,41,106,118,41,77,156,40,116,7,0.114754098360656,457,8.97155361050328
"5212",2014,"Drexel",NA,NA,NA,20,64,24,17,0,43,0,19,17,36,13,31,60,16,44,57,23,34,6,0.3,180,7.22222222222222
"5213",2014,"Duke",NA,NA,NA,450,906,497,295,0,513,0,500,255,755,313,549,756,293,463,417,169,248,142,0.315555555555556,2997,10.4437771104438
"5214",2014,"Duquesne",NA,NA,NA,51,116,73,46,0,105,0,46,45,91,36,81,117,34,83,70,21,49,18,0.352941176470588,367,9.80926430517711
"5215",2014,"East Carolina",NA,NA,NA,23,43,33,20,0,59,0,6,12,18,20,24,71,30,41,39,11,28,8,0.347826086956522,144,13.8888888888889
"5216",2014,"East Tennessee State",NA,NA,NA,41,74,37,23,0,72,0,31,24,55,15,63,80,22,58,46,17,29,10,0.24390243902439,255,5.88235294117647
"5217",2014,"Eastern Kentucky",NA,NA,NA,20,50,30,21,0,45,0,19,11,30,9,30,52,14,38,26,7,19,3,0.15,146,6.16438356164384
"5218",2014,"Eastern Michigan",NA,NA,NA,65,95,55,33,0,68,0,40,31,71,50,55,135,53,82,81,27,54,23,0.353846153846154,343,14.5772594752187
"5219",2014,"Eastern Washington",NA,NA,NA,13,23,12,8,0,17,0,12,16,28,11,20,17,5,12,15,4,11,2,0.153846153846154,82,13.4146341463415
"5220",2014,"Elon",NA,NA,NA,64,100,63,38,0,87,1,47,44,91,26,94,136,46,90,54,11,43,19,0.296875,382,6.80628272251309
"5221",2014,"Evansville",NA,NA,NA,33,76,27,19,0,40,0,25,22,47,25,42,67,13,54,85,22,63,8,0.242424242424242,224,11.1607142857143
"5222",2014,"Fairleigh Dickinson",NA,NA,NA,10,20,15,7,0,22,0,2,6,8,8,18,32,8,24,17,6,11,1,0.1,67,11.9402985074627
"5223",2014,"Florida",NA,NA,NA,310,687,454,293,0,553,4,385,228,613,277,483,543,183,360,505,170,335,87,0.280645161290323,2340,11.8376068376068
"5224",2014,"Florida A&M",NA,NA,NA,11,20,6,5,0,22,0,5,5,10,10,26,25,8,17,27,7,20,2,0.181818181818182,79,12.6582278481013
"5225",2014,"Florida Atlantic",NA,NA,NA,47,61,48,32,0,77,0,24,24,48,29,40,67,21,46,101,29,72,9,0.191489361702128,234,12.3931623931624
"5226",2014,"Florida Gulf Coast",NA,NA,NA,47,139,54,30,0,71,0,53,53,106,47,74,35,13,22,154,54,100,16,0.340425531914894,393,11.9592875318066
"5227",2014,"Florida International",NA,NA,NA,68,141,80,55,0,84,0,55,17,72,24,81,142,55,87,78,25,53,20,0.294117647058824,448,5.35714285714286
"5228",2014,"Florida State",NA,NA,NA,471,801,475,278,0,494,1,447,316,763,312,595,674,223,451,446,128,318,129,0.273885350318471,2783,11.2109234638879
"5229",2014,"Fordham",NA,NA,NA,36,115,24,17,0,71,0,30,32,62,17,57,80,31,49,74,31,43,13,0.361111111111111,305,5.57377049180328
"5230",2014,"Fresno State",NA,NA,NA,55,165,85,60,0,105,0,59,71,130,43,90,100,30,70,131,51,80,15,0.272727272727273,470,9.14893617021277
"5231",2014,"Furman",NA,NA,NA,27,76,39,24,0,65,0,22,24,46,11,51,59,20,39,62,20,42,5,0.185185185185185,226,4.86725663716814
"5232",2014,"Gardner-Webb",NA,NA,NA,17,18,13,8,0,7,0,11,10,21,10,11,26,3,23,12,2,10,6,0.352941176470588,66,15.1515151515152
"5233",2014,"George Washington",NA,NA,NA,84,124,85,55,0,97,0,56,59,115,25,72,142,43,99,71,25,46,19,0.226190476190476,429,5.82750582750583
"5234",2014,"Georgetown",NA,NA,NA,63,148,61,33,0,102,0,57,41,98,28,124,118,44,74,52,18,34,18,0.285714285714286,468,5.98290598290598
"5235",2014,"Georgia",NA,NA,NA,446,746,403,232,0,601,5,324,186,510,258,483,713,216,497,536,163,373,102,0.228699551569507,2489,10.365608678184
"5236",2014,"Georgia Southern",NA,NA,NA,44,107,62,42,0,68,0,35,25,60,24,78,87,22,65,51,12,39,7,0.159090909090909,310,7.74193548387097
"5237",2014,"Georgia State",NA,NA,NA,20,23,8,6,0,18,0,10,16,26,5,19,22,3,19,13,3,10,3,0.15,80,6.25
"5238",2014,"Georgia Tech",NA,NA,NA,490,744,488,302,0,624,4,388,259,647,272,475,783,273,510,479,151,328,154,0.314285714285714,2640,10.3030303030303
"5239",2014,"Gonzaga",NA,NA,NA,379,548,311,198,0,396,2,309,218,527,247,262,544,210,334,385,127,258,110,0.29023746701847,1904,12.9726890756303
"5240",2014,"Grambling",NA,NA,NA,122,169,154,84,0,154,1,67,59,126,49,164,211,57,154,98,24,74,30,0.245901639344262,633,7.74091627172196
"5241",2014,"Grand Canyon",NA,NA,NA,9,29,13,9,0,11,0,15,9,24,5,23,4,0,4,19,3,16,2,0.222222222222222,83,6.02409638554217
"5242",2014,"Green Bay",NA,NA,NA,59,112,72,43,0,83,1,70,54,124,52,68,75,26,49,92,26,66,18,0.305084745762712,376,13.8297872340426
"5243",2014,"Hartford",NA,NA,NA,47,110,43,26,0,91,0,30,36,66,34,98,112,40,72,133,36,97,8,0.170212765957447,371,9.1644204851752
"5244",2014,"Harvard",NA,NA,NA,10,30,7,5,0,17,0,7,3,10,5,20,25,5,20,21,7,14,2,0.2,82,6.09756097560976
"5245",2014,"Hawai'i",NA,NA,NA,113,241,146,93,0,178,0,74,89,163,55,146,250,78,172,111,36,75,33,0.292035398230089,722,7.61772853185596
"5246",2014,"High Point",NA,NA,NA,65,150,88,54,0,124,0,57,50,107,50,97,167,69,98,93,24,69,20,0.307692307692308,474,10.5485232067511
"5247",2014,"Hofstra",NA,NA,NA,10,23,11,8,0,18,0,8,5,13,3,17,17,4,13,16,5,11,3,0.3,67,4.47761194029851
"5248",2014,"Holy Cross",NA,NA,NA,40,68,20,11,0,50,0,38,27,65,25,42,86,28,58,49,14,35,8,0.2,234,10.6837606837607
"5249",2014,"Houston",NA,NA,NA,120,212,140,78,0,177,2,62,75,137,50,172,247,70,177,135,38,97,28,0.233333333333333,700,7.14285714285714
"5250",2014,"Houston Christian",NA,NA,NA,10,23,5,3,0,26,0,6,14,20,4,20,26,8,18,22,8,14,4,0.4,75,5.33333333333333
"5251",2014,"Howard",NA,NA,NA,9,23,10,4,0,21,0,9,22,31,12,20,15,4,11,13,0,13,2,0.222222222222222,66,18.1818181818182
"5252",2014,"IUPUI",NA,NA,NA,121,172,122,69,0,144,0,92,94,186,51,126,131,34,97,110,26,84,28,0.231404958677686,599,8.51419031719533
"5253",2014,"Idaho",NA,NA,NA,49,138,68,40,0,64,0,48,31,79,29,77,78,27,51,121,40,81,19,0.387755102040816,389,7.45501285347044
"5254",2014,"Idaho State",NA,NA,NA,22,44,20,11,0,38,0,15,8,23,13,35,49,9,40,46,10,36,1,0.0454545454545455,141,9.21985815602837
"5255",2014,"Illinois",NA,NA,NA,319,591,333,204,0,558,2,239,180,419,293,421,742,256,486,596,180,416,77,0.241379310344828,2088,14.0325670498084
"5256",2014,"Illinois State",NA,NA,NA,29,66,35,22,0,52,0,16,11,27,17,48,95,41,54,39,12,27,6,0.206896551724138,221,7.69230769230769
"5257",2014,"Indiana",NA,NA,NA,406,874,428,262,0,600,3,433,360,793,195,423,486,136,350,736,255,481,121,0.298029556650246,2636,7.39757207890744
"5258",2014,"Indiana State",NA,NA,NA,105,139,89,53,0,111,0,30,38,68,52,92,209,65,144,114,33,81,25,0.238095238095238,478,10.8786610878661
"5259",2014,"Iona",NA,NA,NA,39,77,48,35,0,55,0,30,29,59,26,40,58,23,35,64,19,45,10,0.256410256410256,237,10.9704641350211
"5260",2014,"Iowa",NA,NA,NA,306,766,434,297,0,534,1,427,139,566,257,422,632,212,420,604,205,399,82,0.26797385620915,2455,10.4684317718941
"5261",2014,"Iowa State",NA,NA,NA,283,709,367,272,0,425,1,243,105,348,135,351,449,146,303,733,235,498,73,0.257950530035336,2047,6.59501709819248
"5262",2014,"Jackson State",NA,NA,NA,59,84,65,38,0,90,1,34,19,53,52,86,155,40,115,41,12,29,16,0.271186440677966,330,15.7575757575758
"5263",2014,"Jacksonville",NA,NA,NA,61,94,42,24,0,77,1,26,33,59,28,79,134,37,97,43,7,36,13,0.213114754098361,310,9.03225806451613
"5264",2014,"Jacksonville State",NA,NA,NA,31,62,32,24,0,36,1,16,11,27,16,36,87,25,62,43,11,32,8,0.258064516129032,190,8.42105263157895
"5265",2014,"James Madison",NA,NA,NA,137,248,121,91,0,171,2,95,66,161,60,132,218,82,136,169,39,130,35,0.255474452554745,764,7.85340314136126
"5266",2014,"Kansas",NA,NA,NA,322,803,442,284,0,578,1,361,304,665,205,515,595,236,359,460,157,303,90,0.279503105590062,2503,8.19017179384738
"5267",2014,"Kansas City",NA,NA,NA,17,47,36,23,0,38,0,14,10,24,16,34,50,23,27,31,12,19,5,0.294117647058824,155,10.3225806451613
"5268",2014,"Kennesaw State",NA,NA,NA,37,76,24,16,0,60,0,24,32,56,8,65,51,14,37,51,15,36,8,0.216216216216216,234,3.41880341880342
"5269",2014,"Kent State",NA,NA,NA,9,21,15,8,0,21,0,7,13,20,6,18,15,4,11,10,2,8,2,0.222222222222222,65,9.23076923076923
"5270",2014,"LIU Brooklyn",NA,NA,NA,6,22,11,6,0,15,0,11,6,17,7,20,17,3,14,11,4,7,1,0.166666666666667,70,10
"5271",2014,"LSU",NA,NA,NA,478,796,474,310,0,643,3,365,224,589,260,545,934,300,634,382,128,254,121,0.253138075313808,2719,9.56233909525561
"5272",2014,"La Salle",NA,NA,NA,15,25,9,6,0,19,0,9,20,29,6,5,19,2,17,15,3,12,3,0.2,61,9.83606557377049
"5273",2014,"Lafayette",NA,NA,NA,70,117,34,24,0,59,0,25,29,54,21,62,137,40,97,72,18,54,18,0.257142857142857,341,6.158357771261
"5274",2014,"Lamar",NA,NA,NA,36,39,15,7,0,29,0,13,7,20,14,31,52,19,33,56,15,41,10,0.277777777777778,155,9.03225806451613
"5275",2014,"Lehigh",NA,NA,NA,29,61,43,26,0,39,0,14,24,38,17,50,38,10,28,35,12,23,5,0.172413793103448,185,9.18918918918919
"5276",2014,"Liberty",NA,NA,NA,34,53,21,13,0,32,0,21,13,34,11,27,40,13,27,43,12,31,6,0.176470588235294,163,6.74846625766871
"5277",2014,"Lipscomb",NA,NA,NA,30,41,16,10,0,32,0,6,25,31,11,35,49,17,32,51,12,39,7,0.233333333333333,143,7.69230769230769
"5278",2014,"Little Rock",NA,NA,NA,27,103,39,23,0,76,1,36,32,68,12,62,95,37,58,39,7,32,3,0.111111111111111,277,4.33212996389892
"5279",2014,"Long Beach State",NA,NA,NA,63,111,62,34,0,98,0,48,42,90,40,113,92,34,58,102,30,72,16,0.253968253968254,414,9.66183574879227
"5280",2014,"Louisiana",NA,NA,NA,23,45,22,11,0,44,1,14,9,23,11,31,46,12,34,46,14,32,6,0.260869565217391,143,7.69230769230769
"5281",2014,"Louisiana Tech",NA,NA,NA,87,145,102,65,0,135,1,47,53,100,44,108,164,50,114,110,32,78,20,0.229885057471264,488,9.01639344262295
"5282",2014,"Louisville",NA,NA,NA,542,1046,592,366,0,700,9,497,263,760,372,582,862,314,548,706,250,456,161,0.297047970479705,3385,10.9896602658789
"5283",2014,"Loyola Chicago",NA,NA,NA,52,131,51,27,0,100,0,23,14,37,25,83,195,59,136,80,24,56,12,0.230769230769231,382,6.54450261780105
"5284",2014,"Loyola Maryland",NA,NA,NA,23,58,19,10,0,42,0,11,33,44,11,35,31,10,21,38,10,28,2,0.0869565217391304,151,7.28476821192053
"5285",2014,"Loyola Marymount",NA,NA,NA,39,65,28,20,0,43,0,24,32,56,14,49,90,33,57,30,6,24,9,0.230769230769231,223,6.2780269058296
"5286",2014,"Maine",NA,NA,NA,21,39,8,7,0,35,0,20,20,40,13,42,35,10,25,38,7,31,7,0.333333333333333,143,9.09090909090909
"5287",2014,"Marist",NA,NA,NA,40,161,111,73,0,106,0,75,59,134,42,98,81,28,53,146,57,89,11,0.275,483,8.69565217391304
"5288",2014,"Marquette",NA,NA,NA,111,185,95,63,0,149,0,79,56,135,27,113,169,50,119,114,39,75,21,0.189189189189189,598,4.51505016722408
"5289",2014,"Marshall",NA,NA,NA,26,51,38,24,0,26,0,23,16,39,14,28,48,20,28,38,9,29,15,0.576923076923077,169,8.28402366863905
"5290",2014,"Maryland",NA,NA,NA,460,840,470,319,0,545,0,476,209,685,257,469,795,291,504,455,164,291,158,0.343478260869565,2840,9.04929577464789
"5291",2014,"Maryland-Eastern Shore",NA,NA,NA,45,74,61,30,0,72,0,25,49,74,24,87,22,4,18,73,11,62,6,0.133333333333333,260,9.23076923076923
"5292",2014,"McNeese",NA,NA,NA,66,132,52,35,0,104,0,55,43,98,23,68,163,55,108,108,38,70,24,0.363636363636364,427,5.3864168618267
"5293",2014,"Memphis",NA,NA,NA,130,185,106,61,0,192,0,84,73,157,69,169,308,89,219,129,41,88,42,0.323076923076923,718,9.6100278551532
"5294",2014,"Mercer",NA,NA,NA,41,107,46,30,0,55,0,35,22,57,23,51,138,41,97,31,6,25,18,0.439024390243902,291,7.90378006872852
"5295",2014,"Miami",NA,NA,NA,391,772,425,261,0,581,1,285,218,503,254,445,795,294,501,532,158,374,101,0.258312020460358,2458,10.33360455655
"5296",2014,"Miami (OH)",NA,NA,NA,23,37,21,13,0,47,0,13,10,23,19,34,44,14,30,46,17,29,2,0.0869565217391304,142,13.3802816901408
"5297",2014,"Michigan",NA,NA,NA,347,727,293,201,0,418,0,314,215,529,161,404,649,256,393,415,158,257,113,0.325648414985591,2268,7.09876543209876
"5298",2014,"Michigan State",NA,NA,NA,336,801,370,247,0,475,2,364,240,604,193,445,500,180,320,488,164,324,95,0.282738095238095,2380,8.10924369747899
"5299",2014,"Middle Tennessee",NA,NA,NA,243,365,289,167,0,256,0,140,123,263,105,221,265,89,176,310,87,223,75,0.308641975308642,1201,8.74271440466278
"5300",2014,"Milwaukee",NA,NA,NA,24,54,22,12,0,36,0,22,18,40,7,33,36,11,25,45,16,29,7,0.291666666666667,166,4.21686746987952
"5301",2014,"Minnesota",NA,NA,NA,311,852,328,224,0,492,0,132,82,214,169,452,1078,465,613,432,169,263,93,0.29903536977492,2463,6.86155095412099
"5302",2014,"Mississippi Valley State",NA,NA,NA,58,133,82,47,0,101,1,38,23,61,40,134,118,36,82,95,31,64,16,0.275862068965517,446,8.96860986547085
"5303",2014,"Missouri",NA,NA,NA,336,788,311,210,0,577,2,286,217,503,174,471,431,124,307,707,276,431,89,0.264880952380952,2350,7.40425531914894
"5304",2014,"Missouri State",NA,NA,NA,72,112,79,45,0,101,0,25,17,42,52,100,153,45,108,76,23,53,13,0.180555555555556,392,13.265306122449
"5305",2014,"Monmouth",NA,NA,NA,28,44,10,7,0,39,0,18,21,39,12,37,52,18,34,30,6,24,8,0.285714285714286,155,7.74193548387097
"5306",2014,"Montana",NA,NA,NA,68,124,86,57,0,82,0,24,16,40,30,71,158,58,100,89,32,57,16,0.235294117647059,392,7.6530612244898
"5307",2014,"Montana State",NA,NA,NA,28,53,23,16,0,45,0,4,6,10,16,36,77,26,51,46,13,33,9,0.321428571428571,164,9.75609756097561
"5308",2014,"Morehead State",NA,NA,NA,10,25,11,7,0,26,0,5,2,7,3,12,23,5,18,27,7,20,0,0,67,4.47761194029851
"5309",2014,"Morgan State",NA,NA,NA,16,41,25,15,0,42,0,10,4,14,18,49,67,22,45,20,3,17,2,0.125,148,12.1621621621622
"5310",2014,"Mount St. Mary's",NA,NA,NA,60,122,82,48,0,94,0,50,65,115,36,75,75,17,58,88,31,57,15,0.25,370,9.72972972972973
"5311",2014,"NC State",NA,NA,NA,367,641,376,245,0,442,2,333,183,516,179,362,509,171,338,542,179,363,114,0.310626702997275,2149,8.32945556072592
"5312",2014,"NJIT",NA,NA,NA,12,26,11,5,0,17,0,6,11,17,3,23,20,3,17,11,4,7,3,0.25,77,3.8961038961039
"5313",2014,"Navy",NA,NA,NA,8,24,5,4,0,13,0,0,0,0,4,14,27,14,13,26,7,19,0,0,70,5.71428571428571
"5314",2014,"Nebraska",NA,NA,NA,308,851,385,286,0,396,0,275,125,400,169,366,776,311,465,568,207,361,96,0.311688311688312,2424,6.97194719471947
"5315",2014,"Nevada",NA,NA,NA,61,90,64,43,0,69,0,38,17,55,27,60,119,37,82,64,18,46,17,0.278688524590164,313,8.62619808306709
"5316",2014,"New Hampshire",NA,NA,NA,17,40,6,5,0,33,0,16,27,43,7,27,31,11,20,35,12,23,4,0.235294117647059,123,5.6910569105691
"5317",2014,"New Mexico",NA,NA,NA,97,143,62,31,0,105,0,39,37,76,35,103,196,52,144,101,32,69,27,0.278350515463918,483,7.2463768115942
"5318",2014,"New Mexico State",NA,NA,NA,21,65,26,16,0,48,0,25,14,39,8,17,33,10,23,61,18,43,8,0.380952380952381,161,4.96894409937888
"5319",2014,"New Orleans",NA,NA,NA,6,19,5,2,0,24,0,5,5,10,11,45,24,8,16,9,3,6,3,0.5,86,12.7906976744186
"5320",2014,"Niagara",NA,NA,NA,14,30,9,5,0,22,0,7,7,14,7,27,23,5,18,22,4,18,2,0.142857142857143,89,7.86516853932584
"5321",2014,"Nicholls",NA,NA,NA,57,79,45,33,0,69,0,33,42,75,19,55,75,21,54,86,25,61,8,0.140350877192982,281,6.76156583629893
"5322",2014,"North Carolina",NA,NA,NA,513,938,591,357,0,702,8,294,213,507,378,587,1107,490,617,635,200,435,167,0.325536062378168,3168,11.9318181818182
"5323",2014,"North Carolina A&T",NA,NA,NA,14,21,5,4,0,18,0,16,10,26,7,11,18,3,15,15,2,13,7,0.5,69,10.1449275362319
"5324",2014,"North Carolina Central",NA,NA,NA,32,33,24,16,0,32,0,7,11,18,10,36,62,14,48,25,2,23,4,0.125,125,8
"5325",2014,"North Dakota",NA,NA,NA,59,130,76,46,0,92,1,41,18,59,35,80,137,37,100,75,21,54,11,0.186440677966102,383,9.13838120104439
"5326",2014,"North Dakota State",NA,NA,NA,16,54,16,12,0,47,0,15,7,22,13,28,65,21,44,32,12,20,4,0.25,149,8.7248322147651
"5327",2014,"North Florida",NA,NA,NA,51,106,40,21,0,81,0,21,24,45,26,98,85,26,59,90,26,64,11,0.215686274509804,339,7.66961651917404
"5328",2014,"North Texas",NA,NA,NA,24,49,25,10,0,33,0,20,29,49,13,37,49,14,35,31,5,26,8,0.333333333333333,154,8.44155844155844
"5329",2014,"Northeastern",NA,NA,NA,29,42,24,13,0,36,2,10,20,30,15,25,46,16,30,43,12,31,7,0.241379310344828,138,10.8695652173913
"5330",2014,"Northern Colorado",NA,NA,NA,12,19,17,9,0,18,0,12,14,26,7,20,13,5,8,16,2,14,2,0.166666666666667,77,9.09090909090909
"5331",2014,"Northern Illinois",NA,NA,NA,23,72,33,20,0,61,0,21,30,51,13,42,90,34,56,31,14,17,6,0.260869565217391,219,5.93607305936073
"5332",2014,"Northern Iowa",NA,NA,NA,22,48,25,14,0,32,0,9,3,12,7,30,59,19,40,40,14,26,6,0.272727272727273,146,4.7945205479452
"5333",2014,"Northern Kentucky",NA,NA,NA,8,24,16,13,0,10,0,9,8,17,4,16,14,6,8,14,10,4,1,0.125,74,5.4054054054054
"5334",2014,"Northwestern",NA,NA,NA,246,740,387,250,0,491,0,332,236,568,232,438,536,183,353,464,158,306,71,0.288617886178862,2195,10.5694760820046
"5335",2014,"Northwestern State",NA,NA,NA,50,145,78,45,0,106,0,63,47,110,34,94,117,43,74,131,43,88,13,0.26,454,7.48898678414097
"5336",2014,"Notre Dame",NA,NA,NA,484,956,525,360,0,539,4,601,357,958,317,486,763,300,463,423,166,257,176,0.363636363636364,3122,10.1537475976938
"5337",2014,"Oakland",NA,NA,NA,66,108,52,29,0,83,0,30,31,61,45,73,154,48,106,113,26,87,18,0.272727272727273,365,12.3287671232877
"5338",2014,"Ohio",NA,NA,NA,23,36,16,8,0,32,0,12,14,26,10,23,29,7,22,64,9,55,5,0.217391304347826,113,8.84955752212389
"5339",2014,"Ohio State",NA,NA,NA,357,828,423,283,0,559,2,392,294,686,204,520,681,222,459,463,144,319,109,0.305322128851541,2565,7.95321637426901
"5340",2014,"Oklahoma",NA,NA,NA,372,830,515,347,0,626,0,408,307,715,248,470,505,187,318,595,198,397,112,0.301075268817204,2585,9.59381044487428
"5341",2014,"Oklahoma State",NA,NA,NA,394,799,420,262,0,515,0,332,235,567,254,404,795,279,516,418,133,285,108,0.274111675126904,2448,10.3758169934641
"5342",2014,"Old Dominion",NA,NA,NA,41,93,59,37,0,73,1,27,31,58,19,62,95,32,63,78,27,51,13,0.317073170731707,300,6.33333333333333
"5343",2014,"Ole Miss",NA,NA,NA,483,751,501,318,0,589,11,353,247,600,223,423,853,269,584,549,165,384,133,0.27536231884058,2570,8.67704280155642
"5344",2014,"Oral Roberts",NA,NA,NA,82,114,68,38,0,121,0,41,49,90,46,136,138,40,98,114,36,78,21,0.25609756097561,463,9.93520518358531
"5345",2014,"Oregon",NA,NA,NA,646,985,581,388,0,622,0,442,313,755,327,498,746,240,506,1000,300,700,150,0.232198142414861,3245,10.0770416024653
"5346",2014,"Oregon State",NA,NA,NA,420,969,434,263,0,570,2,375,273,648,168,510,458,159,299,704,259,445,116,0.276190476190476,2783,6.03665109593963
"5347",2014,"Pacific",NA,NA,NA,62,158,86,55,0,126,1,81,92,173,59,90,78,26,52,127,40,87,11,0.17741935483871,476,12.3949579831933
"5348",2014,"Penn State",NA,NA,NA,379,773,422,297,0,518,1,321,262,583,218,412,800,275,525,307,103,204,97,0.255936675461741,2351,9.27264993619736
"5349",2014,"Pennsylvania",NA,NA,NA,30,72,32,19,0,55,0,19,19,38,17,44,79,26,53,52,19,33,8,0.266666666666667,218,7.79816513761468
"5350",2014,"Pepperdine",NA,NA,NA,54,138,83,53,0,95,0,38,37,75,38,69,160,53,107,68,22,46,11,0.203703703703704,393,9.66921119592875
"5351",2014,"Pittsburgh",NA,NA,NA,338,666,386,238,0,518,2,266,232,498,196,381,637,194,443,507,139,368,81,0.239644970414201,2065,9.49152542372881
"5352",2014,"Portland",NA,NA,NA,63,171,85,55,0,121,0,71,54,125,41,100,115,44,71,129,43,86,13,0.206349206349206,510,8.03921568627451
"5353",2014,"Portland State",NA,NA,NA,31,69,42,23,0,65,0,30,43,73,13,78,68,20,48,34,12,22,3,0.0967741935483871,246,5.28455284552846
"5354",2014,"Prairie View A&M",NA,NA,NA,92,165,107,63,0,124,5,38,33,71,50,138,204,50,154,117,28,89,20,0.217391304347826,531,9.41619585687382
"5355",2014,"Presbyterian",NA,NA,NA,41,98,44,22,0,66,0,20,33,53,29,92,94,23,71,80,19,61,6,0.146341463414634,299,9.6989966555184
"5356",2014,"Princeton",NA,NA,NA,60,116,66,43,0,83,0,59,47,106,13,60,52,19,33,93,32,61,17,0.283333333333333,364,3.57142857142857
"5357",2014,"Providence",NA,NA,NA,29,73,45,31,0,59,0,26,34,60,21,51,62,21,41,52,23,29,7,0.241379310344828,230,9.1304347826087
"5358",2014,"Purdue",NA,NA,NA,377,714,377,265,0,483,4,326,239,565,214,429,643,200,443,477,183,294,108,0.286472148541114,2313,9.25205361003026
"5359",2014,"Purdue Fort Wayne",NA,NA,NA,30,79,37,29,0,77,0,37,20,57,26,54,82,36,46,93,36,57,15,0.5,283,9.18727915194346
"5360",2014,"Quinnipiac",NA,NA,NA,69,136,84,50,0,107,2,67,53,120,37,80,86,36,50,99,26,73,23,0.333333333333333,433,8.54503464203233
"5361",2014,"Radford",NA,NA,NA,32,55,33,17,0,57,0,20,28,48,22,65,68,21,47,39,10,29,5,0.15625,209,10.5263157894737
"5362",2014,"Rice",NA,NA,NA,52,82,56,37,0,81,1,24,18,42,19,64,139,44,95,47,11,36,13,0.25,292,6.50684931506849
"5363",2014,"Richmond",NA,NA,NA,29,64,36,21,0,36,0,13,12,25,14,26,64,20,44,36,8,28,11,0.379310344827586,169,8.28402366863905
"5364",2014,"Rider",NA,NA,NA,18,52,37,24,0,37,0,24,34,58,11,18,23,8,15,22,7,15,2,0.111111111111111,135,8.14814814814815
"5365",2014,"Robert Morris",NA,NA,NA,44,87,57,31,0,67,0,31,30,61,26,63,89,29,60,65,26,39,11,0.25,291,8.93470790378007
"5366",2014,"Rutgers",NA,NA,NA,212,447,208,132,0,295,2,186,137,323,147,276,631,232,399,48,7,41,60,0.283018867924528,1408,10.4403409090909
"5367",2014,"SE Louisiana",NA,NA,NA,31,32,38,22,0,50,0,17,6,23,12,50,52,16,36,40,10,30,7,0.225806451612903,166,7.2289156626506
"5368",2014,"SIU Edwardsville",NA,NA,NA,29,57,21,14,0,37,1,22,22,44,12,42,38,13,25,28,4,24,5,0.172413793103448,176,6.81818181818182
"5369",2014,"SMU",NA,NA,NA,119,174,96,54,0,150,2,60,70,130,63,110,208,65,143,178,50,128,31,0.260504201680672,595,10.5882352941176
"5370",2014,"Sacramento State",NA,NA,NA,32,57,35,22,0,50,0,24,24,48,22,30,37,13,24,88,23,65,5,0.15625,190,11.5789473684211
"5371",2014,"Saint Joseph's",NA,NA,NA,52,107,41,26,0,88,0,52,37,89,39,60,134,40,94,90,34,56,17,0.326923076923077,354,11.0169491525424
"5372",2014,"Saint Louis",NA,NA,NA,11,23,18,13,0,24,0,10,13,23,3,17,17,5,12,15,7,8,3,0.272727272727273,80,3.75
"5373",2014,"Saint Mary's",NA,NA,NA,66,124,85,56,0,110,0,49,59,108,25,77,105,42,63,65,20,45,17,0.257575757575758,398,6.28140703517588
"5374",2014,"Sam Houston",NA,NA,NA,37,56,51,28,0,64,0,16,21,37,8,63,68,18,50,49,12,37,7,0.189189189189189,215,3.72093023255814
"5375",2014,"Samford",NA,NA,NA,17,67,14,11,0,51,0,23,29,52,16,42,22,5,17,80,17,63,2,0.117647058823529,172,9.30232558139535
"5376",2014,"San Diego",NA,NA,NA,74,129,70,42,0,100,0,40,42,82,42,80,161,58,103,53,6,47,19,0.256756756756757,402,10.4477611940298
"5377",2014,"San Diego State",NA,NA,NA,75,140,87,49,0,111,1,46,37,83,42,119,148,47,101,71,20,51,18,0.24,471,8.9171974522293
"5378",2014,"San Francisco",NA,NA,NA,27,56,45,30,0,60,0,37,26,63,16,51,48,14,34,34,13,21,2,0.0740740740740741,208,7.69230769230769
"5379",2014,"San José State",NA,NA,NA,31,59,30,18,0,40,0,9,15,24,13,41,66,16,50,56,24,32,8,0.258064516129032,186,6.98924731182796
"5380",2014,"Santa Clara",NA,NA,NA,19,40,23,15,1,48,0,22,27,49,11,40,32,10,22,23,5,18,4,0.210526315789474,141,7.80141843971631
"5381",2014,"Savannah State",NA,NA,NA,35,66,44,27,0,91,1,26,23,49,19,62,79,16,63,31,2,29,6,0.171428571428571,216,8.7962962962963
"5382",2014,"Seattle U",NA,NA,NA,54,167,106,69,0,123,1,101,64,165,46,94,131,41,90,77,24,53,15,0.277777777777778,506,9.09090909090909
"5383",2014,"Seton Hall",NA,NA,NA,71,123,75,44,0,116,2,51,34,85,39,69,188,66,122,62,19,43,16,0.225352112676056,413,9.44309927360775
"5384",2014,"Siena",NA,NA,NA,25,37,26,17,0,36,1,17,19,36,16,46,33,10,23,37,11,26,6,0.24,150,10.6666666666667
"5385",2014,"South Alabama",NA,NA,NA,35,60,52,32,0,56,0,26,36,62,15,54,33,5,28,67,25,42,11,0.314285714285714,217,6.91244239631336
"5386",2014,"South Carolina",NA,NA,NA,366,892,625,391,0,497,3,318,161,479,175,445,778,318,460,359,127,232,119,0.325136612021858,2629,6.65652339292507
"5387",2014,"South Carolina State",NA,NA,NA,28,43,30,17,0,42,0,21,28,49,27,51,50,14,36,52,12,40,4,0.142857142857143,178,15.1685393258427
"5388",2014,"South Carolina Upstate",NA,NA,NA,64,111,55,37,0,104,0,40,56,96,39,94,144,41,103,77,18,59,17,0.265625,381,10.2362204724409
"5389",2014,"South Dakota",NA,NA,NA,62,145,93,66,0,127,1,67,38,105,42,79,136,46,90,109,37,72,25,0.403225806451613,461,9.11062906724512
"5390",2014,"South Dakota State",NA,NA,NA,89,223,127,86,0,145,0,71,99,170,62,122,105,36,69,185,59,126,19,0.213483146067416,622,9.96784565916399
"5391",2014,"South Florida",NA,NA,NA,197,374,159,102,0,241,0,143,138,281,70,208,357,113,244,202,58,144,55,0.279187817258883,1136,6.16197183098592
"5392",2014,"Southeast Missouri State",NA,NA,NA,27,50,31,19,0,45,0,10,17,27,8,36,56,14,42,31,6,25,3,0.111111111111111,150,5.33333333333333
"5393",2014,"Southern",NA,NA,NA,66,119,63,39,0,125,5,36,22,58,39,99,184,62,122,76,25,51,12,0.181818181818182,423,9.21985815602837
"5394",2014,"Southern Illinois",NA,NA,NA,27,52,23,13,0,37,0,6,1,7,11,43,77,20,57,33,4,29,6,0.222222222222222,158,6.9620253164557
"5395",2014,"Southern Miss",NA,NA,NA,80,200,105,64,0,158,0,70,35,105,56,129,228,93,135,74,24,50,18,0.225,622,9.0032154340836
"5396",2014,"Southern Utah",NA,NA,NA,47,87,78,55,0,100,0,33,51,84,42,91,78,27,51,52,15,37,7,0.148936170212766,319,13.166144200627
"5397",2014,"St. Bonaventure",NA,NA,NA,55,128,73,48,0,69,0,53,78,131,18,58,69,23,46,74,17,57,8,0.145454545454545,351,5.12820512820513
"5398",2014,"St. Francis (PA)",NA,NA,NA,57,102,64,43,0,90,0,54,35,89,34,81,88,25,63,104,37,67,17,0.298245614035088,371,9.1644204851752
"5399",2014,"St. Francis Brooklyn",NA,NA,NA,23,47,14,9,0,36,2,17,22,39,18,36,32,8,24,48,16,32,4,0.173913043478261,153,11.7647058823529
"5400",2014,"Stanford",NA,NA,NA,401,975,413,265,0,501,1,428,245,673,175,392,724,270,454,568,199,369,130,0.324189526184539,2767,6.32453921214312
"5401",2014,"Stephen F. Austin",NA,NA,NA,66,103,59,35,0,55,0,36,41,77,22,56,83,28,55,73,20,53,12,0.181818181818182,326,6.74846625766871
"5402",2014,"Stetson",NA,NA,NA,72,147,92,56,0,80,0,79,79,158,58,95,88,27,61,116,35,81,19,0.263888888888889,472,12.2881355932203
"5403",2014,"Stony Brook",NA,NA,NA,65,87,50,33,0,68,1,37,48,85,27,62,88,25,63,63,18,45,13,0.2,301,8.97009966777409
"5404",2014,"Syracuse",NA,NA,NA,541,792,449,301,0,548,1,348,233,581,314,448,740,234,506,750,233,517,136,0.251386321626617,2708,11.5952732644018
"5405",2014,"TCU",NA,NA,NA,333,707,424,271,0,459,1,294,284,578,285,418,541,188,353,485,151,334,92,0.276276276276276,2187,13.0315500685871
"5406",2014,"Temple",NA,NA,NA,121,227,113,70,0,201,0,103,103,206,81,199,184,55,129,185,58,127,33,0.272727272727273,791,10.2402022756005
"5407",2014,"Tennessee",NA,NA,NA,511,884,510,332,0,519,5,417,217,634,248,519,899,309,590,375,135,240,147,0.287671232876712,2908,8.52819807427785
"5408",2014,"Tennessee State",NA,NA,NA,66,79,66,39,0,95,1,31,41,72,30,66,116,37,79,74,14,60,17,0.257575757575758,307,9.77198697068404
"5409",2014,"Tennessee Tech",NA,NA,NA,20,63,26,16,0,68,0,20,12,32,16,70,76,33,43,32,8,24,7,0.35,218,7.3394495412844
"5410",2014,"Texas",NA,NA,NA,466,984,474,295,0,691,2,376,266,642,197,606,745,260,485,500,183,317,120,0.257510729613734,2983,6.6040898424405
"5411",2014,"Texas A&M",NA,NA,NA,451,960,507,315,0,612,3,429,273,702,255,514,1076,416,660,263,81,182,133,0.29490022172949,2968,8.59164420485175
"5412",2014,"Texas A&M-Corpus Christi",NA,NA,NA,19,22,13,9,0,15,0,12,11,23,5,16,20,11,9,16,5,11,5,0.263157894736842,91,5.49450549450549
"5413",2014,"Texas Southern",NA,NA,NA,50,142,74,46,0,105,2,51,21,72,33,102,161,62,99,65,26,39,18,0.36,455,7.25274725274725
"5414",2014,"Texas State",NA,NA,NA,45,99,52,30,0,84,0,30,19,49,28,62,97,19,78,95,26,69,6,0.133333333333333,290,9.6551724137931
"5415",2014,"Texas Tech",NA,NA,NA,322,647,353,225,0,513,1,191,160,351,166,434,822,270,552,408,115,293,74,0.229813664596273,2050,8.09756097560976
"5416",2014,"Toledo",NA,NA,NA,28,91,27,19,0,35,0,41,32,73,23,37,56,16,40,51,19,32,2,0.0714285714285714,238,9.66386554621849
"5417",2014,"Towson",NA,NA,NA,21,47,21,12,0,36,0,17,7,24,18,24,54,13,41,48,12,36,8,0.380952380952381,138,13.0434782608696
"5418",2014,"Troy",NA,NA,NA,54,103,59,34,0,104,3,49,24,73,34,61,148,46,102,84,19,65,7,0.12962962962963,345,9.85507246376812
"5419",2014,"Tulane",NA,NA,NA,128,176,119,78,0,148,0,68,76,144,65,140,191,45,146,122,37,85,26,0.203125,620,10.4838709677419
"5420",2014,"Tulsa",NA,NA,NA,25,73,38,26,0,65,0,33,28,61,17,54,63,16,47,39,14,25,5,0.2,227,7.48898678414097
"5421",2014,"UAB",NA,NA,NA,52,126,68,44,0,86,0,57,27,84,31,72,109,33,76,81,30,51,17,0.326923076923077,385,8.05194805194805
"5422",2014,"UC Davis",NA,NA,NA,41,98,25,16,0,71,0,29,19,48,18,83,59,19,40,111,31,80,9,0.219512195121951,307,5.86319218241042
"5423",2014,"UC Irvine",NA,NA,NA,52,76,44,28,0,41,0,21,11,32,29,36,109,32,77,70,19,51,16,0.307692307692308,245,11.8367346938776
"5424",2014,"UC Riverside",NA,NA,NA,42,118,37,20,0,74,0,27,22,49,15,77,119,39,80,73,23,50,18,0.428571428571429,332,4.51807228915663
"5425",2014,"UC Santa Barbara",NA,NA,NA,47,82,35,23,0,88,1,49,40,89,29,55,129,40,89,25,5,20,11,0.234042553191489,289,10.0346020761246
"5426",2014,"UCF",NA,NA,NA,52,65,36,23,0,53,2,22,30,52,24,48,97,21,76,41,9,32,9,0.173076923076923,229,10.4803493449782
"5427",2014,"UCLA",NA,NA,NA,347,628,394,238,0,458,2,246,225,471,201,349,776,262,514,332,100,232,93,0.268011527377522,2014,9.98013902681231
"5428",2014,"UConn",NA,NA,NA,453,1153,442,300,0,450,0,585,207,792,355,449,766,305,461,766,284,482,145,0.320088300220751,3363,10.5560511448112
"5429",2014,"UIC",NA,NA,NA,84,131,60,31,0,102,1,80,67,147,38,91,97,32,65,78,26,52,30,0.357142857142857,458,8.29694323144105
"5430",2014,"UL Monroe",NA,NA,NA,70,128,67,36,0,93,0,53,44,97,28,95,126,37,89,80,29,51,16,0.228571428571429,421,6.65083135391924
"5431",2014,"UMBC",NA,NA,NA,10,25,9,7,0,18,0,9,12,21,10,23,9,2,7,17,5,12,4,0.4,75,13.3333333333333
"5432",2014,"UMass Lowell",NA,NA,NA,14,27,4,2,0,19,0,7,6,13,6,17,29,5,24,28,5,23,2,0.142857142857143,75,8
"5433",2014,"UNC Asheville",NA,NA,NA,27,50,29,16,0,37,0,19,23,42,10,39,46,19,27,37,9,28,10,0.37037037037037,171,5.84795321637427
"5434",2014,"UNC Greensboro",NA,NA,NA,35,37,24,17,0,33,0,14,21,35,16,42,61,19,42,31,7,24,10,0.285714285714286,157,10.1910828025478
"5435",2014,"UNC Wilmington",NA,NA,NA,77,115,74,46,0,101,0,59,46,105,48,94,156,45,111,93,23,70,23,0.298701298701299,432,11.1111111111111
"5436",2014,"UNLV",NA,NA,NA,86,151,108,68,0,94,0,71,58,129,52,100,151,39,112,76,19,57,21,0.244186046511628,488,10.655737704918
"5437",2014,"USC",NA,NA,NA,396,814,504,302,0,617,1,362,325,687,279,489,715,246,469,461,161,300,117,0.295454545454545,2585,10.7930367504836
"5438",2014,"UT Arlington",NA,NA,NA,24,51,30,18,0,35,0,19,31,50,13,57,28,5,23,22,3,19,5,0.208333333333333,169,7.69230769230769
"5439",2014,"UT Martin",NA,NA,NA,92,214,108,72,0,141,1,60,41,101,67,109,207,75,132,239,77,162,23,0.25,652,10.2760736196319
"5440",2014,"UT Rio Grande Valley",NA,NA,NA,35,81,58,30,0,67,0,26,33,59,18,41,54,11,43,76,17,59,11,0.314285714285714,223,8.07174887892377
"5441",2014,"UTEP",NA,NA,NA,115,195,144,99,0,135,2,87,85,172,72,115,159,50,109,143,38,105,31,0.269565217391304,631,11.4104595879556
"5442",2014,"UTSA",NA,NA,NA,36,72,50,29,0,71,1,30,20,50,16,49,67,23,44,61,10,51,7,0.194444444444444,229,6.98689956331878
"5443",2014,"Utah",NA,NA,NA,246,751,328,200,0,485,1,213,177,390,141,364,654,209,445,419,143,276,49,0.199186991869919,2006,7.02891326021934
"5444",2014,"Utah State",NA,NA,NA,35,60,25,14,0,70,1,16,5,21,33,46,103,44,59,69,24,45,8,0.228571428571429,230,14.3478260869565
"5445",2014,"Utah Valley",NA,NA,NA,17,62,34,23,0,30,0,15,10,25,8,28,55,20,35,23,9,14,2,0.117647058823529,158,5.06329113924051
"5446",2014,"VCU",NA,NA,NA,24,43,27,14,0,49,0,17,13,30,15,28,34,16,18,73,20,53,5,0.208333333333333,154,9.74025974025974
"5447",2014,"Valparaiso",NA,NA,NA,35,97,43,31,0,72,2,20,22,42,27,88,84,29,55,81,28,53,7,0.2,309,8.7378640776699
"5448",2014,"Vanderbilt",NA,NA,NA,309,611,399,262,0,496,2,375,193,568,199,439,571,175,396,346,135,211,76,0.245954692556634,2151,9.25151092515109
"5449",2014,"Villanova",NA,NA,NA,27,73,43,27,0,51,0,29,25,54,19,35,43,15,28,72,21,51,9,0.333333333333333,210,9.04761904761905
"5450",2014,"Virginia",NA,NA,NA,386,571,387,255,0,513,0,314,289,603,253,385,605,210,395,425,137,288,119,0.308290155440414,2098,12.0591039084843
"5451",2014,"Virginia Tech",NA,NA,NA,331,735,376,225,0,507,2,223,166,389,124,400,652,232,420,480,139,341,79,0.238670694864048,2156,5.75139146567718
"5452",2014,"Wagner",NA,NA,NA,39,74,36,19,0,71,0,40,45,85,21,62,24,5,19,69,21,48,13,0.333333333333333,252,8.33333333333333
"5453",2014,"Wake Forest",NA,NA,NA,347,622,387,227,0,476,1,312,207,519,182,453,468,147,321,384,115,269,93,0.268011527377522,2077,8.76263842079923
"5454",2014,"Washington",NA,NA,NA,332,1004,487,324,0,548,5,255,240,495,205,419,752,268,484,757,258,499,85,0.256024096385542,2645,7.75047258979206
"5455",2014,"Washington State",NA,NA,NA,431,843,507,311,0,658,3,316,291,607,266,424,912,332,580,622,208,414,125,0.290023201856148,2668,9.97001499250375
"5456",2014,"West Virginia",NA,NA,NA,476,873,611,393,0,628,0,410,265,675,274,463,651,221,430,601,194,407,141,0.296218487394958,2781,9.85257101761956
"5457",2014,"Western Carolina",NA,NA,NA,45,89,53,36,0,82,1,36,36,72,33,59,84,28,56,80,28,52,12,0.266666666666667,301,10.9634551495017
"5458",2014,"Western Illinois",NA,NA,NA,28,68,55,37,0,44,0,45,21,66,26,52,46,12,34,58,22,36,8,0.285714285714286,239,10.8786610878661
"5459",2014,"Western Kentucky",NA,NA,NA,57,133,73,44,0,114,0,55,41,96,49,68,167,53,114,103,36,67,16,0.280701754385965,419,11.6945107398568
"5460",2014,"Western Michigan",NA,NA,NA,35,81,34,26,0,45,1,31,24,55,8,48,57,20,37,52,14,38,9,0.257142857142857,238,3.36134453781513
"5461",2014,"Wichita State",NA,NA,NA,55,106,65,43,0,95,0,33,20,53,40,50,175,75,100,71,19,52,22,0.4,356,11.2359550561798
"5462",2014,"William & Mary",NA,NA,NA,20,44,26,13,0,33,1,11,14,25,20,28,60,23,37,34,15,19,8,0.4,145,13.7931034482759
"5463",2014,"Winthrop",NA,NA,NA,54,119,68,45,0,84,0,51,33,84,49,67,144,47,97,63,22,41,18,0.333333333333333,373,13.1367292225201
"5464",2014,"Wisconsin",NA,NA,NA,261,657,271,181,0,384,0,270,200,470,106,359,503,180,323,477,151,326,87,0.333333333333333,1946,5.44707091469681
"5465",2014,"Wofford",NA,NA,NA,43,55,46,29,0,69,0,26,44,70,14,57,42,10,32,70,17,53,8,0.186046511627907,219,6.39269406392694
"5466",2014,"Wright State",NA,NA,NA,94,123,83,52,0,84,2,65,62,127,52,69,142,35,107,108,26,82,23,0.24468085106383,429,12.1212121212121
"5467",2014,"Xavier",NA,NA,NA,43,83,49,31,0,51,0,35,27,62,26,61,56,10,46,99,29,70,8,0.186046511627907,271,9.59409594095941
"5468",2014,"Yale",NA,NA,NA,35,41,22,12,0,43,0,12,22,34,13,38,58,19,39,43,17,26,12,0.342857142857143,163,7.97546012269939
"5469",2014,"Youngstown State",NA,NA,NA,34,86,49,32,0,51,0,38,28,66,11,52,47,16,31,70,14,56,13,0.382352941176471,252,4.36507936507936
"5470",2015,"Abilene Christian",NA,NA,NA,15,41,26,15,0,30,0,11,9,20,23,51,20,10,10,45,11,34,4,0.266666666666667,145,15.8620689655172
"5471",2015,"Akron",NA,NA,NA,12,20,14,9,0,24,0,10,6,16,11,18,18,4,14,25,9,16,4,0.333333333333333,74,14.8648648648649
"5472",2015,"Alabama",NA,NA,NA,365,745,494,292,0,523,4,226,179,405,256,556,701,252,449,515,132,383,95,0.26027397260274,2388,10.7202680067002
"5473",2015,"Alabama A&M",NA,NA,NA,23,43,22,12,0,36,0,14,21,35,23,44,62,18,44,14,3,11,6,0.260869565217391,150,15.3333333333333
"5474",2015,"Alabama State",NA,NA,NA,38,77,42,22,0,64,0,23,17,40,17,64,68,17,51,48,21,27,9,0.236842105263158,249,6.82730923694779
"5475",2015,"Alabama-Huntsville",NA,NA,NA,3,11,5,5,0,21,0,8,4,12,8,26,11,1,10,17,8,9,0,0,58,13.7931034482759
"5476",2015,"Albany",NA,NA,NA,56,87,60,36,0,73,2,31,22,53,46,73,135,52,83,35,8,27,19,0.339285714285714,316,14.5569620253165
"5477",2015,"Alcorn State",NA,NA,NA,8,21,5,4,0,20,0,4,1,5,7,19,39,11,28,12,4,8,3,0.375,68,10.2941176470588
"5478",2015,"American University",NA,NA,NA,44,105,55,37,0,82,0,47,33,80,41,74,112,41,71,87,29,58,14,0.318181818181818,352,11.6477272727273
"5479",2015,"Appalachian State",NA,NA,NA,19,50,34,24,0,42,0,10,5,15,13,61,74,25,49,25,6,19,5,0.263157894736842,176,7.38636363636364
"5480",2015,"Arizona",NA,NA,NA,382,739,390,253,0,466,1,262,244,506,166,450,982,314,668,278,67,211,96,0.25130890052356,2298,7.2236727589208
"5481",2015,"Arkansas",NA,NA,NA,399,782,461,273,0,516,3,245,181,426,201,392,757,218,539,496,145,351,124,0.31077694235589,2292,8.7696335078534
"5482",2015,"Arkansas State",NA,NA,NA,71,140,63,42,0,106,0,65,42,107,39,95,168,53,115,76,21,55,19,0.267605633802817,458,8.51528384279476
"5483",2015,"Arkansas-Pine Bluff",NA,NA,NA,53,101,48,27,0,76,0,15,45,60,27,97,132,28,104,38,9,29,6,0.113207547169811,306,8.82352941176471
"5484",2015,"Army",NA,NA,NA,14,18,7,5,0,19,0,11,9,20,10,8,31,8,23,14,3,11,6,0.428571428571429,63,15.8730158730159
"5485",2015,"Auburn",NA,NA,NA,409,719,327,186,0,531,2,367,225,592,322,532,754,229,525,394,103,291,110,0.268948655256724,2432,13.2401315789474
"5486",2015,"BYU",NA,NA,NA,35,87,37,24,0,61,1,44,29,73,22,68,80,26,54,57,24,33,12,0.342857142857143,295,7.45762711864407
"5487",2015,"Ball State",NA,NA,NA,33,108,46,33,0,80,2,43,28,71,21,91,45,9,36,62,21,41,10,0.303030303030303,313,6.70926517571885
"5488",2015,"Baylor",NA,NA,NA,513,1055,585,379,0,557,3,526,336,862,278,462,1012,421,591,332,115,217,187,0.364522417153996,3242,8.57495373226404
"5489",2015,"Belmont",NA,NA,NA,40,89,27,17,0,69,0,29,22,51,22,96,71,21,50,85,22,63,6,0.15,302,7.28476821192053
"5490",2015,"Bethune-Cookman",NA,NA,NA,8,11,13,7,0,30,0,6,11,17,7,25,21,3,18,12,2,10,1,0.125,56,12.5
"5491",2015,"Boise State",NA,NA,NA,44,72,40,27,0,53,0,17,28,45,23,49,45,17,28,73,26,47,8,0.181818181818182,236,9.74576271186441
"5492",2015,"Boston College",NA,NA,NA,259,579,224,144,0,444,0,235,225,460,179,435,342,87,255,531,189,342,58,0.223938223938224,1824,9.81359649122807
"5493",2015,"Boston University",NA,NA,NA,25,68,39,22,0,35,1,21,29,50,11,35,30,9,21,46,14,32,6,0.24,183,6.01092896174863
"5494",2015,"Bradley",NA,NA,NA,24,43,38,24,0,43,0,17,20,37,26,46,42,12,30,40,12,28,7,0.291666666666667,163,15.9509202453988
"5495",2015,"Brown",NA,NA,NA,21,42,22,16,0,41,0,20,25,45,22,28,51,20,31,35,7,28,6,0.285714285714286,144,15.2777777777778
"5496",2015,"Bryant",NA,NA,NA,25,16,20,13,0,19,0,15,17,32,6,16,18,2,16,20,9,11,11,0.44,90,6.66666666666667
"5497",2015,"Bucknell",NA,NA,NA,9,23,12,9,0,17,0,11,11,22,6,18,17,8,9,14,3,11,3,0.333333333333333,75,8
"5498",2015,"Buffalo",NA,NA,NA,28,43,33,22,0,41,1,13,24,37,18,27,59,14,45,34,9,25,4,0.142857142857143,142,12.6760563380282
"5499",2015,"Butler",NA,NA,NA,42,103,52,31,0,67,0,24,26,50,18,67,123,48,75,75,31,44,17,0.404761904761905,330,5.45454545454545
"5500",2015,"Cal State Bakersfield",NA,NA,NA,41,96,39,28,0,76,2,31,39,70,39,60,107,33,74,69,19,50,6,0.146341463414634,290,13.448275862069
"5501",2015,"Cal State Northridge",NA,NA,NA,41,68,47,30,0,53,0,29,27,56,30,37,100,30,70,45,14,31,8,0.195121951219512,229,13.1004366812227
"5502",2015,"California",NA,NA,NA,365,834,426,252,0,481,2,420,236,656,243,472,736,255,481,469,152,317,117,0.320547945205479,2589,9.38586326767092
"5503",2015,"Central Arkansas",NA,NA,NA,7,19,1,1,0,10,1,5,5,10,4,25,18,6,12,26,9,17,2,0.285714285714286,71,5.63380281690141
"5504",2015,"Central Connecticut",NA,NA,NA,27,54,14,7,0,41,0,8,11,19,7,40,68,26,42,28,11,17,6,0.222222222222222,168,4.16666666666667
"5505",2015,"Central Michigan",NA,NA,NA,11,25,6,4,0,12,0,0,0,0,6,23,47,16,31,12,2,10,0,0,78,7.69230769230769
"5506",2015,"Charleston",NA,NA,NA,36,39,13,6,0,37,0,12,29,41,16,40,45,10,35,42,7,35,6,0.166666666666667,146,10.958904109589
"5507",2015,"Charleston Southern",NA,NA,NA,10,17,13,7,0,25,0,8,7,15,10,30,18,6,12,22,9,13,4,0.4,82,12.1951219512195
"5508",2015,"Charlotte",NA,NA,NA,58,67,42,30,0,68,0,30,38,68,42,69,109,38,71,50,17,33,8,0.137931034482759,291,14.4329896907216
"5509",2015,"Chattanooga",NA,NA,NA,162,339,162,98,0,166,0,175,110,285,126,190,248,95,153,263,80,183,52,0.320987654320988,1078,11.6883116883117
"5510",2015,"Cincinnati",NA,NA,NA,45,101,41,26,0,69,0,13,17,30,21,76,166,43,123,86,19,67,8,0.177777777777778,304,6.90789473684211
"5511",2015,"Clemson",NA,NA,NA,301,599,335,222,0,554,2,296,272,568,216,456,474,140,334,507,143,364,82,0.272425249169435,1993,10.8379327646764
"5512",2015,"Cleveland State",NA,NA,NA,20,56,24,14,0,27,0,6,7,13,14,38,60,21,39,50,18,32,4,0.2,166,8.43373493975904
"5513",2015,"Colgate",NA,NA,NA,25,56,19,10,0,32,0,6,16,22,5,46,42,15,27,32,6,26,6,0.24,156,3.2051282051282
"5514",2015,"Colorado State",NA,NA,NA,32,75,39,19,0,57,0,34,30,64,20,40,55,25,30,59,21,38,8,0.25,237,8.43881856540084
"5515",2015,"Columbia",NA,NA,NA,13,33,24,18,0,32,0,14,18,32,9,44,26,8,18,16,5,11,1,0.0769230769230769,123,7.31707317073171
"5516",2015,"Concordia Oregon",NA,NA,NA,11,16,9,7,0,11,0,5,14,19,3,15,17,3,14,15,2,13,1,0.0909090909090909,52,5.76923076923077
"5517",2015,"Coppin State",NA,NA,NA,76,149,81,46,0,123,1,58,49,107,45,125,189,42,147,37,15,22,19,0.25,481,9.35550935550936
"5518",2015,"Cornell",NA,NA,NA,28,68,33,18,0,39,0,24,36,60,18,33,96,26,70,24,6,18,9,0.321428571428571,192,9.375
"5519",2015,"Creighton",NA,NA,NA,50,101,41,28,0,86,0,37,32,69,39,54,143,42,101,112,42,70,15,0.3,337,11.5727002967359
"5520",2015,"Dartmouth",NA,NA,NA,9,31,21,14,0,28,0,5,16,21,14,24,53,16,37,35,11,24,3,0.333333333333333,101,13.8613861386139
"5521",2015,"Davidson",NA,NA,NA,35,105,20,11,0,76,0,34,31,65,26,88,95,26,69,73,25,48,11,0.314285714285714,317,8.2018927444795
"5522",2015,"Dayton",NA,NA,NA,130,340,176,119,0,249,1,129,103,232,76,214,273,91,182,198,70,128,44,0.338461538461538,1016,7.48031496062992
"5523",2015,"Delaware State",NA,NA,NA,34,63,39,26,0,64,0,36,33,69,23,49,68,15,53,35,11,24,12,0.352941176470588,215,10.6976744186047
"5524",2015,"Denver",NA,NA,NA,8,25,6,3,0,20,0,6,0,6,4,17,25,8,17,25,6,19,2,0.25,70,5.71428571428571
"5525",2015,"Detroit Mercy",NA,NA,NA,10,23,9,4,0,11,0,12,11,23,9,19,16,2,14,19,7,12,1,0.1,73,12.3287671232877
"5526",2015,"Drake",NA,NA,NA,69,107,48,30,0,80,1,47,24,71,41,61,93,33,60,124,39,85,21,0.304347826086957,366,11.2021857923497
"5527",2015,"Drexel",NA,NA,NA,28,62,25,16,0,54,0,21,18,39,20,51,72,26,46,46,14,32,7,0.25,206,9.70873786407767
"5528",2015,"Duke",NA,NA,NA,464,903,460,284,0,473,2,399,245,644,272,553,691,247,444,402,132,270,144,0.310344827586207,2798,9.72122944960686
"5529",2015,"Duquesne",NA,NA,NA,64,127,64,44,0,87,0,53,47,100,35,81,115,36,79,80,32,48,20,0.3125,408,8.57843137254902
"5530",2015,"East Carolina",NA,NA,NA,84,109,67,41,0,128,2,47,44,91,65,116,174,44,130,90,28,62,19,0.226190476190476,446,14.5739910313901
"5531",2015,"East Tennessee State",NA,NA,NA,74,124,55,36,0,100,0,61,39,100,39,108,130,48,82,108,25,83,26,0.351351351351351,452,8.6283185840708
"5532",2015,"Eastern Illinois",NA,NA,NA,13,40,24,14,0,40,0,18,19,37,9,52,33,14,19,17,5,12,4,0.307692307692308,145,6.20689655172414
"5533",2015,"Eastern Kentucky",NA,NA,NA,9,29,13,6,0,24,0,3,5,8,6,19,28,6,22,15,5,10,2,0.222222222222222,74,8.10810810810811
"5534",2015,"Eastern Michigan",NA,NA,NA,109,202,86,50,0,103,0,87,69,156,84,108,210,79,131,116,32,84,36,0.330275229357798,635,13.2283464566929
"5535",2015,"Eastern University",NA,NA,NA,9,24,14,7,0,19,0,9,12,21,11,31,19,6,13,23,9,14,3,0.333333333333333,89,12.3595505617978
"5536",2015,"Eastern Washington",NA,NA,NA,44,111,50,30,0,67,2,33,24,57,24,79,94,34,60,74,24,50,10,0.227272727272727,336,7.14285714285714
"5537",2015,"Elon",NA,NA,NA,31,66,22,12,0,61,0,25,29,54,23,64,48,14,34,72,18,54,7,0.225806451612903,220,10.4545454545455
"5538",2015,"Evansville",NA,NA,NA,40,72,40,20,1,45,0,32,37,69,33,51,66,18,48,44,14,30,9,0.225,237,13.9240506329114
"5539",2015,"Fairfield",NA,NA,NA,23,38,17,10,1,32,0,12,5,17,10,34,56,19,37,35,13,22,7,0.304347826086957,145,6.89655172413793
"5540",2015,"Florida",NA,NA,NA,399,673,338,217,0,572,1,327,270,597,313,563,635,201,434,431,122,309,93,0.233082706766917,2356,13.2852292020374
"5541",2015,"Florida A&M",NA,NA,NA,13,21,17,9,0,19,0,3,2,5,5,22,27,5,22,14,6,8,3,0.230769230769231,74,6.75675675675676
"5542",2015,"Florida International",NA,NA,NA,38,51,22,14,0,17,0,21,34,55,9,40,51,12,39,23,5,18,10,0.263157894736842,170,5.29411764705882
"5543",2015,"Florida State",NA,NA,NA,592,943,528,312,0,621,4,525,356,881,311,594,756,268,488,583,207,376,199,0.336148648648649,3251,9.56628729621655
"5544",2015,"Fordham",NA,NA,NA,64,113,50,33,0,94,0,42,43,85,29,75,135,46,89,79,24,55,8,0.125,371,7.8167115902965
"5545",2015,"Fresno State",NA,NA,NA,40,81,60,38,0,78,2,47,49,96,37,64,46,13,33,72,27,45,9,0.225,283,13.0742049469965
"5546",2015,"Furman",NA,NA,NA,65,142,74,46,0,104,1,65,65,130,30,97,85,35,50,122,36,86,19,0.292307692307692,457,6.56455142231947
"5547",2015,"Gardner-Webb",NA,NA,NA,14,24,18,9,0,13,0,14,21,35,6,26,16,6,10,10,1,9,2,0.142857142857143,89,6.74157303370786
"5548",2015,"George Mason",NA,NA,NA,15,24,9,5,0,17,0,10,13,23,7,23,21,4,17,13,3,10,3,0.2,79,8.86075949367089
"5549",2015,"George Washington",NA,NA,NA,245,414,173,106,0,237,1,165,142,307,122,239,457,164,293,153,54,99,71,0.289795918367347,1321,9.23542770628312
"5550",2015,"Georgetown",NA,NA,NA,22,27,7,4,0,21,0,5,6,11,10,16,55,10,45,7,2,5,4,0.181818181818182,83,12.0481927710843
"5551",2015,"Georgia",NA,NA,NA,420,778,406,253,0,522,4,321,196,517,302,500,728,176,552,510,142,368,88,0.20952380952381,2418,12.4896608767577
"5552",2015,"Georgia Southern",NA,NA,NA,4,25,3,1,0,19,0,3,2,5,5,32,22,6,16,25,11,14,2,0.5,82,6.09756097560976
"5553",2015,"Georgia Tech",NA,NA,NA,496,772,411,274,0,532,2,351,260,611,240,482,713,254,459,566,173,393,156,0.314516129032258,2610,9.19540229885057
"5554",2015,"Gonzaga",NA,NA,NA,84,185,90,67,0,123,0,72,56,128,60,126,150,52,98,108,40,68,27,0.321428571428571,584,10.2739726027397
"5555",2015,"Grambling",NA,NA,NA,67,136,61,35,0,109,0,59,62,121,65,143,151,44,107,124,30,94,18,0.26865671641791,495,13.1313131313131
"5556",2015,"Grand Canyon",NA,NA,NA,16,22,8,6,0,13,0,4,9,13,4,19,19,6,13,25,7,18,3,0.1875,75,5.33333333333333
"5557",2015,"Hampton",NA,NA,NA,117,164,104,56,0,132,1,62,60,122,77,127,194,47,147,152,37,115,28,0.239316239316239,575,13.3913043478261
"5558",2015,"Hartford",NA,NA,NA,26,63,35,23,0,54,0,14,16,30,23,57,61,21,40,73,30,43,7,0.269230769230769,217,10.5990783410138
"5559",2015,"Harvard",NA,NA,NA,33,67,20,13,0,58,0,23,29,52,22,60,76,22,54,63,12,51,10,0.303030303030303,220,10
"5560",2015,"Hawai'i",NA,NA,NA,81,124,83,58,0,115,0,52,46,98,31,77,163,47,116,71,23,48,24,0.296296296296296,419,7.39856801909308
"5561",2015,"High Point",NA,NA,NA,17,56,11,7,0,35,0,19,16,35,10,39,44,14,30,38,14,24,5,0.294117647058824,162,6.17283950617284
"5562",2015,"Hofstra",NA,NA,NA,45,106,47,34,0,77,1,43,39,82,22,64,83,22,61,65,17,48,11,0.244444444444444,310,7.09677419354839
"5563",2015,"Holy Cross",NA,NA,NA,18,55,27,18,0,42,0,12,28,40,14,35,34,10,24,39,12,27,4,0.222222222222222,146,9.58904109589041
"5564",2015,"Houston",NA,NA,NA,44,75,41,24,0,69,0,25,29,54,17,65,95,22,73,71,19,52,5,0.113636363636364,260,6.53846153846154
"5565",2015,"Houston Christian",NA,NA,NA,61,101,67,37,0,78,0,50,48,98,23,65,92,28,64,39,15,24,8,0.131147540983607,335,6.86567164179105
"5566",2015,"Howard",NA,NA,NA,39,58,20,10,0,50,0,10,5,15,19,58,88,21,67,49,12,37,3,0.0769230769230769,204,9.31372549019608
"5567",2015,"IUPUI",NA,NA,NA,43,67,37,22,0,60,0,34,40,74,14,64,57,25,32,35,7,28,16,0.372093023255814,249,5.62248995983936
"5568",2015,"Idaho",NA,NA,NA,24,53,19,12,0,29,0,14,30,44,10,28,37,14,23,51,16,35,5,0.208333333333333,151,6.62251655629139
"5569",2015,"Idaho State",NA,NA,NA,29,46,21,10,0,35,0,17,23,40,12,46,48,6,42,24,4,20,5,0.172413793103448,152,7.89473684210526
"5570",2015,"Illinois",NA,NA,NA,349,648,323,194,1,519,1,293,168,461,318,467,720,210,510,585,183,402,99,0.283667621776504,2225,14.2921348314607
"5571",2015,"Illinois State",NA,NA,NA,29,76,41,23,0,57,0,21,27,48,15,60,77,27,50,37,6,31,5,0.172413793103448,229,6.55021834061135
"5572",2015,"Incarnate Word",NA,NA,NA,26,34,8,4,0,34,0,16,14,30,19,36,74,21,53,20,5,15,8,0.307692307692308,140,13.5714285714286
"5573",2015,"Indiana",NA,NA,NA,308,736,364,245,0,486,1,380,344,724,224,397,329,124,205,639,207,432,87,0.282467532467532,2234,10.0268576544315
"5574",2015,"Indiana State",NA,NA,NA,14,34,18,11,0,17,0,8,10,18,16,17,34,11,23,16,4,12,5,0.357142857142857,92,17.3913043478261
"5575",2015,"Iona",NA,NA,NA,23,32,13,12,0,34,0,11,20,31,20,38,34,11,23,45,14,31,6,0.260869565217391,132,15.1515151515152
"5576",2015,"Iowa",NA,NA,NA,341,762,413,274,0,490,0,427,159,586,214,419,689,199,490,597,241,356,97,0.284457478005865,2492,8.58747993579454
"5577",2015,"Iowa State",NA,NA,NA,353,856,378,263,0,468,1,279,127,406,159,387,597,181,416,799,269,530,101,0.286118980169972,2402,6.61948376353039
"5578",2015,"Jackson State",NA,NA,NA,17,31,9,5,0,19,0,6,5,11,17,35,29,9,20,16,2,14,4,0.235294117647059,101,16.8316831683168
"5579",2015,"Jacksonville",NA,NA,NA,74,142,73,44,0,114,2,57,74,131,29,135,113,31,82,61,19,42,17,0.22972972972973,468,6.1965811965812
"5580",2015,"Jacksonville State",NA,NA,NA,25,42,16,10,0,42,0,8,7,15,8,20,68,24,44,37,15,22,9,0.36,138,5.79710144927536
"5581",2015,"James Madison",NA,NA,NA,128,191,105,71,0,135,1,86,71,157,48,95,224,66,158,127,37,90,42,0.328125,632,7.59493670886076
"5582",2015,"Kansas",NA,NA,NA,317,839,374,251,0,553,1,316,251,567,190,562,560,202,358,555,198,357,91,0.287066246056782,2512,7.56369426751592
"5583",2015,"Kansas City",NA,NA,NA,8,19,3,2,0,13,0,2,3,5,9,25,29,10,19,13,3,10,3,0.375,67,13.4328358208955
"5584",2015,"Kansas State",NA,NA,NA,340,660,430,246,0,430,3,340,323,663,345,448,436,131,305,535,153,382,96,0.282352941176471,2153,16.0241523455643
"5585",2015,"Kennesaw State",NA,NA,NA,30,38,29,21,0,40,0,18,24,42,11,40,32,9,23,31,7,24,6,0.2,151,7.28476821192053
"5586",2015,"Kent St Tuscarawas",NA,NA,NA,4,18,2,2,0,9,0,0,7,7,1,32,12,3,9,38,10,28,1,0.25,67,1.49253731343284
"5587",2015,"Kent State",NA,NA,NA,17,26,14,9,0,26,0,7,8,15,9,27,31,16,15,8,3,5,4,0.235294117647059,98,9.18367346938776
"5588",2015,"Lafayette",NA,NA,NA,4,24,8,6,0,24,0,7,2,9,3,22,19,5,14,21,9,12,2,0.5,72,4.16666666666667
"5589",2015,"Lamar",NA,NA,NA,44,69,32,19,0,51,0,43,44,87,31,51,43,10,33,72,23,49,17,0.386363636363636,244,12.7049180327869
"5590",2015,"Lehigh",NA,NA,NA,25,46,24,15,0,29,1,22,21,43,7,35,39,12,27,25,7,18,4,0.16,153,4.57516339869281
"5591",2015,"Liberty",NA,NA,NA,72,121,54,36,0,107,0,33,34,67,37,85,150,55,95,92,27,65,17,0.236111111111111,406,9.11330049261084
"5592",2015,"Lipscomb",NA,NA,NA,10,25,7,3,0,20,0,6,9,15,4,24,17,6,11,23,7,16,1,0.1,79,5.06329113924051
"5593",2015,"Little Rock",NA,NA,NA,46,96,62,42,0,92,1,56,38,94,42,63,120,51,69,57,20,37,11,0.239130434782609,351,11.965811965812
"5594",2015,"Long Beach State",NA,NA,NA,23,34,21,13,0,33,1,20,18,38,24,25,44,13,31,37,11,26,8,0.347826086956522,132,18.1818181818182
"5595",2015,"Longwood",NA,NA,NA,61,110,45,28,0,92,0,29,58,87,31,95,106,38,68,99,25,74,14,0.229508196721311,369,8.40108401084011
"5596",2015,"Louisiana",NA,NA,NA,23,42,24,17,0,29,0,24,10,34,23,25,54,15,39,29,5,24,4,0.173913043478261,141,16.3120567375887
"5597",2015,"Louisiana Tech",NA,NA,NA,63,96,67,46,0,87,0,34,36,70,32,62,113,30,83,77,22,55,11,0.174603174603175,317,10.0946372239748
"5598",2015,"Louisville",NA,NA,NA,514,860,538,325,0,589,7,515,314,829,348,473,843,261,582,400,124,276,151,0.293774319066148,2871,12.1212121212121
"5599",2015,"Loyola Chicago",NA,NA,NA,41,105,68,37,0,80,1,32,35,67,34,81,103,26,77,42,18,24,5,0.121951219512195,311,10.9324758842444
"5600",2015,"Loyola Maryland",NA,NA,NA,27,40,12,7,0,23,0,17,23,40,16,33,47,6,41,30,11,19,5,0.185185185185185,136,11.7647058823529
"5601",2015,"Loyola Marymount",NA,NA,NA,36,72,39,22,0,62,0,35,25,60,15,62,66,16,50,50,14,36,10,0.277777777777778,242,6.19834710743802
"5602",2015,"Maine",NA,NA,NA,9,24,10,7,0,11,0,8,11,19,1,12,24,11,13,9,4,5,3,0.333333333333333,71,1.40845070422535
"5603",2015,"Marist",NA,NA,NA,27,73,32,20,0,47,0,25,17,42,10,33,65,21,44,66,17,49,8,0.296296296296296,205,4.8780487804878
"5604",2015,"Marquette",NA,NA,NA,92,141,76,53,0,127,0,50,55,105,29,124,133,42,91,128,33,95,19,0.206521739130435,492,5.89430894308943
"5605",2015,"Marshall",NA,NA,NA,40,98,51,28,0,65,0,57,50,107,26,59,43,16,27,80,28,52,14,0.35,308,8.44155844155844
"5606",2015,"Maryland",NA,NA,NA,514,886,443,304,0,483,1,440,244,684,270,497,858,342,516,508,175,333,174,0.33852140077821,2952,9.14634146341463
"5607",2015,"Maryland-Eastern Shore",NA,NA,NA,39,64,41,20,0,48,1,29,48,77,22,52,16,3,13,69,21,48,8,0.205128205128205,213,10.3286384976526
"5608",2015,"McNeese",NA,NA,NA,37,68,30,22,0,44,0,29,28,57,18,44,79,19,60,49,14,35,6,0.162162162162162,218,8.25688073394496
"5609",2015,"Memphis",NA,NA,NA,64,83,28,16,0,72,0,29,19,48,28,70,121,24,97,88,15,73,13,0.203125,290,9.6551724137931
"5610",2015,"Mercer",NA,NA,NA,111,169,86,57,0,108,0,43,62,105,41,105,249,95,154,69,20,49,38,0.342342342342342,573,7.15532286212914
"5611",2015,"Miami",NA,NA,NA,448,801,447,274,0,602,0,296,206,502,293,452,803,274,529,669,211,458,109,0.243303571428571,2584,11.3390092879257
"5612",2015,"Miami (OH)",NA,NA,NA,9,19,18,10,0,16,0,11,18,29,9,20,7,0,7,12,1,11,3,0.333333333333333,63,14.2857142857143
"5613",2015,"Michigan",NA,NA,NA,406,701,283,192,0,467,0,346,268,614,257,463,745,284,461,473,169,304,129,0.317733990147783,2424,10.6023102310231
"5614",2015,"Michigan State",NA,NA,NA,378,857,379,247,0,487,1,317,282,599,183,510,534,197,337,584,180,404,113,0.298941798941799,2519,7.26478761413259
"5615",2015,"Middle Tennessee",NA,NA,NA,147,211,147,83,0,161,0,130,94,224,100,137,119,26,93,206,56,150,35,0.238095238095238,741,13.4952766531714
"5616",2015,"Milwaukee",NA,NA,NA,14,44,14,9,0,34,0,22,24,46,13,30,24,7,17,48,13,35,5,0.357142857142857,133,9.77443609022556
"5617",2015,"Minnesota",NA,NA,NA,343,728,346,227,0,373,0,211,155,366,161,387,765,314,451,478,143,335,118,0.34402332361516,2201,7.31485688323489
"5618",2015,"Mississippi Valley State",NA,NA,NA,41,98,41,27,0,83,2,25,26,51,30,131,87,16,71,48,9,39,9,0.219512195121951,324,9.25925925925926
"5619",2015,"Missouri",NA,NA,NA,369,863,354,212,0,573,1,320,198,518,195,489,498,132,366,689,222,467,119,0.322493224932249,2474,7.88197251414713
"5620",2015,"Missouri State",NA,NA,NA,104,163,94,51,0,118,0,45,63,108,38,110,160,52,108,141,48,93,16,0.153846153846154,535,7.10280373831776
"5621",2015,"Montana",NA,NA,NA,40,67,24,13,0,54,0,8,6,14,18,40,122,54,68,45,7,38,11,0.275,221,8.1447963800905
"5622",2015,"Montana State",NA,NA,NA,10,30,12,8,0,15,0,8,13,21,4,25,24,10,14,16,4,12,1,0.1,90,4.44444444444444
"5623",2015,"Morehead State",NA,NA,NA,24,55,29,13,0,42,0,20,22,42,7,42,51,21,30,32,6,26,4,0.166666666666667,173,4.04624277456647
"5624",2015,"Morgan State",NA,NA,NA,67,96,65,43,0,90,0,44,54,98,58,89,133,31,102,76,17,59,12,0.17910447761194,360,16.1111111111111
"5625",2015,"Mount St. Mary's",NA,NA,NA,16,39,28,13,0,40,0,13,10,23,10,46,45,12,33,33,13,20,3,0.1875,143,6.99300699300699
"5626",2015,"Murray State",NA,NA,NA,12,32,5,1,0,19,0,3,0,3,5,20,40,12,28,26,4,22,2,0.166666666666667,83,6.02409638554217
"5627",2015,"NC State",NA,NA,NA,320,707,403,279,0,483,5,268,240,508,248,391,514,164,350,615,199,416,78,0.24375,2130,11.6431924882629
"5628",2015,"NJIT",NA,NA,NA,24,51,20,11,0,33,1,16,12,28,10,38,53,11,42,26,11,15,6,0.25,155,6.45161290322581
"5629",2015,"Nebraska",NA,NA,NA,348,931,332,223,0,408,0,263,178,441,188,428,906,349,557,572,172,400,112,0.32183908045977,2553,7.36388562475519
"5630",2015,"Nevada",NA,NA,NA,28,49,32,20,0,36,0,25,19,44,10,43,45,11,34,22,6,16,11,0.392857142857143,168,5.95238095238095
"5631",2015,"New Hampshire",NA,NA,NA,20,48,35,21,0,40,0,23,10,33,12,25,38,14,24,30,4,26,5,0.25,139,8.63309352517986
"5632",2015,"New Mexico",NA,NA,NA,108,183,112,65,0,161,0,75,67,142,57,130,205,60,145,90,25,65,35,0.324074074074074,603,9.45273631840796
"5633",2015,"New Mexico State",NA,NA,NA,13,55,24,16,0,33,0,20,14,34,17,29,32,10,22,40,14,26,5,0.384615384615385,146,11.6438356164384
"5634",2015,"New Orleans",NA,NA,NA,14,31,26,14,0,55,1,9,9,18,12,42,58,17,41,27,7,20,4,0.285714285714286,129,9.30232558139535
"5635",2015,"Niagara",NA,NA,NA,17,28,12,5,0,20,1,6,5,11,4,19,32,8,24,17,7,10,5,0.294117647058824,85,4.70588235294118
"5636",2015,"Nicholls",NA,NA,NA,16,39,26,13,0,40,0,13,16,29,23,33,42,11,31,40,12,28,9,0.5625,126,18.2539682539683
"5637",2015,"Norfolk State",NA,NA,NA,7,23,6,4,0,20,0,9,10,19,6,14,25,9,16,16,2,14,3,0.428571428571429,65,9.23076923076923
"5638",2015,"North Carolina",NA,NA,NA,476,859,501,301,0,600,1,206,142,348,317,493,1125,467,658,645,203,442,149,0.313025210084034,2817,11.2531061412851
"5639",2015,"North Carolina A&T",NA,NA,NA,13,18,5,3,0,16,0,3,5,8,6,21,28,3,25,25,7,18,3,0.230769230769231,67,8.95522388059701
"5640",2015,"North Carolina Central",NA,NA,NA,36,87,39,22,0,72,0,22,29,51,20,104,86,17,69,44,11,33,7,0.194444444444444,284,7.04225352112676
"5641",2015,"North Dakota",NA,NA,NA,59,103,71,41,0,66,0,57,56,113,31,80,54,9,45,48,14,34,12,0.203389830508475,336,9.22619047619048
"5642",2015,"North Dakota State",NA,NA,NA,22,36,35,23,0,40,0,23,17,40,23,32,50,14,36,27,7,20,6,0.272727272727273,138,16.6666666666667
"5643",2015,"North Florida",NA,NA,NA,51,111,58,34,0,83,1,27,44,71,33,102,114,32,82,63,17,46,8,0.156862745098039,347,9.51008645533141
"5644",2015,"North Texas",NA,NA,NA,24,53,19,12,0,36,2,16,20,36,17,63,59,11,48,17,2,15,10,0.416666666666667,171,9.94152046783626
"5645",2015,"Northeastern",NA,NA,NA,15,52,28,19,0,37,0,22,14,36,10,36,33,8,25,44,16,28,5,0.333333333333333,156,6.41025641025641
"5646",2015,"Northern Colorado",NA,NA,NA,29,66,39,23,0,50,0,19,17,36,21,42,65,23,42,55,15,40,5,0.172413793103448,204,10.2941176470588
"5647",2015,"Northern Illinois",NA,NA,NA,6,19,5,3,0,15,0,7,7,14,8,12,20,5,15,18,5,13,1,0.166666666666667,56,14.2857142857143
"5648",2015,"Northern Iowa",NA,NA,NA,19,51,16,13,0,38,0,16,16,32,7,30,41,10,31,38,11,27,8,0.421052631578947,142,4.92957746478873
"5649",2015,"Northern Kentucky",NA,NA,NA,27,107,51,35,0,81,0,34,20,54,19,81,53,19,34,91,34,57,6,0.222222222222222,313,6.0702875399361
"5650",2015,"Northwestern State",NA,NA,NA,61,161,35,25,0,85,0,31,57,88,32,90,135,41,94,170,42,128,12,0.19672131147541,432,7.40740740740741
"5651",2015,"Notre Dame",NA,NA,NA,499,1077,559,383,0,533,0,661,424,1085,350,560,734,281,453,476,182,294,167,0.334669338677355,3406,10.2759835584263
"5652",2015,"Oakland",NA,NA,NA,36,80,28,16,0,48,0,28,37,65,22,54,64,19,45,61,20,41,17,0.472222222222222,242,9.09090909090909
"5653",2015,"Oakland City",NA,NA,NA,10,19,2,2,0,14,0,5,10,15,7,22,21,4,17,19,6,13,1,0.1,66,10.6060606060606
"5654",2015,"Ohio",NA,NA,NA,25,49,20,12,0,31,1,17,17,34,14,34,18,4,14,49,17,32,6,0.24,150,9.33333333333333
"5655",2015,"Oklahoma State",NA,NA,NA,428,857,352,209,0,457,1,333,256,589,288,430,898,317,581,362,127,235,119,0.27803738317757,2575,11.1844660194175
"5656",2015,"Old Dominion",NA,NA,NA,66,156,68,36,0,88,0,56,40,96,36,105,175,58,117,125,47,78,19,0.287878787878788,501,7.18562874251497
"5657",2015,"Ole Miss",NA,NA,NA,499,737,519,303,0,691,6,412,350,762,346,552,594,178,416,566,149,417,134,0.268537074148297,2635,13.1309297912713
"5658",2015,"Oral Roberts",NA,NA,NA,70,180,62,40,0,115,1,58,54,112,29,133,138,31,107,80,25,55,21,0.3,509,5.69744597249509
"5659",2015,"Oregon State",NA,NA,NA,344,859,314,195,0,420,2,336,262,598,153,406,406,175,231,641,239,402,103,0.299418604651163,2427,6.30407911001236
"5660",2015,"Pacific",NA,NA,NA,51,105,70,43,0,83,2,49,39,88,31,57,77,29,48,85,37,48,14,0.274509803921569,342,9.06432748538012
"5661",2015,"Penn State",NA,NA,NA,349,714,350,203,0,505,2,345,297,642,185,490,663,213,450,253,66,187,100,0.286532951289398,2251,8.21856952465571
"5662",2015,"Pennsylvania",NA,NA,NA,43,91,48,29,0,50,0,35,46,81,14,55,95,29,66,45,12,33,10,0.232558139534884,279,5.0179211469534
"5663",2015,"Pepperdine",NA,NA,NA,22,43,11,7,0,40,0,16,3,19,9,30,74,23,51,45,15,30,10,0.454545454545455,153,5.88235294117647
"5664",2015,"Pittsburgh",NA,NA,NA,396,830,358,224,0,462,2,324,256,580,226,426,661,214,447,583,183,400,113,0.285353535353535,2451,9.22072623419013
"5665",2015,"Portland",NA,NA,NA,57,122,55,37,0,91,0,50,49,99,20,88,96,27,69,73,23,50,12,0.210526315789474,381,5.249343832021
"5666",2015,"Portland State",NA,NA,NA,10,23,12,8,0,19,0,7,8,15,8,19,17,6,11,18,4,14,1,0.1,72,11.1111111111111
"5667",2015,"Prairie View A&M",NA,NA,NA,65,97,69,42,0,96,1,29,37,66,24,88,126,28,98,95,22,73,13,0.2,343,6.99708454810496
"5668",2015,"Princeton",NA,NA,NA,222,571,220,142,0,281,0,329,197,526,140,271,296,111,185,274,105,169,72,0.324324324324324,1662,8.42358604091456
"5669",2015,"Providence",NA,NA,NA,33,38,24,12,0,48,0,13,25,38,21,34,53,19,34,39,13,26,11,0.333333333333333,155,13.5483870967742
"5670",2015,"Purdue Fort Wayne",NA,NA,NA,36,71,30,19,0,58,0,18,15,33,11,77,47,11,36,75,20,55,8,0.222222222222222,238,4.6218487394958
"5671",2015,"Quinnipiac",NA,NA,NA,36,95,70,46,0,86,0,39,52,91,25,55,63,21,42,86,29,57,7,0.194444444444444,291,8.59106529209622
"5672",2015,"Radford",NA,NA,NA,55,104,57,34,0,84,0,42,38,80,19,89,73,19,54,60,12,48,16,0.290909090909091,332,5.72289156626506
"5673",2015,"Rhode Island",NA,NA,NA,10,23,14,6,0,21,0,12,12,24,9,21,8,2,6,17,3,14,2,0.2,75,12
"5674",2015,"Rice",NA,NA,NA,42,45,17,10,0,37,0,12,25,37,9,28,81,22,59,26,8,18,6,0.142857142857143,158,5.69620253164557
"5675",2015,"Richmond",NA,NA,NA,34,72,46,29,0,53,0,30,34,64,26,42,74,26,48,44,20,24,13,0.382352941176471,235,11.063829787234
"5676",2015,"Rider",NA,NA,NA,12,32,18,8,0,17,0,11,10,21,4,31,18,7,11,8,0,8,1,0.0833333333333333,97,4.12371134020619
"5677",2015,"Robert Morris",NA,NA,NA,24,64,37,17,0,63,0,22,8,30,14,53,63,18,45,67,24,43,6,0.25,215,6.51162790697674
"5678",2015,"SE Louisiana",NA,NA,NA,39,105,34,18,0,70,0,26,23,49,31,83,96,31,65,86,17,69,9,0.230769230769231,307,10.0977198697068
"5679",2015,"SIU Edwardsville",NA,NA,NA,16,28,16,10,0,18,0,8,4,12,7,25,27,6,21,21,4,17,1,0.0625,91,7.69230769230769
"5680",2015,"SMU",NA,NA,NA,99,170,76,44,0,140,1,51,62,113,40,153,169,43,126,119,28,91,21,0.212121212121212,556,7.19424460431655
"5681",2015,"Sacramento State",NA,NA,NA,137,145,102,57,0,136,0,82,93,175,106,113,102,33,69,281,90,191,41,0.299270072992701,628,16.8789808917197
"5682",2015,"Saint Joseph's",NA,NA,NA,30,35,23,13,0,34,0,10,17,27,7,37,58,20,38,25,8,17,6,0.2,144,4.86111111111111
"5683",2015,"Saint Louis",NA,NA,NA,34,91,45,30,0,67,0,42,36,78,32,55,64,16,48,100,32,68,7,0.205882352941176,283,11.3074204946996
"5684",2015,"Saint Mary's",NA,NA,NA,73,224,147,98,0,118,1,90,101,191,45,128,78,36,42,81,30,51,23,0.315068493150685,616,7.3051948051948
"5685",2015,"Sam Houston",NA,NA,NA,21,37,20,11,0,32,0,8,11,19,23,50,34,11,23,40,15,25,5,0.238095238095238,144,15.9722222222222
"5686",2015,"Samford",NA,NA,NA,40,143,54,36,0,98,1,46,51,97,31,130,62,17,45,90,26,64,9,0.225,413,7.50605326876513
"5687",2015,"San Diego",NA,NA,NA,34,50,39,21,0,38,0,25,13,38,14,33,56,22,34,21,10,11,9,0.264705882352941,183,7.65027322404372
"5688",2015,"San Diego State",NA,NA,NA,35,65,28,16,0,41,0,22,26,48,18,60,75,23,52,34,10,24,5,0.142857142857143,221,8.1447963800905
"5689",2015,"San Francisco",NA,NA,NA,56,69,42,26,0,54,2,39,30,69,18,49,74,20,54,47,12,35,18,0.321428571428571,253,7.11462450592885
"5690",2015,"San José State",NA,NA,NA,45,82,67,43,0,61,0,27,45,72,36,32,84,20,64,92,33,59,14,0.311111111111111,250,14.4
"5691",2015,"Savannah State",NA,NA,NA,82,117,79,42,0,152,1,77,61,138,64,119,165,52,113,90,22,68,14,0.170731707317073,482,13.2780082987552
"5692",2015,"Seattle U",NA,NA,NA,22,49,26,16,0,31,0,13,30,43,13,37,36,9,27,31,12,19,2,0.0909090909090909,147,8.84353741496599
"5693",2015,"Seton Hall",NA,NA,NA,120,262,134,84,0,203,3,125,127,252,114,138,189,66,123,194,64,130,31,0.258333333333333,800,14.25
"5694",2015,"Siena",NA,NA,NA,42,81,41,27,0,43,0,46,47,93,24,46,35,8,27,40,13,27,14,0.333333333333333,247,9.7165991902834
"5695",2015,"South Alabama",NA,NA,NA,11,19,21,13,0,24,0,10,17,27,9,31,6,1,5,11,2,9,3,0.272727272727273,77,11.6883116883117
"5696",2015,"South Carolina",NA,NA,NA,481,941,547,339,0,512,1,424,204,628,287,495,883,380,503,457,162,295,170,0.353430353430353,3026,9.48446794448116
"5697",2015,"South Carolina State",NA,NA,NA,19,23,9,6,0,19,0,10,14,24,8,16,23,4,19,15,7,8,3,0.157894736842105,82,9.75609756097561
"5698",2015,"South Carolina Upstate",NA,NA,NA,42,90,47,31,0,85,0,25,5,30,24,76,160,51,109,56,20,36,10,0.238095238095238,316,7.59493670886076
"5699",2015,"South Dakota",NA,NA,NA,62,108,64,47,0,85,0,35,34,69,23,71,103,30,73,68,21,47,13,0.209677419354839,344,6.68604651162791
"5700",2015,"South Dakota State",NA,NA,NA,28,79,44,32,0,68,0,36,29,65,17,41,53,23,30,49,15,34,4,0.142857142857143,230,7.39130434782609
"5701",2015,"South Florida",NA,NA,NA,200,335,184,122,0,232,0,122,122,244,73,178,335,113,222,229,71,158,52,0.26,1064,6.8609022556391
"5702",2015,"Southeast Missouri State",NA,NA,NA,27,49,24,13,0,34,0,16,20,36,19,47,35,7,28,33,11,22,5,0.185185185185185,159,11.9496855345912
"5703",2015,"Southern",NA,NA,NA,66,129,84,51,0,121,0,33,28,61,48,125,174,46,128,91,22,69,18,0.272727272727273,432,11.1111111111111
"5704",2015,"Southern Miss",NA,NA,NA,107,207,112,67,0,145,0,51,45,96,75,155,257,125,132,117,37,80,32,0.299065420560748,706,10.6232294617564
"5705",2015,"St. Bonaventure",NA,NA,NA,22,50,25,15,0,27,0,16,31,47,13,31,35,7,28,33,13,20,5,0.227272727272727,147,8.84353741496599
"5706",2015,"St. Francis (PA)",NA,NA,NA,66,104,44,25,0,101,1,33,42,75,25,88,102,31,71,128,28,100,18,0.272727272727273,355,7.04225352112676
"5707",2015,"St. Francis Brooklyn",NA,NA,NA,34,58,12,9,0,36,0,18,24,42,22,42,61,21,40,72,25,47,12,0.352941176470588,199,11.0552763819095
"5708",2015,"St. John's",NA,NA,NA,97,212,112,71,0,104,1,68,57,125,40,119,268,107,161,53,14,39,29,0.298969072164948,643,6.2208398133748
"5709",2015,"St. Martins",NA,NA,NA,11,22,12,7,0,18,0,2,9,11,4,15,23,4,19,16,5,11,2,0.181818181818182,60,6.66666666666667
"5710",2015,"Stanford",NA,NA,NA,402,902,407,270,0,501,0,317,246,563,199,421,773,295,478,597,223,374,128,0.318407960199005,2640,7.53787878787879
"5711",2015,"Stanislaus State",NA,NA,NA,10,24,17,10,0,18,0,11,7,18,6,19,20,6,14,16,6,10,4,0.4,78,7.69230769230769
"5712",2015,"Stephen F. Austin",NA,NA,NA,57,74,55,36,0,81,0,55,33,88,39,68,97,30,67,60,20,40,26,0.456140350877193,314,12.4203821656051
"5713",2015,"Stetson",NA,NA,NA,30,71,25,18,0,57,0,36,37,73,28,65,30,4,26,71,17,54,8,0.266666666666667,228,12.280701754386
"5714",2015,"Stony Brook",NA,NA,NA,28,70,32,20,0,53,0,17,14,31,10,40,67,19,48,59,17,42,7,0.25,196,5.10204081632653
"5715",2015,"Syracuse",NA,NA,NA,471,662,427,263,0,469,2,308,258,566,311,391,554,168,386,720,203,517,127,0.26963906581741,2282,13.6283961437336
"5716",2015,"TCU",NA,NA,NA,341,698,357,252,0,528,2,288,266,554,312,480,590,221,369,631,217,414,85,0.249266862170088,2312,13.4948096885813
"5717",2015,"Temple",NA,NA,NA,145,251,122,80,0,170,0,89,106,195,69,143,222,46,176,212,69,143,34,0.23448275862069,770,8.96103896103896
"5718",2015,"Tennessee",NA,NA,NA,564,951,490,335,0,507,2,428,332,760,319,508,909,319,590,508,172,336,136,0.24113475177305,3052,10.4521625163827
"5719",2015,"Tennessee State",NA,NA,NA,61,92,45,27,0,107,0,31,29,60,32,114,112,28,84,67,20,47,13,0.213114754098361,353,9.06515580736544
"5720",2015,"Tennessee Tech",NA,NA,NA,35,57,56,33,0,71,2,28,25,53,22,62,74,21,53,27,9,18,9,0.257142857142857,224,9.82142857142857
"5721",2015,"Texas A&M",NA,NA,NA,408,860,443,272,0,529,4,390,260,650,239,448,982,351,631,203,61,142,107,0.262254901960784,2622,9.11517925247902
"5722",2015,"Texas Southern",NA,NA,NA,27,63,35,19,0,58,0,22,21,43,26,60,70,20,50,58,20,38,11,0.407407407407407,217,11.9815668202765
"5723",2015,"Texas State",NA,NA,NA,26,82,21,14,0,44,0,17,30,47,16,44,80,22,58,58,23,35,3,0.115384615384615,218,7.3394495412844
"5724",2015,"Texas Tech",NA,NA,NA,320,690,356,216,0,558,0,232,174,406,232,454,679,197,482,461,153,308,94,0.29375,2106,11.0161443494777
"5725",2015,"Toledo",NA,NA,NA,60,126,62,43,0,85,0,51,36,87,22,82,84,27,57,103,29,74,14,0.233333333333333,387,5.68475452196382
"5726",2015,"Towson",NA,NA,NA,40,66,25,16,0,53,0,26,19,45,23,44,85,22,63,68,20,48,12,0.3,225,10.2222222222222
"5727",2015,"Troy",NA,NA,NA,49,75,36,23,0,55,1,26,24,50,30,62,107,34,73,57,13,44,12,0.244897959183673,269,11.1524163568773
"5728",2015,"Tulane",NA,NA,NA,84,182,92,56,0,128,1,72,57,129,65,152,151,40,111,140,41,99,21,0.25,593,10.9612141652614
"5729",2015,"Tulsa",NA,NA,NA,62,141,61,39,0,102,0,63,58,121,45,90,116,29,87,109,36,73,11,0.17741935483871,431,10.4408352668213
"5730",2015,"UAB",NA,NA,NA,17,48,18,11,0,34,0,20,15,35,9,47,30,8,22,34,11,23,7,0.411764705882353,153,5.88235294117647
"5731",2015,"UC Davis",NA,NA,NA,17,41,19,12,0,31,0,28,16,44,11,33,23,8,15,34,7,27,4,0.235294117647059,140,7.85714285714286
"5732",2015,"UC Irvine",NA,NA,NA,9,20,9,3,0,18,0,16,9,25,7,10,25,6,19,13,3,10,3,0.333333333333333,66,10.6060606060606
"5733",2015,"UC Riverside",NA,NA,NA,30,64,22,10,0,52,1,19,10,29,21,39,87,37,50,56,14,42,9,0.3,207,10.1449275362319
"5734",2015,"UC Santa Barbara",NA,NA,NA,31,79,34,20,0,66,0,21,30,51,23,69,114,35,79,37,8,29,9,0.290322580645161,249,9.23694779116466
"5735",2015,"UCF",NA,NA,NA,39,55,16,11,0,27,0,18,27,45,14,45,49,17,32,37,7,30,12,0.307692307692308,184,7.60869565217391
"5736",2015,"UCLA",NA,NA,NA,483,893,484,295,0,612,2,347,283,630,290,547,1005,336,669,447,148,299,135,0.279503105590062,2865,10.1221640488656
"5737",2015,"UConn",NA,NA,NA,480,1099,392,266,0,390,1,711,250,961,362,435,609,248,361,731,291,440,176,0.366666666666667,3383,10.7005616316879
"5738",2015,"UIC",NA,NA,NA,17,23,8,3,0,16,0,11,14,25,9,29,20,3,17,9,3,6,4,0.235294117647059,88,10.2272727272727
"5739",2015,"UL Monroe",NA,NA,NA,8,23,18,11,0,22,0,2,4,6,10,32,25,8,17,7,3,4,2,0.25,79,12.6582278481013
"5740",2015,"UMBC",NA,NA,NA,10,36,15,9,0,19,0,26,19,45,22,26,15,9,6,8,3,5,3,0.3,113,19.4690265486726
"5741",2015,"UMass",NA,NA,NA,10,25,22,13,0,22,2,11,14,25,5,21,11,2,9,10,1,9,3,0.3,73,6.84931506849315
"5742",2015,"UMass Lowell",NA,NA,NA,19,34,15,10,0,40,0,14,12,26,14,43,36,8,28,58,13,45,3,0.157894736842105,134,10.4477611940298
"5743",2015,"UNC Greensboro",NA,NA,NA,61,73,46,26,0,75,0,29,35,64,42,79,119,30,89,53,18,35,12,0.19672131147541,298,14.0939597315436
"5744",2015,"UNC Wilmington",NA,NA,NA,16,32,5,2,0,25,0,14,7,21,4,25,28,5,23,13,3,10,4,0.25,96,4.16666666666667
"5745",2015,"UNLV",NA,NA,NA,49,105,64,38,0,66,1,46,32,78,33,61,97,24,73,66,13,53,17,0.346938775510204,315,10.4761904761905
"5746",2015,"UT Arlington",NA,NA,NA,13,27,11,6,0,23,0,1,2,3,10,22,26,8,18,20,5,15,4,0.307692307692308,76,13.1578947368421
"5747",2015,"UT Martin",NA,NA,NA,52,114,75,45,0,105,3,32,34,66,44,105,94,34,60,96,30,66,13,0.25,383,11.4882506527415
"5748",2015,"UT Rio Grande Valley",NA,NA,NA,79,127,81,49,0,127,0,39,54,93,54,94,160,38,122,105,23,82,17,0.215189873417722,420,12.8571428571429
"5749",2015,"UTEP",NA,NA,NA,15,26,18,12,0,25,0,10,13,23,2,24,11,2,9,24,11,13,4,0.266666666666667,93,2.1505376344086
"5750",2015,"UTSA",NA,NA,NA,46,62,52,31,0,69,0,20,24,44,23,77,62,16,46,51,12,39,11,0.239130434782609,240,9.58333333333333
"5751",2015,"Utah",NA,NA,NA,237,700,282,173,0,448,4,247,181,428,108,362,474,155,319,445,124,321,63,0.265822784810127,1897,5.69319978914075
"5752",2015,"Utah State",NA,NA,NA,54,84,36,22,0,98,0,39,42,81,30,69,114,38,76,52,14,38,8,0.148148148148148,306,9.80392156862745
"5753",2015,"VCU",NA,NA,NA,36,52,26,13,0,40,0,18,19,37,12,32,65,14,51,44,21,23,10,0.277777777777778,178,6.74157303370786
"5754",2015,"Valparaiso",NA,NA,NA,35,83,25,16,0,48,0,34,26,60,12,71,56,14,42,59,15,44,13,0.371428571428571,257,4.66926070038911
"5755",2015,"Vanderbilt",NA,NA,NA,345,723,400,248,0,538,4,352,210,562,216,620,685,255,430,330,105,225,86,0.249275362318841,2486,8.6886564762671
"5756",2015,"Vermont",NA,NA,NA,18,34,13,6,0,18,0,7,12,19,3,32,14,3,11,29,12,17,4,0.222222222222222,108,2.77777777777778
"5757",2015,"Villanova",NA,NA,NA,71,186,49,33,0,117,0,57,50,107,40,65,160,59,101,212,83,129,16,0.225352112676056,533,7.5046904315197
"5758",2015,"Virginia",NA,NA,NA,326,716,319,211,0,494,0,284,256,540,202,414,666,256,410,449,165,284,105,0.322085889570552,2232,9.05017921146953
"5759",2015,"Virginia Tech",NA,NA,NA,323,713,297,184,0,504,0,261,249,510,122,463,424,129,295,547,151,396,100,0.309597523219814,2100,5.80952380952381
"5760",2015,"Wagner",NA,NA,NA,34,54,38,19,0,65,0,12,22,34,17,81,66,19,47,58,19,39,4,0.117647058823529,226,7.52212389380531
"5761",2015,"Wake Forest",NA,NA,NA,419,783,493,295,0,623,3,457,363,820,249,648,463,147,316,440,145,295,128,0.305489260143198,2676,9.30493273542601
"5762",2015,"Washington",NA,NA,NA,289,848,403,289,0,457,5,251,185,436,213,346,688,279,409,666,232,434,89,0.30795847750865,2332,9.13379073756432
"5763",2015,"Washington State",NA,NA,NA,432,718,373,235,0,526,4,364,342,706,303,405,666,212,454,614,174,440,112,0.259259259259259,2390,12.6778242677824
"5764",2015,"Weber State",NA,NA,NA,14,22,8,6,0,18,0,6,10,16,7,18,22,8,14,13,3,10,2,0.142857142857143,71,9.85915492957746
"5765",2015,"West Virginia",NA,NA,NA,518,964,517,320,0,626,3,378,203,581,297,529,978,288,690,556,166,390,114,0.22007722007722,2964,10.0202429149798
"5766",2015,"Western Carolina",NA,NA,NA,18,41,28,20,0,27,0,14,15,29,9,29,59,18,41,22,6,16,2,0.111111111111111,131,6.87022900763359
"5767",2015,"Western Illinois",NA,NA,NA,18,18,9,5,0,16,0,8,5,13,10,16,27,5,22,25,6,19,4,0.222222222222222,72,13.8888888888889
"5768",2015,"Western Kentucky",NA,NA,NA,140,223,182,117,0,193,0,103,77,180,111,163,232,88,144,189,58,131,46,0.328571428571429,821,13.5200974421437
"5769",2015,"Western Michigan",NA,NA,NA,34,68,27,20,0,59,0,27,36,63,16,55,70,16,54,36,8,28,9,0.264705882352941,213,7.51173708920188
"5770",2015,"Wichita State",NA,NA,NA,56,120,40,29,0,91,0,49,34,83,56,82,146,61,85,103,39,64,22,0.392857142857143,422,13.2701421800948
"5771",2015,"William & Mary",NA,NA,NA,10,23,9,5,0,15,0,14,13,27,8,10,19,8,11,13,2,11,5,0.5,70,11.4285714285714
"5772",2015,"William Carey",NA,NA,NA,16,10,21,11,0,21,0,0,1,1,8,25,37,14,23,15,1,14,5,0.3125,67,11.9402985074627
"5773",2015,"Winthrop",NA,NA,NA,40,77,30,16,0,42,0,23,24,47,19,75,76,22,54,32,14,18,12,0.3,254,7.48031496062992
"5774",2015,"Wisconsin",NA,NA,NA,269,634,223,142,0,376,1,219,148,367,135,396,635,241,394,389,139,250,79,0.29368029739777,1941,6.95517774343122
"5775",2015,"Wofford",NA,NA,NA,11,15,8,6,0,13,0,7,14,21,9,13,9,1,8,18,5,13,2,0.181818181818182,53,16.9811320754717
"5776",2015,"Wright State",NA,NA,NA,47,79,54,35,0,50,0,26,19,45,22,33,88,20,68,72,14,58,6,0.127659574468085,230,9.56521739130435
"5777",2015,"Wyoming",NA,NA,NA,26,48,32,19,0,38,0,18,28,46,10,19,42,15,27,43,13,30,7,0.269230769230769,146,6.84931506849315
"5778",2015,"Xavier",NA,NA,NA,26,66,37,21,0,40,0,39,27,66,23,48,39,9,30,56,13,43,3,0.115384615384615,208,11.0576923076923
"5779",2015,"Yale",NA,NA,NA,76,111,51,28,0,97,1,42,52,94,38,72,170,41,129,58,18,40,19,0.25,371,10.2425876010782
"5780",2015,"Youngstown State",NA,NA,NA,24,49,20,14,0,24,0,16,16,32,5,29,32,8,24,52,12,40,5,0.208333333333333,143,3.4965034965035
"5781",2016,"Air Force",NA,NA,NA,29,48,14,6,0,55,0,17,11,28,18,61,86,27,59,35,8,27,11,0.379310344827586,195,9.23076923076923
"5782",2016,"Alabama A&M",NA,NA,NA,39,107,54,30,0,105,0,43,31,74,26,111,104,34,70,42,14,28,16,0.41025641025641,361,7.202216066482
"5783",2016,"Alabama State",NA,NA,NA,72,138,98,67,0,145,0,54,46,100,49,106,142,38,104,89,25,64,18,0.25,457,10.7221006564551
"5784",2016,"Arkansas-Pine Bluff",NA,NA,NA,55,136,60,32,0,112,0,34,23,57,40,106,197,60,137,75,16,59,13,0.236363636363636,419,9.54653937947494
"5785",2016,"Army",NA,NA,NA,62,122,57,37,0,97,0,56,41,97,43,72,84,32,52,101,39,62,23,0.370967741935484,397,10.831234256927
"5786",2016,"Bethune-Cookman",NA,NA,NA,38,76,36,20,0,35,0,28,34,62,15,53,49,12,37,40,13,27,7,0.184210526315789,228,6.57894736842105
"5787",2016,"Binghamton",NA,NA,NA,29,69,35,20,0,41,0,16,24,40,26,43,96,27,69,44,13,31,6,0.206896551724138,203,12.807881773399
"5788",2016,"Boston University",NA,NA,NA,21,40,13,9,0,48,0,17,13,30,15,38,46,15,31,27,4,23,1,0.0476190476190476,138,10.8695652173913
"5789",2016,"Bowling Green",NA,NA,NA,24,78,34,22,0,46,0,23,16,39,16,56,29,6,23,71,22,49,5,0.208333333333333,214,7.47663551401869
"5790",2016,"Bryant",NA,NA,NA,39,65,33,21,0,45,0,48,32,80,19,44,32,8,24,55,15,40,12,0.307692307692308,226,8.4070796460177
"5791",2016,"Bucknell",NA,NA,NA,44,93,56,34,0,77,0,47,48,95,21,64,52,17,35,68,25,43,16,0.363636363636364,301,6.97674418604651
"5792",2016,"Butler",NA,NA,NA,79,207,78,52,0,131,1,104,104,208,48,137,82,29,53,137,41,96,25,0.316455696202532,616,7.79220779220779
"5793",2016,"Cal State Northridge",NA,NA,NA,59,105,59,35,0,89,1,44,64,108,29,94,93,28,65,72,28,44,14,0.23728813559322,367,7.90190735694823
"5794",2016,"Central Connecticut",NA,NA,NA,18,44,21,15,0,37,0,17,14,31,23,32,57,16,41,39,11,28,1,0.0555555555555556,145,15.8620689655172
"5795",2016,"Charleston Southern",NA,NA,NA,52,90,43,25,0,81,1,34,24,58,37,71,98,31,67,74,19,55,17,0.326923076923077,302,12.2516556291391
"5796",2016,"Chicago State",NA,NA,NA,28,69,27,15,0,48,0,24,18,42,24,71,57,18,39,47,12,35,8,0.285714285714286,230,10.4347826086957
"5797",2016,"Cincinnati",NA,NA,NA,70,152,51,33,0,109,0,42,65,107,36,105,171,50,121,148,40,108,21,0.3,468,7.69230769230769
"5798",2016,"Cleveland State",NA,NA,NA,6,23,12,6,0,20,1,6,7,13,8,18,13,4,9,26,11,15,1,0.166666666666667,74,10.8108108108108
"5799",2016,"Colgate",NA,NA,NA,25,36,14,10,0,31,0,8,27,35,8,37,44,13,31,38,19,19,2,0.08,143,5.59440559440559
"5800",2016,"Columbia",NA,NA,NA,7,28,5,4,0,14,0,7,7,14,3,21,16,9,7,15,3,12,1,0.142857142857143,75,4
"5801",2016,"Cornell",NA,NA,NA,9,19,10,4,0,14,0,2,12,14,4,11,32,6,26,16,6,10,0,0,57,7.01754385964912
"5802",2016,"Davidson",NA,NA,NA,46,103,37,24,0,76,0,39,42,81,21,72,93,25,68,53,9,44,12,0.260869565217391,301,6.97674418604651
"5803",2016,"Denver",NA,NA,NA,18,37,21,16,0,38,0,19,26,45,11,25,33,11,22,25,11,14,4,0.222222222222222,127,8.66141732283465
"5804",2016,"Drexel",NA,NA,NA,37,109,28,20,0,67,0,30,28,58,33,53,103,37,66,115,43,72,11,0.297297297297297,315,10.4761904761905
"5805",2016,"Eastern Kentucky",NA,NA,NA,20,64,28,22,0,75,0,26,17,43,23,32,92,31,61,54,19,35,5,0.25,199,11.5577889447236
"5806",2016,"Fairfield",NA,NA,NA,14,48,9,6,0,26,0,15,23,38,12,28,38,14,24,39,9,30,4,0.285714285714286,130,9.23076923076923
"5807",2016,"Fairleigh Dickinson",NA,NA,NA,26,38,32,19,0,49,0,10,7,17,13,45,63,16,47,25,8,17,6,0.230769230769231,151,8.60927152317881
"5808",2016,"Florida A&M",NA,NA,NA,43,94,44,26,0,70,0,42,43,85,23,66,85,24,61,67,21,46,21,0.488372093023256,303,7.59075907590759
"5809",2016,"Furman",NA,NA,NA,58,119,45,30,0,59,0,33,59,92,28,76,78,21,57,103,35,68,12,0.206896551724138,354,7.90960451977401
"5810",2016,"Georgetown",NA,NA,NA,41,103,45,28,0,85,0,38,33,71,34,77,112,39,73,44,10,34,11,0.268292682926829,320,10.625
"5811",2016,"Georgia Southern",NA,NA,NA,13,15,4,2,0,14,0,4,3,7,7,17,22,3,19,22,2,20,0,0,55,12.7272727272727
"5812",2016,"Georgia State",NA,NA,NA,15,33,13,6,0,23,0,1,2,3,9,23,39,15,24,21,5,16,4,0.266666666666667,93,9.67741935483871
"5813",2016,"Hartford",NA,NA,NA,38,61,19,12,0,48,0,19,29,48,29,57,91,18,73,72,18,54,8,0.210526315789474,215,13.4883720930233
"5814",2016,"Hawai'i",NA,NA,NA,109,173,91,56,0,126,0,62,58,120,28,134,144,47,97,118,32,86,30,0.275229357798165,577,4.8526863084922
"5815",2016,"High Point",NA,NA,NA,60,122,65,44,0,99,0,29,31,60,29,93,137,49,88,96,23,73,16,0.266666666666667,393,7.37913486005089
"5816",2016,"Hofstra",NA,NA,NA,36,63,30,21,0,59,0,36,25,61,33,50,49,13,36,58,10,48,9,0.25,211,15.6398104265403
"5817",2016,"Howard",NA,NA,NA,70,133,73,48,0,89,1,51,55,106,29,124,109,24,85,66,10,56,14,0.2,424,6.83962264150943
"5818",2016,"Incarnate Word",NA,NA,NA,28,27,13,8,0,32,0,4,4,8,13,40,77,16,61,32,10,22,4,0.142857142857143,128,10.15625
"5819",2016,"Jackson State",NA,NA,NA,23,44,29,18,0,33,0,11,15,26,17,52,52,9,43,15,2,13,1,0.0434782608695652,146,11.6438356164384
"5820",2016,"Jacksonville State",NA,NA,NA,8,23,8,4,0,14,0,6,2,8,2,19,25,5,20,19,7,12,2,0.25,71,2.8169014084507
"5821",2016,"Kennesaw State",NA,NA,NA,18,46,25,16,0,43,1,13,14,27,14,41,43,13,30,38,12,26,6,0.333333333333333,149,9.39597315436242
"5822",2016,"Kent State",NA,NA,NA,23,44,24,19,0,38,0,26,21,47,22,32,33,19,14,44,5,39,12,0.521739130434783,156,14.1025641025641
"5823",2016,"LIU Brooklyn",NA,NA,NA,13,33,24,15,0,29,0,16,11,27,12,37,34,8,26,29,9,20,5,0.384615384615385,121,9.91735537190083
"5824",2016,"La Salle",NA,NA,NA,45,68,29,17,0,56,0,29,36,65,27,65,76,22,54,48,17,31,14,0.311111111111111,257,10.5058365758755
"5825",2016,"Lehigh",NA,NA,NA,52,105,58,35,0,45,0,29,36,65,25,70,71,28,43,80,27,53,12,0.230769230769231,326,7.66871165644172
"5826",2016,"Lipscomb",NA,NA,NA,23,33,13,10,0,36,0,10,18,28,13,40,46,12,34,36,13,23,3,0.130434782608696,133,9.77443609022556
"5827",2016,"Longwood",NA,NA,NA,27,70,33,20,0,52,1,19,21,40,13,51,73,16,57,56,11,45,4,0.148148148148148,195,6.66666666666667
"5828",2016,"Loyola Chicago",NA,NA,NA,54,133,57,35,0,92,1,69,60,129,35,90,120,44,76,56,16,40,17,0.314814814814815,423,8.274231678487
"5829",2016,"Loyola Marymount",NA,NA,NA,59,91,69,44,0,95,0,32,47,79,36,58,77,25,52,103,35,68,16,0.271186440677966,316,11.3924050632911
"5830",2016,"Manhattan",NA,NA,NA,30,45,19,12,0,41,0,22,32,54,17,20,38,14,24,35,10,25,12,0.4,147,11.5646258503401
"5831",2016,"Marshall",NA,NA,NA,40,100,49,28,0,70,0,49,47,96,17,47,43,13,30,91,26,65,11,0.275,288,5.90277777777778
"5832",2016,"Maryland-Eastern Shore",NA,NA,NA,18,32,9,5,0,21,0,12,18,30,1,22,9,4,5,24,4,20,2,0.111111111111111,95,1.05263157894737
"5833",2016,"McNeese",NA,NA,NA,97,126,58,35,0,132,0,50,60,110,42,110,158,52,106,120,35,85,24,0.247422680412371,479,8.76826722338205
"5834",2016,"Mercer",NA,NA,NA,68,127,40,27,0,85,0,56,55,111,48,63,173,51,122,86,24,62,21,0.308823529411765,395,12.1518987341772
"5835",2016,"Miami (OH)",NA,NA,NA,10,17,4,2,0,18,0,8,5,13,4,24,24,9,15,16,6,10,2,0.2,75,5.33333333333333
"5836",2016,"Milwaukee",NA,NA,NA,29,89,26,16,0,38,0,19,21,40,6,58,61,18,43,56,13,43,9,0.310344827586207,229,2.62008733624454
"5837",2016,"Mississippi Valley State",NA,NA,NA,79,138,63,36,0,121,1,39,38,77,41,170,178,36,142,81,20,61,20,0.253164556962025,499,8.21643286573146
"5838",2016,"Montana State",NA,NA,NA,24,62,42,22,0,35,0,14,17,31,17,29,64,16,48,26,7,19,7,0.291666666666667,162,10.4938271604938
"5839",2016,"Morehead State",NA,NA,NA,28,55,23,12,0,46,0,15,11,26,9,42,71,16,55,46,10,36,5,0.178571428571429,172,5.23255813953488
"5840",2016,"Mount St. Mary's",NA,NA,NA,25,81,32,22,0,41,0,20,35,55,13,57,46,15,31,53,13,40,8,0.32,219,5.93607305936073
"5841",2016,"NJIT",NA,NA,NA,22,85,16,12,0,40,0,8,10,18,13,61,74,21,53,62,19,43,5,0.227272727272727,218,5.96330275229358
"5842",2016,"Nevada",NA,NA,NA,33,71,43,29,0,58,0,30,29,59,14,56,63,14,49,37,6,31,8,0.242424242424242,221,6.33484162895928
"5843",2016,"New Orleans",NA,NA,NA,40,65,38,27,0,57,2,25,39,64,15,75,59,10,49,44,9,35,2,0.05,234,6.41025641025641
"5844",2016,"Nicholls",NA,NA,NA,27,20,16,11,0,20,0,9,8,17,11,14,31,6,25,20,5,15,2,0.0740740740740741,86,12.7906976744186
"5845",2016,"Norfolk State",NA,NA,NA,50,53,27,16,0,51,1,24,27,51,15,65,97,25,72,39,6,33,8,0.16,231,6.49350649350649
"5846",2016,"North Carolina A&T",NA,NA,NA,70,129,76,45,0,92,0,46,60,106,24,81,122,38,84,75,26,49,24,0.342857142857143,410,5.85365853658537
"5847",2016,"North Carolina Central",NA,NA,NA,19,51,16,9,0,28,0,13,15,28,12,40,59,16,43,18,6,12,6,0.31578947368421,149,8.05369127516778
"5848",2016,"North Florida",NA,NA,NA,53,104,33,20,0,84,1,13,23,36,24,96,133,46,87,106,23,83,14,0.264150943396226,341,7.03812316715543
"5849",2016,"Northeastern",NA,NA,NA,26,69,43,26,0,58,0,17,22,39,19,60,51,20,31,48,16,32,3,0.115384615384615,218,8.71559633027523
"5850",2016,"Northern Arizona",NA,NA,NA,46,99,52,33,0,90,0,35,27,62,26,61,137,39,98,57,22,35,11,0.239130434782609,316,8.22784810126582
"5851",2016,"Northern Colorado",NA,NA,NA,20,35,16,11,0,30,0,13,18,31,15,23,32,8,24,45,9,36,6,0.3,110,13.6363636363636
"5852",2016,"Northern Illinois",NA,NA,NA,27,79,32,20,0,53,0,37,25,62,15,42,87,20,67,44,10,34,8,0.296296296296296,220,6.81818181818182
"5853",2016,"Omaha",NA,NA,NA,20,60,22,16,0,23,0,23,25,48,9,28,31,8,23,32,12,20,7,0.35,156,5.76923076923077
"5854",2016,"Pacific",NA,NA,NA,42,75,41,27,0,63,0,25,26,51,22,50,77,26,51,65,17,48,11,0.261904761904762,243,9.05349794238683
"5855",2016,"Pepperdine",NA,NA,NA,13,56,34,22,0,28,0,24,14,38,15,39,34,11,23,30,11,19,3,0.230769230769231,160,9.375
"5856",2016,"Portland",NA,NA,NA,33,83,67,45,0,77,0,24,32,56,15,57,96,30,66,71,21,50,5,0.151515151515152,268,5.59701492537313
"5857",2016,"Portland State",NA,NA,NA,22,58,31,18,0,37,0,18,37,55,22,46,42,11,31,37,14,23,2,0.0909090909090909,175,12.5714285714286
"5858",2016,"Princeton",NA,NA,NA,45,108,48,31,0,75,0,61,52,113,26,64,50,13,37,70,25,45,13,0.288888888888889,333,7.80780780780781
"5859",2016,"Providence",NA,NA,NA,38,103,60,34,0,87,0,44,45,89,21,89,98,29,69,73,21,52,6,0.157894736842105,336,6.25
"5860",2016,"Rhode Island",NA,NA,NA,21,56,31,17,0,41,1,21,16,37,5,27,22,8,14,49,17,32,2,0.0952380952380952,157,3.18471337579618
"5861",2016,"Richmond",NA,NA,NA,44,98,46,30,0,66,0,32,35,67,28,59,99,22,77,53,14,39,8,0.181818181818182,275,10.1818181818182
"5862",2016,"SE Louisiana",NA,NA,NA,59,124,66,41,0,137,0,25,26,51,24,125,127,30,97,114,29,85,14,0.23728813559322,404,5.94059405940594
"5863",2016,"Sacramento State",NA,NA,NA,69,56,46,30,0,63,1,42,31,73,34,41,49,16,33,158,38,120,17,0.246376811594203,277,12.2743682310469
"5864",2016,"Saint Peter's",NA,NA,NA,23,45,11,6,0,28,1,18,23,41,9,26,49,16,33,24,3,21,5,0.217391304347826,134,6.71641791044776
"5865",2016,"San José State",NA,NA,NA,29,68,33,21,0,50,0,37,38,75,28,40,50,14,36,83,23,60,8,0.275862068965517,215,13.0232558139535
"5866",2016,"Seattle U",NA,NA,NA,39,71,34,19,0,56,1,17,19,36,20,55,73,21,52,65,23,42,6,0.153846153846154,232,8.62068965517241
"5867",2016,"South Alabama",NA,NA,NA,10,30,9,6,0,21,0,11,9,20,9,31,18,6,12,15,2,13,3,0.3,92,9.78260869565217
"5868",2016,"Southern Utah",NA,NA,NA,26,44,15,8,0,40,0,24,28,52,16,53,46,8,38,14,1,13,10,0.384615384615385,161,9.93788819875776
"5869",2016,"St. Bonaventure",NA,NA,NA,43,131,46,33,0,103,0,50,43,93,39,87,92,30,62,91,23,68,10,0.232558139534884,375,10.4
"5870",2016,"St. Francis (PA)",NA,NA,NA,62,107,54,35,0,93,0,41,48,89,35,89,69,22,47,116,32,84,18,0.290322580645161,366,9.56284153005464
"5871",2016,"St. Francis Brooklyn",NA,NA,NA,6,18,6,4,0,16,0,9,5,14,7,22,14,0,14,20,9,11,1,0.166666666666667,65,10.7692307692308
"5872",2016,"Stetson",NA,NA,NA,51,150,72,46,0,113,0,81,52,133,37,112,85,24,61,82,27,55,11,0.215686274509804,461,8.02603036876356
"5873",2016,"Tennessee State",NA,NA,NA,77,107,43,25,0,116,1,23,41,64,33,109,167,53,114,94,22,72,13,0.168831168831169,400,8.25
"5874",2016,"Tennessee Tech",NA,NA,NA,26,66,53,32,0,45,0,17,32,49,16,63,54,19,35,35,13,22,4,0.153846153846154,219,7.30593607305936
"5875",2016,"Texas State",NA,NA,NA,40,91,34,23,0,91,0,31,30,61,31,92,85,21,64,126,37,89,12,0.3,317,9.77917981072555
"5876",2016,"Towson",NA,NA,NA,47,91,59,33,0,77,1,24,19,43,22,56,111,40,71,80,30,50,10,0.212765957446809,304,7.23684210526316
"5877",2016,"Tulsa",NA,NA,NA,85,234,72,44,0,169,0,82,96,178,64,132,202,65,137,178,49,129,24,0.282352941176471,664,9.63855421686747
"5878",2016,"UC Irvine",NA,NA,NA,37,63,32,19,0,55,0,25,19,44,16,52,100,22,78,36,8,28,8,0.216216216216216,213,7.51173708920188
"5879",2016,"UConn",NA,NA,NA,476,1071,406,298,0,420,1,689,278,967,446,452,688,301,387,775,295,480,205,0.430672268907563,3413,13.0676823908585
"5880",2016,"UIC",NA,NA,NA,32,50,16,11,0,46,0,17,12,29,13,33,69,25,44,22,2,20,13,0.40625,162,8.02469135802469
"5881",2016,"UMBC",NA,NA,NA,31,85,21,14,0,27,0,20,18,38,17,44,83,31,52,38,9,29,10,0.32258064516129,226,7.52212389380531
"5882",2016,"UMass Lowell",NA,NA,NA,40,69,25,17,0,49,1,16,31,47,17,70,67,20,47,59,22,37,11,0.275,245,6.93877551020408
"5883",2016,"UNC Greensboro",NA,NA,NA,28,47,22,13,0,33,0,18,15,33,12,45,55,13,42,27,5,22,7,0.25,162,7.40740740740741
"5884",2016,"Utah Valley",NA,NA,NA,39,94,52,35,0,61,0,53,42,95,29,63,55,19,36,57,10,47,12,0.307692307692308,292,9.93150684931507
"5885",2016,"VCU",NA,NA,NA,68,151,75,42,0,92,0,68,70,138,37,69,113,33,80,52,12,40,17,0.25,416,8.89423076923077
"5886",2016,"Wagner",NA,NA,NA,22,42,24,13,0,42,0,15,27,42,8,43,28,6,22,57,12,45,6,0.272727272727273,145,5.51724137931035
"5887",2016,"Western Carolina",NA,NA,NA,38,57,26,18,0,60,1,20,23,43,26,55,91,29,62,53,11,42,5,0.131578947368421,219,11.8721461187215
"5888",2016,"Winthrop",NA,NA,NA,68,99,46,22,0,77,0,34,30,64,59,96,180,43,137,63,13,50,12,0.176470588235294,365,16.1643835616438
"5889",2016,"Wofford",NA,NA,NA,23,75,41,25,0,54,1,14,17,31,19,56,62,19,43,62,13,49,4,0.173913043478261,208,9.13461538461538
"5890",2016,"Wyoming",NA,NA,NA,34,70,47,30,0,35,1,25,14,39,19,35,67,25,42,61,19,42,8,0.235294117647059,228,8.33333333333333
"5891",2016,"Yale",NA,NA,NA,15,37,21,14,0,40,0,28,24,52,19,30,19,6,13,33,10,23,5,0.333333333333333,131,14.5038167938931
"5892",2017,"Akron",NA,NA,NA,20,54,16,9,0,36,0,22,22,44,6,31,39,14,25,40,8,32,6,0.3,155,3.87096774193548
"5893",2017,"Alabama A&M",NA,NA,NA,23,44,12,6,0,37,0,6,1,7,11,67,80,21,59,19,1,18,2,0.0869565217391304,165,6.66666666666667
"5894",2017,"Alabama State",NA,NA,NA,112,161,85,54,0,181,6,52,40,92,47,165,182,47,135,134,23,111,25,0.223214285714286,577,8.14558058925477
"5895",2017,"Appalachian State",NA,NA,NA,60,126,82,50,0,90,0,50,42,92,25,88,142,38,104,59,20,39,14,0.233333333333333,399,6.265664160401
"5896",2017,"Arkansas State",NA,NA,NA,67,121,74,44,0,101,0,38,58,96,29,87,130,30,100,88,25,63,9,0.134328358208955,384,7.55208333333333
"5897",2017,"Austin Peay",NA,NA,NA,19,52,19,12,0,39,0,18,14,32,14,31,53,10,43,31,3,28,4,0.210526315789474,140,10
"5898",2017,"Bethune-Cookman",NA,NA,NA,18,43,23,15,0,37,0,11,13,24,10,36,42,8,34,37,6,31,4,0.222222222222222,126,7.93650793650794
"5899",2017,"Binghamton",NA,NA,NA,9,24,6,4,0,10,0,5,8,13,8,24,15,3,12,17,6,11,0,0,73,10.958904109589
"5900",2017,"Boston University",NA,NA,NA,16,33,15,9,0,44,0,20,18,38,18,41,27,11,16,24,5,19,4,0.25,127,14.1732283464567
"5901",2017,"Bowling Green",NA,NA,NA,44,97,45,28,0,77,1,27,35,62,21,88,67,19,48,87,23,64,11,0.25,308,6.81818181818182
"5902",2017,"Bradley",NA,NA,NA,8,19,4,2,0,14,0,3,0,3,5,20,33,11,22,15,3,12,3,0.375,66,7.57575757575758
"5903",2017,"Cal Poly",NA,NA,NA,47,64,38,25,0,62,0,23,44,67,24,42,90,32,58,48,9,39,12,0.25531914893617,230,10.4347826086957
"5904",2017,"Central Arkansas",NA,NA,NA,46,90,35,22,0,55,0,32,21,53,13,50,118,46,72,48,10,38,17,0.369565217391304,287,4.52961672473868
"5905",2017,"Central Connecticut",NA,NA,NA,51,119,59,35,0,78,0,53,56,109,45,85,97,34,63,81,18,63,14,0.274509803921569,365,12.3287671232877
"5906",2017,"Charlotte",NA,NA,NA,86,168,89,49,0,101,0,49,54,103,49,107,145,47,98,124,38,86,19,0.22093023255814,509,9.62671905697446
"5907",2017,"Chattanooga",NA,NA,NA,101,200,94,67,0,90,0,110,99,209,63,117,122,38,84,179,57,122,30,0.297029702970297,642,9.81308411214953
"5908",2017,"Chicago State",NA,NA,NA,20,39,28,17,0,26,0,10,13,23,15,34,48,8,40,32,4,28,2,0.1,117,12.8205128205128
"5909",2017,"Cleveland State",NA,NA,NA,28,67,21,15,0,38,0,23,23,46,23,42,54,22,32,85,22,63,8,0.285714285714286,208,11.0576923076923
"5910",2017,"Coastal Carolina",NA,NA,NA,58,54,42,26,0,48,0,14,29,43,13,41,57,17,40,33,6,27,19,0.327586206896552,199,6.53266331658291
"5911",2017,"Colgate",NA,NA,NA,22,51,15,11,0,48,0,21,18,39,7,46,61,18,43,24,11,13,10,0.454545454545455,174,4.02298850574713
"5912",2017,"Coppin State",NA,NA,NA,68,106,53,28,0,82,0,31,40,71,49,115,137,26,111,71,15,56,10,0.147058823529412,373,13.1367292225201
"5913",2017,"Cornell",NA,NA,NA,15,27,12,6,0,14,0,6,6,12,6,21,27,9,18,10,2,8,2,0.133333333333333,81,7.40740740740741
"5914",2017,"Dartmouth",NA,NA,NA,10,25,13,6,0,20,0,9,14,23,2,17,13,3,10,14,7,7,3,0.3,74,2.7027027027027
"5915",2017,"Davidson",NA,NA,NA,32,68,36,20,0,66,0,20,29,49,29,37,92,28,64,33,8,25,6,0.1875,201,14.4278606965174
"5916",2017,"Delaware",NA,NA,NA,20,32,25,18,0,30,0,8,16,24,15,30,48,19,29,24,8,16,4,0.2,122,12.2950819672131
"5917",2017,"Delaware State",NA,NA,NA,20,49,23,14,0,34,0,16,13,29,16,43,52,13,39,39,9,30,6,0.3,156,10.2564102564103
"5918",2017,"Denver",NA,NA,NA,13,29,3,3,0,14,0,4,5,9,7,23,33,7,26,18,4,14,3,0.230769230769231,81,8.64197530864197
"5919",2017,"Detroit Mercy",NA,NA,NA,41,137,41,24,0,96,1,31,26,57,13,79,106,44,62,131,60,71,9,0.219512195121951,402,3.23383084577114
"5920",2017,"Duquesne",NA,NA,NA,84,200,89,62,0,141,3,77,65,142,32,121,141,38,103,174,59,115,27,0.321428571428571,598,5.35117056856187
"5921",2017,"Eastern Michigan",NA,NA,NA,34,68,33,19,0,48,1,23,27,50,14,41,82,28,54,44,10,34,6,0.176470588235294,210,6.66666666666667
"5922",2017,"Fairfield",NA,NA,NA,16,51,12,8,0,31,0,20,18,38,11,28,34,10,24,29,8,21,4,0.25,134,8.2089552238806
"5923",2017,"Fairleigh Dickinson",NA,NA,NA,10,20,9,4,0,15,0,10,14,24,6,16,18,4,14,12,1,11,3,0.3,63,9.52380952380952
"5924",2017,"Florida A&M",NA,NA,NA,32,44,21,12,0,47,0,12,8,20,28,60,59,14,45,50,14,36,4,0.125,181,15.4696132596685
"5925",2017,"Florida Atlantic",NA,NA,NA,15,25,10,7,0,11,0,8,8,16,2,18,33,10,23,19,6,13,6,0.4,85,2.35294117647059
"5926",2017,"Florida International",NA,NA,NA,9,24,11,8,0,15,0,5,11,16,5,18,22,9,13,14,3,11,0,0,70,7.14285714285714
"5927",2017,"Fresno State",NA,NA,NA,57,170,71,49,0,92,0,57,54,111,37,100,130,40,90,78,21,57,19,0.333333333333333,462,8.00865800865801
"5928",2017,"Georgia Southern",NA,NA,NA,27,79,24,15,0,54,0,21,31,52,17,51,46,20,26,62,15,47,3,0.111111111111111,219,7.76255707762557
"5929",2017,"Gonzaga",NA,NA,NA,118,235,118,85,0,143,0,125,75,200,69,140,146,53,93,169,59,110,28,0.23728813559322,764,9.03141361256544
"5930",2017,"Grand Canyon",NA,NA,NA,21,38,8,4,0,42,0,5,16,21,8,31,56,21,35,57,18,39,7,0.333333333333333,135,5.92592592592593
"5931",2017,"Hampton",NA,NA,NA,52,80,39,21,0,95,1,34,69,103,35,68,76,17,59,74,20,54,13,0.25,279,12.5448028673835
"5932",2017,"High Point",NA,NA,NA,38,79,31,24,0,55,0,18,30,48,16,59,68,22,46,44,14,30,9,0.236842105263158,236,6.77966101694915
"5933",2017,"Hofstra",NA,NA,NA,20,52,28,18,0,38,0,19,15,34,19,31,33,10,23,47,14,33,8,0.4,155,12.258064516129
"5934",2017,"Houston Christian",NA,NA,NA,23,57,26,17,0,71,0,13,13,26,8,76,82,15,67,60,16,44,2,0.0869565217391304,206,3.88349514563107
"5935",2017,"Howard",NA,NA,NA,15,34,29,17,0,42,1,15,15,30,17,53,38,8,30,35,6,29,1,0.0666666666666667,138,12.3188405797101
"5936",2017,"Illinois State",NA,NA,NA,56,96,39,25,0,66,0,25,25,50,34,82,97,21,76,64,15,49,10,0.178571428571429,303,11.2211221122112
"5937",2017,"Incarnate Word",NA,NA,NA,14,20,13,10,0,20,0,3,14,17,4,18,17,5,12,22,3,19,1,0.0714285714285714,67,5.97014925373134
"5938",2017,"Indiana State",NA,NA,NA,42,65,37,21,0,57,2,13,20,33,26,56,77,19,58,53,15,38,6,0.142857142857143,220,11.8181818181818
"5939",2017,"Jackson State",NA,NA,NA,13,20,12,7,0,19,0,7,16,23,10,20,36,7,29,6,1,5,1,0.0769230769230769,71,14.0845070422535
"5940",2017,"LIU Brooklyn",NA,NA,NA,7,23,10,6,0,19,0,0,7,7,2,28,20,5,15,27,12,15,0,0,78,2.56410256410256
"5941",2017,"La Salle",NA,NA,NA,29,39,29,20,0,43,0,19,30,49,14,25,46,16,30,18,6,12,8,0.275862068965517,138,10.1449275362319
"5942",2017,"Lafayette",NA,NA,NA,45,80,34,18,0,54,1,23,32,55,23,62,71,17,54,51,12,39,9,0.2,243,9.46502057613169
"5943",2017,"Lehigh",NA,NA,NA,22,44,23,15,0,30,0,16,13,29,7,30,42,7,35,46,15,31,5,0.227272727272727,139,5.03597122302158
"5944",2017,"Lipscomb",NA,NA,NA,25,69,29,17,0,67,0,16,10,26,17,53,73,18,55,70,18,52,5,0.2,205,8.29268292682927
"5945",2017,"Loyola Chicago",NA,NA,NA,32,87,57,35,0,41,0,22,36,58,21,88,85,19,66,55,12,43,6,0.1875,275,7.63636363636364
"5946",2017,"Maine",NA,NA,NA,73,148,75,50,0,113,0,55,51,106,51,109,134,45,89,126,31,95,18,0.246575342465753,470,10.8510638297872
"5947",2017,"Manhattan",NA,NA,NA,6,23,8,5,0,12,0,12,10,22,9,10,14,3,11,18,3,15,0,0,61,14.7540983606557
"5948",2017,"Maryland-Eastern Shore",NA,NA,NA,30,68,36,19,0,51,0,23,34,57,15,46,63,17,46,65,22,43,12,0.4,219,6.84931506849315
"5949",2017,"Mississippi Valley State",NA,NA,NA,58,81,62,37,0,98,0,15,19,34,41,112,141,28,113,53,10,43,5,0.0862068965517241,314,13.0573248407643
"5950",2017,"Monmouth",NA,NA,NA,44,72,27,13,0,49,0,34,46,80,18,55,21,5,16,71,21,50,11,0.25,233,7.72532188841202
"5951",2017,"Montana",NA,NA,NA,14,27,14,10,0,23,0,4,5,9,8,15,33,8,25,16,4,12,2,0.142857142857143,75,10.6666666666667
"5952",2017,"Mount St. Mary's",NA,NA,NA,30,83,40,22,0,66,3,35,32,67,25,69,62,15,47,97,20,77,8,0.266666666666667,263,9.50570342205323
"5953",2017,"New Orleans",NA,NA,NA,39,84,42,29,0,90,0,24,24,48,24,77,127,43,84,63,20,43,10,0.256410256410256,292,8.21917808219178
"5954",2017,"Nicholls",NA,NA,NA,8,14,15,11,0,21,0,8,9,17,10,9,15,4,11,28,6,22,1,0.125,52,19.2307692307692
"5955",2017,"North Carolina A&T",NA,NA,NA,37,42,22,11,0,34,0,9,39,48,17,42,36,8,28,47,11,36,8,0.216216216216216,150,11.3333333333333
"5956",2017,"North Carolina Central",NA,NA,NA,19,39,7,3,0,26,0,4,11,15,9,34,69,12,57,23,8,15,3,0.157894736842105,117,7.69230769230769
"5957",2017,"North Dakota State",NA,NA,NA,20,52,35,22,0,31,0,14,16,30,11,40,43,17,26,24,7,17,4,0.2,158,6.9620253164557
"5958",2017,"North Florida",NA,NA,NA,28,67,30,19,0,59,0,19,31,50,14,75,50,13,37,44,15,29,12,0.428571428571429,225,6.22222222222222
"5959",2017,"Northeastern",NA,NA,NA,41,87,32,16,0,64,0,25,48,73,25,62,84,26,58,76,24,52,7,0.170731707317073,272,9.19117647058824
"5960",2017,"Northern Arizona",NA,NA,NA,26,47,29,20,0,43,1,13,12,25,9,22,43,14,29,59,19,40,8,0.307692307692308,148,6.08108108108108
"5961",2017,"Northern Kentucky",NA,NA,NA,26,30,21,12,0,38,0,22,19,41,14,32,37,11,26,42,9,33,9,0.346153846153846,133,10.5263157894737
"5962",2017,"Northwestern State",NA,NA,NA,47,73,30,20,0,73,1,22,18,40,27,90,103,19,84,75,14,61,7,0.148936170212766,274,9.85401459854015
"5963",2017,"Oakland",NA,NA,NA,48,113,53,32,0,89,1,52,69,121,35,73,64,24,40,130,44,86,14,0.291666666666667,365,9.58904109589041
"5964",2017,"Pacific",NA,NA,NA,29,75,41,26,0,55,0,20,25,45,24,53,71,20,51,74,24,50,11,0.379310344827586,232,10.3448275862069
"5965",2017,"Pennsylvania",NA,NA,NA,43,85,32,20,0,33,0,21,26,47,19,38,77,24,53,57,19,38,10,0.232558139534884,235,8.08510638297872
"5966",2017,"Pepperdine",NA,NA,NA,27,55,25,18,0,34,0,11,24,35,8,43,48,15,33,34,13,21,7,0.259259259259259,167,4.79041916167665
"5967",2017,"Portland",NA,NA,NA,47,107,49,33,0,95,0,38,49,87,27,84,119,34,85,66,15,51,10,0.212765957446809,336,8.03571428571429
"5968",2017,"Prairie View A&M",NA,NA,NA,41,89,50,32,0,67,0,27,39,66,26,73,128,40,88,49,10,39,6,0.146341463414634,291,8.93470790378007
"5969",2017,"Purdue Fort Wayne",NA,NA,NA,12,25,10,7,0,13,0,3,6,9,3,23,19,5,14,11,2,9,3,0.25,71,4.22535211267606
"5970",2017,"Rhode Island",NA,NA,NA,40,76,36,19,0,61,1,31,32,63,23,73,53,12,41,55,8,47,7,0.175,251,9.16334661354582
"5971",2017,"Rider",NA,NA,NA,43,93,56,42,0,68,0,55,64,119,36,60,59,13,46,49,17,32,15,0.348837209302326,300,12
"5972",2017,"Robert Morris",NA,NA,NA,40,95,50,31,0,69,0,51,29,80,34,51,79,26,53,70,19,51,12,0.3,289,11.7647058823529
"5973",2017,"SE Louisiana",NA,NA,NA,43,65,47,27,0,113,0,25,36,61,33,108,69,18,51,90,17,73,4,0.0930232558139535,290,11.3793103448276
"5974",2017,"Saint Joseph's",NA,NA,NA,57,101,49,37,0,71,0,60,64,124,23,53,56,19,37,56,15,41,16,0.280701754385965,319,7.21003134796238
"5975",2017,"Saint Peter's",NA,NA,NA,40,76,22,13,0,57,0,21,30,51,22,80,96,30,66,75,25,50,11,0.275,275,8
"5976",2017,"Sam Houston",NA,NA,NA,51,106,51,28,0,68,0,20,27,47,23,116,75,15,60,72,18,54,12,0.235294117647059,331,6.94864048338369
"5977",2017,"San Diego State",NA,NA,NA,17,43,28,17,0,32,1,16,8,24,13,36,48,12,36,36,11,25,5,0.294117647058824,138,9.42028985507246
"5978",2017,"San Francisco",NA,NA,NA,55,104,48,31,0,64,0,31,51,82,23,69,85,27,58,90,17,73,14,0.254545454545455,313,7.3482428115016
"5979",2017,"Savannah State",NA,NA,NA,35,83,19,14,0,52,0,18,18,36,26,78,96,21,75,72,21,51,7,0.2,261,9.96168582375479
"5980",2017,"Seton Hall",NA,NA,NA,80,193,103,68,0,134,1,82,71,153,75,176,119,31,88,167,53,114,21,0.2625,638,11.7554858934169
"5981",2017,"Siena",NA,NA,NA,20,50,28,17,0,42,0,22,24,46,12,46,27,4,23,34,11,23,4,0.2,158,7.59493670886076
"5982",2017,"Slippery Rock",NA,NA,NA,11,13,8,5,0,9,0,4,6,10,3,19,23,7,16,23,6,17,3,0.272727272727273,61,4.91803278688525
"5983",2017,"South Carolina State",NA,NA,NA,55,65,35,18,0,46,1,21,14,35,26,58,98,16,82,41,11,30,5,0.0909090909090909,234,11.1111111111111
"5984",2017,"South Carolina Upstate",NA,NA,NA,31,73,31,19,0,46,0,24,26,50,24,60,124,39,85,48,9,39,5,0.161290322580645,243,9.87654320987654
"5985",2017,"Southeast Missouri State",NA,NA,NA,16,21,12,7,0,22,0,2,1,3,5,11,48,18,30,19,3,16,3,0.1875,75,6.66666666666667
"5986",2017,"Southern",NA,NA,NA,77,137,70,44,0,133,0,46,35,81,43,109,209,58,151,85,30,55,18,0.233766233766234,474,9.07172995780591
"5987",2017,"Southern Utah",NA,NA,NA,37,75,38,26,0,56,0,22,29,51,23,40,104,23,81,36,5,31,6,0.162162162162162,212,10.8490566037736
"5988",2017,"St. Francis Brooklyn",NA,NA,NA,36,70,31,23,0,34,0,34,46,80,16,44,37,13,24,68,18,50,7,0.194444444444444,226,7.07964601769912
"5989",2017,"Stephen F. Austin",NA,NA,NA,49,129,67,45,0,83,1,57,47,104,38,85,89,22,67,67,17,50,13,0.26530612244898,373,10.1876675603217
"5990",2017,"Stony Brook",NA,NA,NA,28,65,23,15,0,45,2,24,37,61,19,61,35,16,19,58,21,37,7,0.25,220,8.63636363636364
"5991",2017,"Tennessee State",NA,NA,NA,40,67,27,17,0,63,0,20,33,53,24,61,53,14,39,71,17,54,6,0.15,227,10.5726872246696
"5992",2017,"Tennessee Tech",NA,NA,NA,25,47,26,17,0,48,1,19,26,45,8,38,34,9,25,42,15,27,6,0.24,162,4.93827160493827
"5993",2017,"Texas A&M-Corpus Christi",NA,NA,NA,43,106,62,44,0,81,0,25,32,57,26,80,99,33,66,53,19,34,9,0.209302325581395,321,8.09968847352025
"5994",2017,"Texas Southern",NA,NA,NA,48,110,55,29,0,65,0,48,36,84,31,77,71,26,45,61,21,40,16,0.333333333333333,344,9.01162790697674
"5995",2017,"Towson",NA,NA,NA,12,47,30,21,0,41,0,18,14,32,15,35,50,17,33,28,9,19,3,0.25,142,10.5633802816901
"5996",2017,"Troy",NA,NA,NA,107,142,65,47,0,103,1,46,63,109,37,84,111,38,73,114,29,85,33,0.308411214953271,463,7.99136069114471
"5997",2017,"UC Davis",NA,NA,NA,46,130,42,27,0,73,0,40,47,87,31,67,96,31,65,110,33,77,8,0.173913043478261,356,8.70786516853933
"5998",2017,"UC Irvine",NA,NA,NA,17,43,16,11,0,38,0,14,21,35,10,41,49,19,30,27,7,20,6,0.352941176470588,145,6.89655172413793
"5999",2017,"UC Santa Barbara",NA,NA,NA,48,91,42,29,0,60,0,37,34,71,27,66,68,27,41,77,31,46,11,0.229166666666667,307,8.79478827361564
"6000",2017,"UConn",NA,NA,NA,105,218,101,70,0,107,0,111,52,163,86,112,171,68,103,158,66,92,40,0.380952380952381,714,12.0448179271709
"6001",2017,"UIC",NA,NA,NA,49,87,48,25,0,78,0,44,33,77,36,96,76,19,57,62,16,46,13,0.26530612244898,322,11.1801242236025
"6002",2017,"UL Monroe",NA,NA,NA,43,73,41,24,0,63,0,26,16,42,15,59,86,19,67,47,11,36,12,0.27906976744186,241,6.22406639004149
"6003",2017,"UMBC",NA,NA,NA,36,85,36,22,0,48,0,27,50,77,36,67,72,23,49,85,19,66,10,0.277777777777778,267,13.4831460674157
"6004",2017,"UMass",NA,NA,NA,26,38,20,11,0,21,0,10,9,19,14,39,76,15,61,16,5,11,5,0.192307692307692,140,10
"6005",2017,"UMass Lowell",NA,NA,NA,10,53,16,10,0,42,0,15,13,28,6,68,36,11,25,29,7,22,2,0.2,167,3.59281437125748
"6006",2017,"UNC Greensboro",NA,NA,NA,88,165,76,45,0,121,0,85,69,154,52,96,136,42,94,76,17,59,22,0.25,510,10.1960784313725
"6007",2017,"UNC Wilmington",NA,NA,NA,35,99,46,27,0,66,1,24,33,57,25,53,95,29,66,72,13,59,7,0.2,262,9.54198473282443
"6008",2017,"UT Arlington",NA,NA,NA,67,91,52,38,0,108,0,51,52,103,57,79,80,20,60,116,27,89,13,0.194029850746269,343,16.6180758017493
"6009",2017,"UTEP",NA,NA,NA,48,86,39,27,0,81,1,25,37,62,26,75,83,33,50,68,14,54,7,0.145833333333333,292,8.9041095890411
"6010",2017,"UTSA",NA,NA,NA,31,77,44,26,0,56,0,15,22,37,24,42,99,33,66,45,10,35,8,0.258064516129032,220,10.9090909090909
"6011",2017,"Valparaiso",NA,NA,NA,49,82,28,17,0,61,0,42,36,78,22,86,56,19,37,90,34,56,16,0.326530612244898,321,6.85358255451713
"6012",2017,"Vermont",NA,NA,NA,12,49,20,14,0,37,0,12,22,34,8,39,20,6,14,43,14,29,1,0.0833333333333333,139,5.75539568345324
"6013",2017,"Western Carolina",NA,NA,NA,56,68,35,21,0,85,0,37,51,88,23,83,76,19,57,58,13,45,11,0.196428571428571,286,8.04195804195804
"6014",2017,"Wichita State",NA,NA,NA,66,103,51,32,0,98,0,39,31,70,45,83,166,61,105,88,23,65,23,0.348484848484849,387,11.6279069767442
"6015",2017,"William & Mary",NA,NA,NA,16,34,18,14,0,35,0,19,19,38,15,29,28,10,18,33,13,20,3,0.1875,125,12
"6016",2017,"Winthrop",NA,NA,NA,63,118,41,28,0,97,0,41,62,103,31,148,134,31,103,77,14,63,11,0.174603174603175,426,7.27699530516432
"6017",2017,"Wofford",NA,NA,NA,28,67,29,16,0,44,0,22,26,48,19,44,78,18,60,45,11,34,7,0.25,197,9.64467005076142
"6018",2017,"Yale",NA,NA,NA,13,20,1,1,0,8,0,3,8,11,1,19,24,6,18,29,8,21,5,0.384615384615385,69,1.44927536231884
"6019",2017,"Youngstown State",NA,NA,NA,21,30,18,12,0,24,0,9,13,22,13,22,33,11,22,61,19,42,5,0.238095238095238,117,11.1111111111111
"6020",2018,"Abilene Christian",NA,NA,NA,29,42,18,11,0,40,0,17,13,30,20,40,34,6,28,47,14,33,5,0.172413793103448,152,13.1578947368421
"6021",2018,"Air Force",NA,NA,NA,47,71,44,29,0,59,0,25,22,47,42,59,120,33,87,55,14,41,12,0.25531914893617,254,16.5354330708661
"6022",2018,"Akron",NA,NA,NA,11,31,8,7,0,19,0,4,10,14,3,16,12,2,10,34,16,18,1,0.0909090909090909,81,3.7037037037037
"6023",2018,"Alabama A&M",NA,NA,NA,13,24,2,1,0,25,1,0,2,2,1,31,46,14,32,13,1,12,3,0.230769230769231,84,1.19047619047619
"6024",2018,"Alabama State",NA,NA,NA,37,63,31,19,0,66,0,11,23,34,12,83,84,14,70,46,12,34,4,0.108108108108108,227,5.2863436123348
"6025",2018,"Albany",NA,NA,NA,24,50,15,10,0,48,1,19,18,37,16,47,49,15,34,32,12,20,11,0.458333333333333,170,9.41176470588235
"6026",2018,"Appalachian State",NA,NA,NA,70,120,69,38,0,85,1,33,43,76,27,97,115,37,78,76,17,59,12,0.171428571428571,391,6.90537084398977
"6027",2018,"Arkansas-Pine Bluff",NA,NA,NA,44,84,40,27,0,89,0,27,18,45,35,78,129,34,95,45,12,33,6,0.136363636363636,285,12.280701754386
"6028",2018,"Austin Peay",NA,NA,NA,20,41,17,12,0,40,0,10,8,18,15,36,50,9,41,38,11,27,7,0.35,132,11.3636363636364
"6029",2018,"Bethune-Cookman",NA,NA,NA,28,66,43,28,0,49,1,16,28,44,27,74,55,12,43,44,13,31,4,0.142857142857143,215,12.5581395348837
"6030",2018,"Bowling Green",NA,NA,NA,8,17,9,7,0,21,0,9,10,19,4,13,21,10,11,17,7,10,3,0.375,67,5.97014925373134
"6031",2018,"Bradley",NA,NA,NA,54,98,37,22,0,69,0,24,23,47,23,52,117,36,81,82,32,50,14,0.259259259259259,301,7.64119601328904
"6032",2018,"Brown",NA,NA,NA,11,20,3,3,0,22,0,10,11,21,4,11,10,3,7,41,16,25,6,0.545454545454545,72,5.55555555555556
"6033",2018,"Bryant",NA,NA,NA,22,55,21,15,0,39,0,28,41,69,7,31,26,6,20,24,4,20,7,0.318181818181818,152,4.60526315789474
"6034",2018,"Cal Poly",NA,NA,NA,28,45,27,21,0,45,0,10,12,22,21,38,66,18,48,47,9,38,5,0.178571428571429,153,13.7254901960784
"6035",2018,"Charleston",NA,NA,NA,46,122,50,30,0,98,0,44,51,95,36,106,121,32,89,77,29,48,11,0.239130434782609,392,9.18367346938776
"6036",2018,"Charleston Southern",NA,NA,NA,32,79,55,31,0,74,1,28,40,68,23,82,69,23,46,63,21,42,6,0.1875,279,8.24372759856631
"6037",2018,"Chicago State",NA,NA,NA,58,104,43,25,0,75,0,29,35,64,24,83,131,41,90,98,25,73,20,0.344827586206897,345,6.95652173913043
"6038",2018,"Cleveland State",NA,NA,NA,25,61,39,26,0,32,1,15,16,31,27,29,36,10,26,46,9,37,5,0.2,159,16.9811320754717
"6039",2018,"Coastal Carolina",NA,NA,NA,49,66,34,22,0,63,0,40,26,66,20,49,58,18,40,56,18,38,15,0.306122448979592,249,8.03212851405623
"6040",2018,"Colgate",NA,NA,NA,13,54,15,9,0,23,0,14,25,39,7,39,27,10,17,33,11,22,5,0.384615384615385,146,4.7945205479452
"6041",2018,"Columbia",NA,NA,NA,35,70,32,22,0,62,0,25,18,43,10,57,63,22,41,49,14,35,7,0.2,231,4.32900432900433
"6042",2018,"Cornell",NA,NA,NA,13,22,14,8,0,16,0,9,13,22,9,24,18,1,17,10,2,8,0,0,73,12.3287671232877
"6043",2018,"Dartmouth",NA,NA,NA,24,67,15,11,0,30,2,20,22,42,8,43,41,19,22,67,27,40,7,0.291666666666667,203,3.94088669950739
"6044",2018,"Davidson",NA,NA,NA,24,51,18,12,0,45,0,10,12,22,12,38,48,13,35,41,13,28,7,0.291666666666667,153,7.84313725490196
"6045",2018,"Delaware State",NA,NA,NA,63,106,52,27,0,86,0,35,38,73,37,64,159,42,117,108,20,88,13,0.206349206349206,347,10.6628242074928
"6046",2018,"East Carolina",NA,NA,NA,29,30,30,19,0,43,0,16,20,36,15,25,73,23,50,25,8,17,6,0.206896551724138,142,10.5633802816901
"6047",2018,"Eastern Illinois",NA,NA,NA,5,21,10,5,0,14,0,7,11,18,8,21,8,1,7,21,6,15,3,0.6,64,12.5
"6048",2018,"Eastern Kentucky",NA,NA,NA,12,20,12,7,0,0,0,0,0,0,2,0,0,0,0,0,0,0,0,0,36,5.55555555555556
"6049",2018,"Eastern Washington",NA,NA,NA,35,50,30,17,0,62,0,23,23,46,28,68,50,11,39,62,19,43,7,0.2,211,13.2701421800948
"6050",2018,"Evansville",NA,NA,NA,16,57,23,18,0,54,0,16,14,30,10,47,59,24,35,67,22,45,5,0.3125,187,5.3475935828877
"6051",2018,"Fairfield",NA,NA,NA,31,74,29,17,0,54,0,33,47,80,16,26,44,14,30,68,19,49,12,0.387096774193548,204,7.84313725490196
"6052",2018,"Fairleigh Dickinson",NA,NA,NA,21,38,10,5,0,30,0,14,17,31,11,48,34,7,27,50,19,31,5,0.238095238095238,150,7.33333333333333
"6053",2018,"Georgia State",NA,NA,NA,39,76,51,33,0,74,0,34,25,59,34,92,96,23,73,50,20,30,11,0.282051282051282,297,11.4478114478114
"6054",2018,"Gonzaga",NA,NA,NA,38,80,35,23,0,49,0,30,17,47,19,54,72,26,46,51,22,29,19,0.5,260,7.30769230769231
"6055",2018,"Hartford",NA,NA,NA,17,39,26,18,0,44,0,13,4,17,22,24,61,22,39,46,12,34,3,0.176470588235294,131,16.793893129771
"6056",2018,"Holy Cross",NA,NA,NA,23,42,21,12,0,45,0,13,24,37,21,24,48,13,35,44,15,29,6,0.260869565217391,137,15.3284671532847
"6057",2018,"Houston Christian",NA,NA,NA,5,33,2,2,0,13,0,8,14,22,3,13,23,3,20,21,6,15,2,0.4,69,4.34782608695652
"6058",2018,"Incarnate Word",NA,NA,NA,28,66,26,17,0,52,0,18,46,64,19,57,59,13,46,49,11,38,7,0.25,197,9.64467005076142
"6059",2018,"Iona",NA,NA,NA,35,52,23,17,0,50,0,19,24,43,19,57,48,18,30,65,18,47,12,0.342857142857143,205,9.26829268292683
"6060",2018,"Jacksonville State",NA,NA,NA,58,131,44,27,0,65,0,38,38,76,23,54,87,20,67,71,24,47,9,0.155172413793103,332,6.92771084337349
"6061",2018,"Kansas City",NA,NA,NA,54,83,52,33,0,58,1,26,27,53,29,51,114,27,87,87,22,65,10,0.185185185185185,277,10.4693140794224
"6062",2018,"Kennesaw State",NA,NA,NA,62,92,55,34,0,88,0,28,36,64,46,105,140,43,97,68,12,56,14,0.225806451612903,356,12.9213483146067
"6063",2018,"La Salle",NA,NA,NA,26,72,30,22,0,42,1,16,21,37,10,49,80,24,56,39,15,24,6,0.230769230769231,213,4.69483568075117
"6064",2018,"Liberty",NA,NA,NA,80,119,71,45,0,106,0,63,59,122,45,80,81,22,59,85,23,62,20,0.25,406,11.0837438423645
"6065",2018,"Long Beach State",NA,NA,NA,31,96,35,22,0,65,0,32,30,62,35,58,84,31,53,106,35,71,11,0.354838709677419,289,12.1107266435986
"6066",2018,"Longwood",NA,NA,NA,7,28,18,10,0,20,0,13,13,26,7,18,13,6,7,15,3,12,0,0,81,8.64197530864197
"6067",2018,"Loyola Chicago",NA,NA,NA,26,63,22,18,0,43,0,18,18,36,13,55,43,7,36,73,11,62,4,0.153846153846154,185,7.02702702702703
"6068",2018,"Loyola Marymount",NA,NA,NA,47,71,60,35,0,72,0,50,31,81,18,40,55,15,40,62,16,46,20,0.425531914893617,254,7.08661417322835
"6069",2018,"Maine",NA,NA,NA,59,109,52,31,0,96,0,31,26,57,46,93,87,28,59,143,40,103,13,0.220338983050847,374,12.2994652406417
"6070",2018,"Manhattan",NA,NA,NA,67,97,28,18,0,81,0,54,56,110,59,84,84,30,54,109,26,83,20,0.298507462686567,363,16.2534435261708
"6071",2018,"Maryland-Eastern Shore",NA,NA,NA,71,119,48,29,0,98,5,50,76,126,53,90,91,29,62,106,29,77,23,0.323943661971831,398,13.3165829145729
"6072",2018,"McNeese",NA,NA,NA,36,69,26,16,0,53,0,11,21,32,11,67,81,15,66,62,15,47,9,0.25,218,5.04587155963303
"6073",2018,"Memphis",NA,NA,NA,47,99,44,25,0,39,0,40,33,73,25,59,56,16,40,53,13,40,10,0.212765957446809,284,8.80281690140845
"6074",2018,"Mississippi Valley State",NA,NA,NA,37,35,33,18,0,40,2,12,21,33,19,47,54,11,43,29,4,25,6,0.162162162162162,153,12.4183006535948
"6075",2018,"Montana",NA,NA,NA,53,101,67,43,0,60,0,51,30,81,22,42,101,30,71,68,17,51,16,0.30188679245283,309,7.11974110032362
"6076",2018,"Morehead State",NA,NA,NA,62,81,57,35,0,48,0,18,17,35,30,44,112,31,81,37,8,29,12,0.193548387096774,259,11.5830115830116
"6077",2018,"Morgan State",NA,NA,NA,61,86,56,34,0,88,0,34,48,82,36,85,74,26,48,67,19,48,13,0.213114754098361,327,11.0091743119266
"6078",2018,"Mount St. Mary's",NA,NA,NA,11,20,12,9,0,16,0,10,15,25,3,25,13,3,10,17,6,11,3,0.272727272727273,79,3.79746835443038
"6079",2018,"Murray State",NA,NA,NA,25,62,22,12,0,38,0,20,9,29,23,52,83,31,52,74,14,60,11,0.44,210,10.952380952381
"6080",2018,"NJIT",NA,NA,NA,5,22,15,9,0,15,0,11,5,16,7,23,14,7,7,17,4,13,1,0.2,73,9.58904109589041
"6081",2018,"New Mexico State",NA,NA,NA,47,94,47,29,0,85,0,44,40,84,45,56,132,55,77,85,23,62,10,0.212765957446809,330,13.6363636363636
"6082",2018,"New Orleans",NA,NA,NA,38,45,15,9,0,37,0,9,20,29,10,43,57,8,49,40,14,26,6,0.157894736842105,160,6.25
"6083",2018,"Niagara",NA,NA,NA,41,68,45,29,0,62,0,35,49,84,28,60,44,7,37,51,20,31,5,0.121951219512195,244,11.4754098360656
"6084",2018,"North Carolina Central",NA,NA,NA,42,51,35,22,0,66,1,15,19,34,25,64,86,24,62,63,20,43,8,0.19047619047619,226,11.0619469026549
"6085",2018,"North Dakota",NA,NA,NA,37,84,35,21,0,58,0,17,23,40,11,48,71,20,51,67,17,50,9,0.243243243243243,232,4.74137931034483
"6086",2018,"North Dakota State",NA,NA,NA,16,52,25,16,0,28,0,14,30,44,11,36,38,13,25,47,14,33,4,0.25,148,7.43243243243243
"6087",2018,"Northeastern",NA,NA,NA,20,53,11,6,0,41,0,17,30,47,16,28,20,6,14,59,18,41,6,0.3,144,11.1111111111111
"6088",2018,"Northern Arizona",NA,NA,NA,27,61,22,15,0,31,0,25,18,43,18,30,47,11,36,41,16,25,2,0.0740740740740741,174,10.3448275862069
"6089",2018,"Northern Kentucky",NA,NA,NA,64,116,60,42,0,87,0,39,39,78,31,84,71,19,52,111,34,77,12,0.1875,371,8.35579514824798
"6090",2018,"Northwestern State",NA,NA,NA,33,76,33,21,0,81,0,17,16,33,27,71,94,25,69,88,22,66,3,0.0909090909090909,250,10.8
"6091",2018,"Omaha",NA,NA,NA,27,40,13,6,0,31,0,11,18,29,7,38,34,11,23,56,22,34,4,0.148148148148148,152,4.60526315789474
"6092",2018,"Pacific",NA,NA,NA,48,82,62,43,0,85,0,46,45,91,39,47,94,37,57,81,24,57,11,0.229166666666667,298,13.0872483221477
"6093",2018,"Pepperdine",NA,NA,NA,25,66,37,22,0,56,0,26,17,43,18,49,70,30,40,53,21,32,9,0.36,224,8.03571428571429
"6094",2018,"Portland",NA,NA,NA,20,46,23,15,0,31,0,18,19,37,10,43,51,21,30,31,9,22,7,0.35,163,6.13496932515337
"6095",2018,"Presbyterian",NA,NA,NA,32,66,21,15,0,55,0,19,16,35,33,75,56,17,39,117,34,83,10,0.3125,247,13.3603238866397
"6096",2018,"Princeton",NA,NA,NA,31,47,19,12,0,36,0,17,19,36,15,37,28,12,16,47,17,30,9,0.290322580645161,163,9.20245398773006
"6097",2018,"Purdue Fort Wayne",NA,NA,NA,31,65,20,13,0,43,0,20,25,45,11,59,53,8,45,52,17,35,9,0.290322580645161,202,5.44554455445545
"6098",2018,"Rhode Island",NA,NA,NA,22,36,30,19,0,37,1,17,15,32,19,47,35,7,28,32,5,27,3,0.136363636363636,143,13.2867132867133
"6099",2018,"Rider",NA,NA,NA,18,54,30,25,0,41,0,20,31,51,9,30,42,9,33,21,11,10,5,0.277777777777778,148,6.08108108108108
"6100",2018,"SE Louisiana",NA,NA,NA,29,48,31,18,0,60,0,18,20,38,23,75,34,7,27,86,30,56,7,0.241379310344828,215,10.6976744186047
"6101",2018,"Sacramento State",NA,NA,NA,59,88,41,24,0,95,0,43,29,72,24,67,79,21,58,123,30,93,12,0.203389830508475,322,7.45341614906832
"6102",2018,"Sacred Heart",NA,NA,NA,31,92,46,29,0,56,0,28,46,74,17,56,32,7,25,71,22,49,5,0.161290322580645,247,6.88259109311741
"6103",2018,"Saint Peter's",NA,NA,NA,21,24,10,8,0,22,0,3,9,12,12,26,23,5,18,21,6,15,5,0.238095238095238,88,13.6363636363636
"6104",2018,"Sam Houston",NA,NA,NA,32,61,11,6,0,30,1,12,3,15,11,41,60,16,44,48,16,32,5,0.15625,181,6.07734806629834
"6105",2018,"San José State",NA,NA,NA,50,96,48,33,0,63,1,24,46,70,29,67,109,29,80,95,27,68,10,0.2,300,9.66666666666667
"6106",2018,"Santa Clara",NA,NA,NA,45,67,49,32,0,68,0,39,41,80,35,74,57,14,43,66,14,52,11,0.244444444444444,267,13.1086142322097
"6107",2018,"Seton Hall",NA,NA,NA,85,175,69,42,0,126,0,106,101,207,64,119,98,34,64,106,29,77,24,0.282352941176471,561,11.4081996434938
"6108",2018,"Siena",NA,NA,NA,40,72,45,26,0,59,1,46,47,93,37,57,30,3,27,65,18,47,8,0.2,245,15.1020408163265
"6109",2018,"South Carolina State",NA,NA,NA,55,101,58,34,0,74,0,32,56,88,31,102,79,25,54,47,13,34,17,0.309090909090909,340,9.11764705882353
"6110",2018,"South Carolina Upstate",NA,NA,NA,22,70,40,25,0,56,0,26,26,52,9,70,47,12,35,57,22,35,5,0.227272727272727,230,3.91304347826087
"6111",2018,"St. Francis (PA)",NA,NA,NA,27,57,19,15,0,24,0,21,21,42,23,30,17,6,11,71,29,42,7,0.259259259259259,177,12.9943502824859
"6112",2018,"Stephen F. Austin",NA,NA,NA,34,65,44,27,0,57,0,23,37,60,19,45,39,13,26,85,28,57,12,0.352941176470588,217,8.75576036866359
"6113",2018,"Tennessee State",NA,NA,NA,23,37,24,12,0,30,1,12,17,29,10,29,49,10,39,45,13,32,4,0.173913043478261,128,7.8125
"6114",2018,"Tennessee Tech",NA,NA,NA,21,47,27,19,0,42,0,18,4,22,12,42,63,13,50,19,4,15,6,0.285714285714286,152,7.89473684210526
"6115",2018,"Texas A&M-Corpus Christi",NA,NA,NA,45,59,18,13,0,30,0,30,20,50,21,29,44,8,36,46,12,34,15,0.333333333333333,185,11.3513513513514
"6116",2018,"Texas Southern",NA,NA,NA,48,79,40,27,0,72,0,32,33,65,33,79,79,18,61,75,22,53,8,0.166666666666667,290,11.3793103448276
"6117",2018,"Towson",NA,NA,NA,39,44,22,13,0,44,0,11,22,33,15,46,57,18,39,40,12,28,10,0.256410256410256,178,8.42696629213483
"6118",2018,"UAB",NA,NA,NA,66,162,67,45,0,108,0,88,76,164,36,76,99,27,72,148,45,103,21,0.318181818181818,482,7.46887966804979
"6119",2018,"UL Monroe",NA,NA,NA,24,67,32,17,0,42,0,20,28,48,16,73,48,18,30,54,18,36,4,0.166666666666667,227,7.04845814977974
"6120",2018,"UMBC",NA,NA,NA,11,24,19,11,0,15,0,9,4,13,5,14,14,6,8,27,9,18,5,0.454545454545455,77,6.49350649350649
"6121",2018,"UMass Lowell",NA,NA,NA,31,49,22,15,0,37,0,28,27,55,13,29,42,13,29,35,9,26,17,0.548387096774194,167,7.78443113772455
"6122",2018,"UNC Wilmington",NA,NA,NA,42,97,53,35,0,57,0,36,25,61,28,87,88,21,67,55,16,39,6,0.142857142857143,314,8.9171974522293
"6123",2018,"UT Rio Grande Valley",NA,NA,NA,78,116,44,26,0,93,0,44,38,82,34,83,109,32,77,129,30,99,24,0.307692307692308,392,8.6734693877551
"6124",2018,"UTSA",NA,NA,NA,36,98,28,19,0,70,0,40,35,75,20,79,101,36,65,62,21,41,15,0.416666666666667,317,6.30914826498423
"6125",2018,"Utah State",NA,NA,NA,35,78,29,18,0,60,0,33,30,63,24,63,95,32,63,66,15,51,9,0.257142857142857,260,9.23076923076923
"6126",2018,"Utah Valley",NA,NA,NA,19,31,15,9,0,18,0,16,34,50,11,21,32,9,23,32,11,21,2,0.105263157894737,109,10.0917431192661
"6127",2018,"VCU",NA,NA,NA,26,34,32,23,0,42,0,9,10,19,9,31,75,28,47,27,6,21,5,0.192307692307692,142,6.33802816901408
"6128",2018,"Vermont",NA,NA,NA,11,24,12,8,0,28,0,5,6,11,7,30,21,7,14,18,4,14,2,0.181818181818182,83,8.43373493975904
"6129",2018,"Wagner",NA,NA,NA,4,18,3,3,0,13,0,7,13,20,6,35,9,3,6,13,2,11,1,0.25,69,8.69565217391304
"6130",2018,"Western Carolina",NA,NA,NA,13,51,20,12,0,24,0,13,14,27,10,46,31,8,23,32,11,21,3,0.230769230769231,146,6.84931506849315
"6131",2018,"Westminster College (MO)",NA,NA,NA,11,24,9,5,0,13,0,4,7,11,6,28,19,7,12,27,5,22,1,0.0909090909090909,80,7.5
"6132",2018,"William & Mary",NA,NA,NA,18,25,18,9,0,20,0,12,21,33,8,14,19,3,16,16,3,13,3,0.166666666666667,80,10
"6133",2018,"Winthrop",NA,NA,NA,23,41,15,8,0,28,0,20,18,38,12,44,36,7,29,28,7,21,4,0.173913043478261,145,8.27586206896552
"6134",2018,"Wofford",NA,NA,NA,33,69,39,28,0,55,0,15,12,27,9,50,103,29,74,47,15,32,4,0.121212121212121,221,4.07239819004525
"6135",2018,"Xavier (LA)",NA,NA,NA,12,26,4,2,0,21,0,8,2,10,8,30,15,2,13,28,7,21,6,0.5,86,9.30232558139535
"6136",2019,"Akron",NA,NA,NA,7,17,6,4,0,21,0,9,8,17,6,13,11,4,7,29,9,20,1,0.142857142857143,60,10
"6137",2019,"Alabama A&M",NA,NA,NA,38,74,49,28,0,56,1,26,26,52,19,49,65,20,45,50,13,37,13,0.342105263157895,230,8.26086956521739
"6138",2019,"Alabama State",NA,NA,NA,53,122,67,40,0,120,1,26,31,57,27,147,105,27,78,66,18,48,13,0.245283018867925,406,6.65024630541872
"6139",2019,"Alcorn State",NA,NA,NA,9,26,10,5,0,16,0,3,19,22,4,30,17,7,10,5,1,4,2,0.222222222222222,76,5.26315789473684
"6140",2019,"Arkansas-Pine Bluff",NA,NA,NA,15,31,20,10,0,39,0,10,17,27,25,39,68,16,52,18,2,16,4,0.266666666666667,115,21.7391304347826
"6141",2019,"Austin Peay",NA,NA,NA,28,33,19,11,0,46,0,18,26,44,14,14,26,10,16,57,17,40,7,0.25,123,11.3821138211382
"6142",2019,"Ball State",NA,NA,NA,38,59,38,23,0,49,1,33,26,59,26,64,48,9,39,55,8,47,9,0.236842105263158,218,11.9266055045872
"6143",2019,"Boston University",NA,NA,NA,28,33,16,8,0,22,0,22,29,51,7,30,33,12,21,32,14,18,10,0.357142857142857,144,4.86111111111111
"6144",2019,"Bowling Green",NA,NA,NA,7,21,11,8,0,17,0,12,17,29,9,15,10,3,7,21,7,14,1,0.142857142857143,69,13.0434782608696
"6145",2019,"Brown",NA,NA,NA,18,42,18,11,0,26,0,11,18,29,13,34,30,13,17,55,16,39,6,0.333333333333333,138,9.42028985507246
"6146",2019,"Bryant",NA,NA,NA,43,77,47,31,0,49,0,41,44,85,19,77,45,10,35,38,8,30,13,0.302325581395349,262,7.25190839694656
"6147",2019,"Bucknell",NA,NA,NA,33,70,26,20,0,56,0,31,25,56,34,55,49,16,33,75,19,56,9,0.272727272727273,229,14.8471615720524
"6148",2019,"Cal Poly",NA,NA,NA,31,40,13,8,0,31,0,8,17,25,13,34,61,15,46,33,9,24,4,0.129032258064516,138,9.42028985507246
"6149",2019,"Cal State Bakersfield",NA,NA,NA,39,57,21,15,0,50,0,26,29,55,27,26,83,29,54,58,17,41,12,0.307692307692308,201,13.4328358208955
"6150",2019,"Cal State Fullerton",NA,NA,NA,17,19,12,5,0,14,0,12,11,23,3,13,15,4,11,16,5,11,6,0.352941176470588,73,4.10958904109589
"6151",2019,"California Baptist",NA,NA,NA,8,23,18,11,0,22,0,21,18,39,6,18,4,1,3,15,6,9,1,0.125,80,7.5
"6152",2019,"Canisius",NA,NA,NA,5,28,7,7,0,25,0,6,7,13,7,19,24,6,18,15,5,10,1,0.2,69,10.1449275362319
"6153",2019,"Charleston",NA,NA,NA,18,25,5,2,0,19,0,6,13,19,5,13,22,7,15,17,4,13,4,0.222222222222222,74,6.75675675675676
"6154",2019,"Chicago State",NA,NA,NA,38,78,31,20,0,66,0,18,27,45,20,82,79,16,63,36,8,28,6,0.157894736842105,244,8.19672131147541
"6155",2019,"Clarke College",NA,NA,NA,19,20,7,6,0,12,0,5,13,18,8,23,25,5,20,21,4,17,5,0.263157894736842,77,10.3896103896104
"6156",2019,"Cleveland State",NA,NA,NA,11,24,7,3,0,17,0,5,7,12,8,16,21,6,15,22,1,21,1,0.0909090909090909,63,12.6984126984127
"6157",2019,"Colgate",NA,NA,NA,8,28,5,3,0,23,0,12,16,28,9,18,16,8,8,21,8,13,4,0.5,84,10.7142857142857
"6158",2019,"Columbia",NA,NA,NA,13,22,10,7,0,15,1,11,20,31,5,16,11,4,7,19,6,13,2,0.153846153846154,73,6.84931506849315
"6159",2019,"Cornell",NA,NA,NA,31,41,16,7,0,34,0,22,32,54,16,40,40,6,34,23,9,14,7,0.225806451612903,152,10.5263157894737
"6160",2019,"Dartmouth",NA,NA,NA,12,17,10,6,0,23,0,17,11,28,5,26,12,5,7,19,6,13,5,0.416666666666667,86,5.81395348837209
"6161",2019,"Delaware",NA,NA,NA,22,24,9,6,0,22,0,6,11,17,8,19,49,15,34,8,1,7,5,0.227272727272727,90,8.88888888888889
"6162",2019,"Delaware State",NA,NA,NA,18,18,11,7,0,19,0,14,18,32,12,16,19,8,11,16,3,13,5,0.277777777777778,79,15.1898734177215
"6163",2019,"Detroit Mercy",NA,NA,NA,11,43,18,14,0,30,0,19,9,28,5,50,35,8,27,31,9,22,3,0.272727272727273,145,3.44827586206897
"6164",2019,"East Tennessee State",NA,NA,NA,76,107,93,53,0,96,2,54,98,152,43,104,78,23,55,67,16,51,13,0.171052631578947,399,10.7769423558897
"6165",2019,"Evansville",NA,NA,NA,22,71,34,25,0,59,0,21,24,45,20,43,44,12,32,85,25,60,4,0.181818181818182,204,9.80392156862745
"6166",2019,"Fairleigh Dickinson",NA,NA,NA,7,20,10,7,0,21,0,4,10,14,8,20,14,4,10,16,4,12,2,0.285714285714286,62,12.9032258064516
"6167",2019,"Florida A&M",NA,NA,NA,58,90,44,26,0,71,0,31,65,96,34,95,82,23,59,62,11,51,12,0.206896551724138,321,10.5919003115265
"6168",2019,"Florida Atlantic",NA,NA,NA,12,49,16,9,0,26,0,17,19,36,13,38,28,6,22,49,16,33,4,0.333333333333333,141,9.21985815602837
"6169",2019,"Florida Gulf Coast",NA,NA,NA,25,56,20,12,0,49,0,29,23,52,30,43,13,0,13,111,31,80,4,0.16,190,15.7894736842105
"6170",2019,"Florida International",NA,NA,NA,7,27,13,9,0,15,0,3,13,16,5,15,13,1,12,22,7,15,0,0,62,8.06451612903226
"6171",2019,"George Washington",NA,NA,NA,38,89,33,17,0,48,1,20,27,47,21,54,78,21,57,88,29,59,12,0.31578947368421,254,8.26771653543307
"6172",2019,"Georgia Southern",NA,NA,NA,23,41,19,12,0,31,1,17,32,49,15,35,42,8,34,25,5,20,4,0.173913043478261,133,11.2781954887218
"6173",2019,"Grand Canyon",NA,NA,NA,10,21,10,6,0,11,0,8,2,10,6,14,18,5,13,23,8,15,1,0.1,68,8.82352941176471
"6174",2019,"Hampton",NA,NA,NA,22,37,19,13,0,39,0,21,38,59,13,23,30,11,19,28,8,20,6,0.272727272727273,126,10.3174603174603
"6175",2019,"Howard",NA,NA,NA,44,79,36,17,0,58,0,28,31,59,23,57,67,26,41,66,13,53,10,0.227272727272727,253,9.09090909090909
"6176",2019,"Idaho",NA,NA,NA,75,155,49,32,0,102,2,52,26,78,25,69,133,54,79,199,60,139,16,0.213333333333333,480,5.20833333333333
"6177",2019,"Incarnate Word",NA,NA,NA,38,67,25,12,0,47,1,18,42,60,22,56,70,19,51,54,12,42,5,0.131578947368421,218,10.0917431192661
"6178",2019,"Iona",NA,NA,NA,28,71,25,16,0,50,0,27,28,55,11,70,29,7,22,57,24,33,7,0.25,232,4.74137931034483
"6179",2019,"Jacksonville",NA,NA,NA,47,85,41,24,0,79,1,42,50,92,30,77,77,24,53,54,15,39,9,0.191489361702128,299,10.0334448160535
"6180",2019,"Jacksonville State",NA,NA,NA,44,72,35,18,0,54,0,22,11,33,17,35,89,29,60,79,18,61,10,0.227272727272727,228,7.45614035087719
"6181",2019,"LIU Brooklyn",NA,NA,NA,10,20,12,6,0,17,0,5,9,14,4,23,11,2,9,29,6,23,4,0.4,69,5.79710144927536
"6182",2019,"La Salle",NA,NA,NA,15,42,29,15,0,38,0,7,17,24,11,24,53,13,40,35,7,28,1,0.0666666666666667,114,9.64912280701754
"6183",2019,"Lafayette",NA,NA,NA,27,42,18,12,0,38,0,23,25,48,12,22,27,7,20,37,11,26,7,0.259259259259259,139,8.63309352517986
"6184",2019,"Lehigh",NA,NA,NA,30,70,56,34,0,50,0,34,29,63,23,48,53,18,35,52,17,35,11,0.366666666666667,228,10.0877192982456
"6185",2019,"Liberty",NA,NA,NA,48,106,39,30,0,47,20,45,46,91,43,73,64,25,39,64,22,42,18,0.375,330,13.030303030303
"6186",2019,"Long Beach State",NA,NA,NA,56,118,64,36,0,98,0,43,40,83,36,101,96,33,63,137,37,100,19,0.339285714285714,408,8.82352941176471
"6187",2019,"Loyola Chicago",NA,NA,NA,30,122,41,27,0,61,0,42,36,78,16,77,81,30,51,68,25,43,14,0.466666666666667,338,4.73372781065089
"6188",2019,"Loyola Maryland",NA,NA,NA,26,48,15,13,0,27,0,16,25,41,11,33,25,6,19,39,13,26,8,0.307692307692308,144,7.63888888888889
"6189",2019,"Maine",NA,NA,NA,42,55,25,18,0,41,0,22,23,45,31,26,49,17,32,94,31,63,13,0.30952380952381,197,15.7360406091371
"6190",2019,"Manhattan",NA,NA,NA,20,59,12,7,0,26,0,26,15,41,11,26,51,18,33,18,5,13,6,0.3,158,6.9620253164557
"6191",2019,"Marist",NA,NA,NA,39,107,40,31,0,56,0,38,32,70,20,63,60,20,40,87,28,59,10,0.256410256410256,307,6.51465798045603
"6192",2019,"Maryland-Eastern Shore",NA,NA,NA,85,119,27,17,0,87,1,36,55,91,30,75,92,31,61,135,38,97,19,0.223529411764706,392,7.6530612244898
"6193",2019,"McNeese",NA,NA,NA,28,41,14,9,0,35,0,7,15,22,15,66,61,16,45,30,5,25,5,0.178571428571429,164,9.14634146341463
"6194",2019,"Mississippi Valley State",NA,NA,NA,10,13,18,9,0,16,0,6,14,20,4,27,17,7,10,10,3,7,0,0,71,5.63380281690141
"6195",2019,"Montana State",NA,NA,NA,25,40,16,9,0,35,0,11,13,24,18,37,45,18,27,42,12,30,4,0.16,146,12.3287671232877
"6196",2019,"Murray State",NA,NA,NA,38,83,45,30,0,50,0,35,22,57,27,69,96,31,65,76,18,58,10,0.263157894736842,284,9.50704225352113
"6197",2019,"Navy",NA,NA,NA,38,35,27,14,0,36,0,17,25,42,17,25,36,9,27,40,6,34,8,0.210526315789474,139,12.2302158273381
"6198",2019,"New Hampshire",NA,NA,NA,15,24,9,5,0,19,0,6,15,21,0,21,10,1,9,17,5,12,2,0.133333333333333,74,0
"6199",2019,"New Orleans",NA,NA,NA,49,72,36,19,0,56,0,21,35,56,15,68,71,14,57,41,9,32,11,0.224489795918367,239,6.27615062761506
"6200",2019,"North Carolina A&T",NA,NA,NA,38,77,40,23,0,51,0,32,32,64,23,49,53,14,39,54,12,42,8,0.210526315789474,235,9.78723404255319
"6201",2019,"North Carolina Central",NA,NA,NA,25,55,33,27,0,64,0,36,36,72,26,65,51,15,36,39,7,32,3,0.12,210,12.3809523809524
"6202",2019,"North Dakota",NA,NA,NA,66,129,40,29,0,120,0,56,47,103,24,112,101,30,71,98,25,73,22,0.333333333333333,428,5.60747663551402
"6203",2019,"North Dakota State",NA,NA,NA,20,62,27,16,0,59,0,28,22,50,12,61,30,10,20,57,21,36,6,0.3,207,5.79710144927536
"6204",2019,"Northern Arizona",NA,NA,NA,39,85,44,30,0,47,0,18,12,30,16,40,118,35,83,44,14,30,11,0.282051282051282,241,6.63900414937759
"6205",2019,"Northern Iowa",NA,NA,NA,66,126,51,35,0,101,0,57,62,119,35,87,80,30,50,166,52,114,21,0.318181818181818,431,8.12064965197216
"6206",2019,"Northern Kentucky",NA,NA,NA,25,40,19,11,0,34,0,23,25,48,9,34,27,8,19,30,7,23,10,0.4,139,6.47482014388489
"6207",2019,"Northwestern State",NA,NA,NA,40,68,58,33,0,112,1,35,35,70,38,83,88,28,60,84,25,59,7,0.175,288,13.1944444444444
"6208",2019,"Oakland",NA,NA,NA,48,93,51,32,0,85,0,29,39,68,34,79,91,19,72,93,22,71,14,0.291666666666667,302,11.2582781456954
"6209",2019,"Omaha",NA,NA,NA,9,28,8,5,0,18,0,10,16,26,8,19,20,4,16,11,4,7,3,0.333333333333333,76,10.5263157894737
"6210",2019,"Pennsylvania",NA,NA,NA,40,81,36,23,0,32,1,31,12,43,25,54,73,24,49,53,19,34,16,0.4,253,9.88142292490119
"6211",2019,"Presbyterian",NA,NA,NA,60,111,56,36,0,93,3,43,63,106,30,100,70,13,57,91,33,58,17,0.283333333333333,371,8.08625336927224
"6212",2019,"Purdue Fort Wayne",NA,NA,NA,19,34,16,9,0,38,0,16,14,30,13,30,41,8,33,44,11,33,1,0.0526315789473684,124,10.4838709677419
"6213",2019,"Radford",NA,NA,NA,77,162,75,50,0,83,0,58,68,126,22,69,123,30,93,94,20,74,16,0.207792207792208,434,5.06912442396313
"6214",2019,"Rhode Island",NA,NA,NA,30,67,33,18,0,55,0,41,21,62,25,69,60,20,40,50,13,37,8,0.266666666666667,249,10.0401606425703
"6215",2019,"Rice",NA,NA,NA,74,226,98,71,0,102,1,83,75,158,41,127,100,34,66,141,52,89,22,0.297297297297297,623,6.58105939004815
"6216",2019,"Richmond",NA,NA,NA,35,50,15,8,0,61,1,26,32,58,25,33,75,25,50,55,14,41,6,0.171428571428571,185,13.5135135135135
"6217",2019,"Rider",NA,NA,NA,31,69,20,13,0,57,0,26,18,44,18,38,64,17,47,73,15,58,9,0.290322580645161,203,8.86699507389163
"6218",2019,"SE Louisiana",NA,NA,NA,22,35,13,8,0,49,0,6,5,11,20,37,59,15,44,54,13,41,6,0.272727272727273,133,15.0375939849624
"6219",2019,"SIU Edwardsville",NA,NA,NA,29,42,11,7,0,32,0,9,8,17,16,32,69,16,53,33,11,22,7,0.241379310344828,142,11.2676056338028
"6220",2019,"Sacred Heart",NA,NA,NA,31,63,35,18,0,46,1,33,25,58,15,45,45,10,35,59,19,40,6,0.193548387096774,208,7.21153846153846
"6221",2019,"Saint Louis",NA,NA,NA,52,97,34,20,0,64,0,37,46,83,16,57,76,25,51,76,21,55,13,0.25,298,5.36912751677852
"6222",2019,"Saint Peter's",NA,NA,NA,27,40,11,8,0,36,0,20,38,58,15,36,52,14,38,27,6,21,6,0.222222222222222,144,10.4166666666667
"6223",2019,"Samford",NA,NA,NA,32,113,41,24,0,105,1,32,36,68,18,91,55,16,39,122,41,81,10,0.3125,333,5.4054054054054
"6224",2019,"Santa Clara",NA,NA,NA,42,112,46,29,0,88,0,49,55,104,34,71,64,16,48,109,29,80,11,0.261904761904762,330,10.3030303030303
"6225",2019,"Savannah State",NA,NA,NA,40,63,40,24,0,64,0,29,38,67,30,52,67,14,53,63,15,48,9,0.225,224,13.3928571428571
"6226",2019,"Siena",NA,NA,NA,14,16,22,12,0,21,0,15,10,25,16,17,12,2,10,18,5,13,7,0.5,74,21.6216216216216
"6227",2019,"South Carolina State",NA,NA,NA,58,97,50,28,0,49,1,25,53,78,30,67,89,21,68,58,13,45,7,0.120689655172414,295,10.1694915254237
"6228",2019,"South Carolina Upstate",NA,NA,NA,16,43,22,14,0,30,0,13,10,23,15,37,42,17,25,42,12,30,4,0.25,144,10.4166666666667
"6229",2019,"Southern Utah",NA,NA,NA,31,45,23,16,0,24,0,3,0,3,10,26,79,26,53,35,10,25,9,0.290322580645161,147,6.80272108843537
"6230",2019,"St. Bonaventure",NA,NA,NA,26,86,35,22,0,59,0,18,28,46,15,46,64,16,48,56,17,39,2,0.0769230769230769,215,6.97674418604651
"6231",2019,"Tennessee State",NA,NA,NA,47,65,35,24,0,70,0,39,36,75,21,67,66,18,48,45,11,34,17,0.361702127659574,253,8.300395256917
"6232",2019,"Texas Southern",NA,NA,NA,33,54,37,17,0,70,0,33,45,78,24,52,42,13,29,44,16,28,9,0.272727272727273,209,11.4832535885167
"6233",2019,"UAB",NA,NA,NA,30,76,35,23,0,51,0,33,33,66,12,31,49,15,34,62,18,44,7,0.233333333333333,209,5.74162679425837
"6234",2019,"UC Davis",NA,NA,NA,35,106,42,30,0,53,1,45,31,76,28,52,67,17,50,84,29,55,11,0.314285714285714,292,9.58904109589041
"6235",2019,"UConn",NA,NA,NA,160,397,151,104,0,135,1,201,122,323,105,139,201,93,108,275,107,168,55,0.34375,1127,9.3167701863354
"6236",2019,"UIC",NA,NA,NA,32,60,36,19,0,63,0,25,33,58,19,73,51,10,41,54,9,45,10,0.3125,215,8.83720930232558
"6237",2019,"UL Monroe",NA,NA,NA,8,24,12,6,0,14,0,3,5,8,4,19,26,8,18,16,4,12,1,0.125,68,5.88235294117647
"6238",2019,"UMBC",NA,NA,NA,19,50,12,8,0,38,0,17,18,35,10,50,24,5,19,47,18,29,3,0.157894736842105,162,6.17283950617284
"6239",2019,"UNC Greensboro",NA,NA,NA,30,42,16,8,0,33,0,17,22,39,12,21,47,13,34,44,17,27,11,0.366666666666667,141,8.51063829787234
"6240",2019,"UT Martin",NA,NA,NA,65,129,49,40,0,97,0,39,45,84,41,77,131,40,91,100,34,66,23,0.353846153846154,401,10.2244389027431
"6241",2019,"UTSA",NA,NA,NA,26,35,6,4,0,29,0,13,23,36,8,36,52,14,38,34,11,23,3,0.115384615384615,135,5.92592592592593
"6242",2019,"VCU",NA,NA,NA,74,186,114,71,0,123,0,74,72,146,37,101,135,38,97,81,26,55,20,0.27027027027027,529,6.99432892249527
"6243",2019,"Valparaiso",NA,NA,NA,18,56,24,18,0,60,1,22,25,47,26,48,37,14,23,91,30,61,4,0.222222222222222,195,13.3333333333333
"6244",2019,"Vermont",NA,NA,NA,16,46,27,19,0,30,0,14,19,33,8,31,32,13,19,28,4,24,1,0.0625,132,6.06060606060606
"6245",2019,"Wagner",NA,NA,NA,14,22,8,6,0,21,1,11,11,22,5,22,11,7,4,14,2,12,2,0.142857142857143,80,6.25
"6246",2019,"Weber State",NA,NA,NA,15,46,19,13,0,32,0,10,6,16,11,32,61,24,37,40,14,26,1,0.0666666666666667,144,7.63888888888889
"6247",2019,"Western Carolina",NA,NA,NA,17,38,16,8,0,18,0,12,17,29,16,38,41,10,31,36,6,30,2,0.117647058823529,125,12.8
"6248",2019,"Wichita State",NA,NA,NA,48,94,52,30,0,72,1,41,54,95,25,67,90,24,66,44,10,34,11,0.229166666666667,295,8.47457627118644
"6249",2019,"William & Mary",NA,NA,NA,13,50,20,14,0,25,0,24,13,37,10,21,27,10,17,38,11,27,7,0.538461538461538,134,7.46268656716418
"6250",2019,"Winthrop",NA,NA,NA,36,68,28,17,0,53,0,20,27,47,31,49,106,25,81,38,5,33,8,0.222222222222222,209,14.8325358851675
"6251",2019,"Wofford",NA,NA,NA,55,107,48,27,0,75,0,28,28,56,25,77,131,44,87,73,21,52,16,0.290909090909091,344,7.26744186046512
"6252",2020,"Alabama-Huntsville",NA,NA,NA,10,30,7,5,0,18,0,4,0,4,5,16,34,7,27,28,9,19,2,0.2,77,6.49350649350649
"6253",2020,"Alderson-Broaddus",NA,NA,NA,17,20,8,3,0,9,0,12,16,28,9,17,22,2,20,18,3,15,1,0.0588235294117647,73,12.3287671232877
"6254",2020,"Alice Lloyd College",NA,NA,NA,14,21,13,8,0,23,0,8,5,13,4,23,19,6,13,32,6,26,0,0,80,5
"6255",2020,"Antelope Valley",NA,NA,NA,17,23,14,8,0,16,0,11,11,22,9,21,17,6,11,20,6,14,8,0.470588235294118,90,10
"6256",2020,"Asbury",NA,NA,NA,16,24,13,9,0,15,0,2,13,15,8,24,10,0,10,44,12,32,3,0.1875,80,10
"6257",2020,"Auburn-Montgomery",NA,NA,NA,9,29,3,2,0,18,0,5,8,13,9,16,23,5,18,25,6,19,2,0.222222222222222,70,12.8571428571429
"6258",2020,"Benedictine",NA,NA,NA,16,22,10,5,0,16,0,15,10,25,11,29,11,2,9,20,4,16,6,0.375,90,12.2222222222222
"6259",2020,"Biola",NA,NA,NA,6,26,3,2,0,19,0,1,5,6,6,29,21,5,16,18,4,14,1,0.166666666666667,71,8.45070422535211
"6260",2020,"Bloomsburg University",NA,NA,NA,19,40,24,13,0,23,0,20,23,43,11,39,32,11,21,22,3,19,6,0.31578947368421,137,8.02919708029197
"6261",2020,"Bluefield University",NA,NA,NA,8,23,9,6,0,17,0,8,8,16,5,19,14,2,12,13,4,9,2,0.25,66,7.57575757575758
"6262",2020,"Bob Jones University",NA,NA,NA,8,52,10,7,0,18,0,13,20,33,13,53,28,10,18,33,10,23,2,0.25,148,8.78378378378378
"6263",2020,"Brescia",NA,NA,NA,17,36,7,4,0,18,0,11,11,22,7,28,26,8,18,19,6,13,7,0.411764705882353,109,6.42201834862385
"6264",2020,"Brevard College",NA,NA,NA,11,51,21,12,0,37,0,13,7,20,2,44,23,5,18,50,9,41,3,0.272727272727273,136,1.47058823529412
"6265",2020,"Bridgeport",NA,NA,NA,13,25,9,5,0,26,0,14,20,34,8,15,14,4,10,18,7,11,5,0.384615384615385,81,9.87654320987654
"6266",2020,"CSU San Bernardino",NA,NA,NA,12,18,2,2,0,17,0,5,18,23,5,12,24,6,18,24,7,17,0,0,61,8.19672131147541
"6267",2020,"Cal State-Los Angeles",NA,NA,NA,8,21,2,2,0,14,0,8,12,20,8,17,25,9,16,19,6,13,1,0.125,69,11.5942028985507
"6268",2020,"California Maritime",NA,NA,NA,19,39,21,13,0,12,0,11,10,21,9,42,11,1,10,18,4,14,5,0.263157894736842,121,7.43801652892562
"6269",2020,"Carroll (MT)",NA,NA,NA,10,26,10,5,0,18,0,9,11,20,7,14,20,2,18,19,2,17,5,0.5,67,10.4477611940298
"6270",2020,"Centenary",NA,NA,NA,13,27,10,5,0,30,0,4,12,16,4,40,13,5,8,22,4,18,4,0.307692307692308,95,4.21052631578947
"6271",2020,"Central Arkansas",NA,NA,NA,449,700,330,199,0,553,2,300,267,567,173,473,773,266,507,201,40,161,144,0.320712694877506,2315,7.47300215982721
"6272",2020,"Central Christian College",NA,NA,NA,19,49,16,10,0,42,0,14,19,33,13,47,42,9,33,56,14,42,3,0.157894736842105,157,8.28025477707006
"6273",2020,"Chadron State",NA,NA,NA,7,17,14,9,0,16,0,2,5,7,4,18,22,7,15,31,7,24,2,0.285714285714286,61,6.55737704918033
"6274",2020,"Chaminade",NA,NA,NA,8,23,9,5,0,9,0,2,5,7,8,22,21,1,20,24,9,15,3,0.375,67,11.9402985074627
"6275",2020,"Chestnut Hill",NA,NA,NA,15,25,5,3,0,13,0,11,12,23,8,26,22,8,14,18,2,16,4,0.266666666666667,87,9.19540229885057
"6276",2020,"Christian Brothers",NA,NA,NA,14,46,20,12,0,26,0,17,23,40,13,49,28,14,14,46,14,32,6,0.428571428571429,160,8.125
"6277",2020,"Clark Atlanta",NA,NA,NA,18,29,7,3,0,14,0,11,18,29,2,18,18,4,14,17,4,13,5,0.277777777777778,86,2.32558139534884
"6278",2020,"Coker",NA,NA,NA,11,24,16,7,0,21,0,6,7,13,8,33,30,11,19,12,4,8,3,0.272727272727273,92,8.69565217391304
"6279",2020,"Colorado Christian",NA,NA,NA,20,40,21,10,0,27,0,10,20,30,11,34,44,12,32,31,8,23,5,0.25,129,8.52713178294574
"6280",2020,"Columbia College (SC)",NA,NA,NA,21,23,11,7,0,22,0,14,6,20,16,29,26,2,24,20,5,15,6,0.285714285714286,96,16.6666666666667
"6281",2020,"Concord College",NA,NA,NA,11,21,7,4,0,12,0,5,7,12,6,24,24,6,18,14,5,9,2,0.181818181818182,73,8.21917808219178
"6282",2020,"Concordia (MI)",NA,NA,NA,15,28,9,6,0,12,0,9,15,24,3,25,21,3,18,13,3,10,4,0.266666666666667,85,3.52941176470588
"6283",2020,"Concordia (TX)",NA,NA,NA,9,27,14,8,0,19,0,3,7,10,8,30,20,7,13,15,4,11,3,0.333333333333333,83,9.63855421686747
"6284",2020,"Concordia University (CA)",NA,NA,NA,13,28,12,10,0,16,0,6,8,14,0,4,24,5,19,26,6,20,5,0.384615384615385,65,0
"6285",2020,"Converse College",NA,NA,NA,6,25,3,1,0,14,0,6,8,14,6,27,12,2,10,23,6,17,4,0.666666666666667,72,8.33333333333333
"6286",2020,"Culver-Stockton",NA,NA,NA,11,27,12,12,0,27,0,7,6,13,6,18,26,9,17,17,8,9,4,0.363636363636364,84,7.14285714285714
"6287",2020,"Cumberland (TN)",NA,NA,NA,7,22,10,5,0,19,0,9,10,19,9,27,16,4,12,15,6,9,1,0.142857142857143,78,11.5384615384615
"6288",2020,"Dakota Wesleyan University",NA,NA,NA,5,19,5,4,0,25,0,5,6,11,6,28,11,4,7,21,7,14,0,0,69,8.69565217391304
"6289",2020,"Davis & Elkins",NA,NA,NA,20,38,17,9,0,33,0,17,18,35,16,52,29,7,22,45,11,34,6,0.3,147,10.8843537414966
"6290",2020,"E. Stroudsburg",NA,NA,NA,7,20,1,1,0,20,0,11,8,19,3,15,15,7,8,23,7,16,1,0.142857142857143,68,4.41176470588235
"6291",2020,"East Nazarene",NA,NA,NA,14,36,7,4,0,9,0,10,16,26,3,24,21,4,17,23,6,17,2,0.142857142857143,97,3.09278350515464
"6292",2020,"Edward Waters",NA,NA,NA,22,45,22,10,0,40,1,16,13,29,14,37,41,12,29,50,10,40,6,0.272727272727273,146,9.58904109589041
"6293",2020,"Erskine",NA,NA,NA,7,17,4,1,0,21,0,2,7,9,2,18,23,6,17,25,7,18,2,0.285714285714286,57,3.50877192982456
"6294",2020,"Eureka College",NA,NA,NA,6,17,7,4,0,10,0,5,8,13,12,20,27,7,20,24,3,21,1,0.166666666666667,59,20.3389830508475
"6295",2020,"FDU-Florham",NA,NA,NA,16,21,11,5,0,14,0,0,6,6,4,17,33,8,25,17,0,17,4,0.25,66,6.06060606060606
"6296",2020,"Faulkner",NA,NA,NA,11,27,5,4,0,17,0,4,6,10,4,23,15,6,9,28,11,17,3,0.272727272727273,83,4.81927710843374
"6297",2020,"Fisher College",NA,NA,NA,8,27,7,4,0,11,0,6,6,12,6,23,36,11,25,10,1,9,2,0.25,78,7.69230769230769
"6298",2020,"Fisk",NA,NA,NA,13,15,13,7,0,19,0,7,15,22,11,18,32,13,19,11,0,11,3,0.230769230769231,67,16.4179104477612
"6299",2020,"Florida Memorial",NA,NA,NA,18,30,17,9,0,12,0,9,7,16,5,22,16,2,14,26,5,21,5,0.277777777777778,92,5.43478260869565
"6300",2020,"Florida National",NA,NA,NA,13,14,10,6,0,13,0,6,15,21,9,24,19,4,15,16,3,13,2,0.153846153846154,67,13.4328358208955
"6301",2020,"Fort Valley State",NA,NA,NA,30,57,23,14,0,59,0,21,20,41,23,73,49,11,38,36,11,25,7,0.233333333333333,207,11.1111111111111
"6302",2020,"Fresno Pacific",NA,NA,NA,10,19,18,14,0,10,0,6,6,12,4,22,11,1,10,28,9,19,1,0.1,70,5.71428571428571
"6303",2020,"Frostburg",NA,NA,NA,10,21,18,9,0,21,0,6,12,18,9,34,15,5,10,12,2,10,2,0.2,83,10.8433734939759
"6304",2020,"Gettysburg",NA,NA,NA,8,17,9,6,0,23,0,9,18,27,5,19,10,5,5,18,4,14,2,0.25,63,7.93650793650794
"6305",2020,"Graceland University",NA,NA,NA,4,30,12,7,0,11,0,10,13,23,6,20,21,4,17,14,3,11,1,0.25,74,8.10810810810811
"6306",2020,"Greensboro College",NA,NA,NA,15,35,19,12,0,19,0,4,15,19,3,20,15,4,11,22,5,17,1,0.0666666666666667,88,3.40909090909091
"6307",2020,"Harris Stowe",NA,NA,NA,8,18,10,6,0,17,0,7,7,14,7,21,25,3,22,24,12,12,2,0.25,72,9.72222222222222
"6308",2020,"Heidelberg",NA,NA,NA,18,21,9,5,0,11,0,4,7,11,5,18,29,11,18,17,6,11,6,0.333333333333333,81,6.17283950617284
"6309",2020,"Hendrix College",NA,NA,NA,6,11,8,4,0,24,0,1,5,6,2,31,15,3,12,17,5,12,1,0.166666666666667,58,3.44827586206897
"6310",2020,"Hiram",NA,NA,NA,5,21,4,3,0,11,0,6,6,12,3,20,25,4,21,17,4,13,1,0.2,62,4.83870967741935
"6311",2020,"Holy Names College",NA,NA,NA,9,22,7,4,0,16,0,2,12,14,7,24,18,4,14,24,6,18,2,0.222222222222222,69,10.1449275362319
"6312",2020,"Hope International",NA,NA,NA,27,42,28,16,0,36,0,16,13,29,16,44,25,5,20,55,14,41,8,0.296296296296296,157,10.1910828025478
"6313",2020,"Howard Payne",NA,NA,NA,36,82,34,20,0,63,0,29,39,68,15,108,38,10,28,46,4,42,8,0.222222222222222,274,5.47445255474453
"6314",2020,"Huston-Tillotson",NA,NA,NA,6,18,6,4,0,14,0,8,7,15,13,19,19,6,13,17,5,12,1,0.166666666666667,62,20.9677419354839
"6315",2020,"Illinois-Springfield",NA,NA,NA,13,21,12,8,0,19,0,7,9,16,13,23,25,10,15,15,2,13,2,0.153846153846154,78,16.6666666666667
"6316",2020,"Indiana-Northwest",NA,NA,NA,13,17,9,4,0,14,0,12,20,32,8,25,16,4,12,13,3,10,6,0.461538461538462,76,10.5263157894737
"6317",2020,"Jarvis Christian",NA,NA,NA,21,19,16,7,0,25,1,9,15,24,12,33,13,4,9,20,4,16,5,0.238095238095238,93,12.9032258064516
"6318",2020,"Johnson & Wales Florida",NA,NA,NA,18,30,14,8,0,18,0,4,3,7,5,25,34,11,23,18,5,13,3,0.166666666666667,95,5.26315789473684
"6319",2020,"Johnson University (FL)",NA,NA,NA,9,16,11,6,0,19,0,4,7,11,4,30,24,4,20,14,4,10,4,0.444444444444444,70,5.71428571428571
"6320",2020,"KY Wesleyan",NA,NA,NA,3,23,13,7,0,16,0,20,12,32,6,24,2,0,2,19,7,12,1,0.333333333333333,79,7.59493670886076
"6321",2020,"Kentucky Christian",NA,NA,NA,13,27,4,3,0,11,0,8,18,26,4,33,11,4,7,22,4,18,2,0.153846153846154,90,4.44444444444444
"6322",2020,"Kentucky State",NA,NA,NA,16,32,7,5,0,26,0,10,9,19,8,22,27,3,24,20,2,18,3,0.1875,86,9.30232558139535
"6323",2020,"LSU Alexandria",NA,NA,NA,16,50,25,17,0,45,0,14,18,32,18,33,62,19,43,33,11,22,8,0.5,146,12.3287671232877
"6324",2020,"La Verne",NA,NA,NA,39,42,17,11,0,27,1,14,23,37,12,53,52,12,40,64,16,48,6,0.153846153846154,180,6.66666666666667
"6325",2020,"Lake Erie College",NA,NA,NA,18,43,20,12,0,35,0,17,15,32,16,48,32,10,22,45,9,36,3,0.166666666666667,153,10.4575163398693
"6326",2020,"Le Tourneau",NA,NA,NA,13,27,11,7,0,16,0,7,11,18,8,40,22,5,17,13,3,10,3,0.230769230769231,97,8.24742268041237
"6327",2020,"Lenoir-Rhyne College",NA,NA,NA,5,19,9,5,0,15,0,11,4,15,4,16,11,4,7,21,7,14,3,0.6,64,6.25
"6328",2020,"Lewis Clark State",NA,NA,NA,2,23,7,7,0,13,0,5,8,13,6,29,16,2,14,14,2,12,0,0,63,9.52380952380952
"6329",2020,"Life Pacific",NA,NA,NA,9,26,6,4,0,9,0,5,16,21,9,23,16,5,11,30,7,23,3,0.333333333333333,76,11.8421052631579
"6330",2020,"Lincoln PA",NA,NA,NA,9,34,22,13,0,24,0,8,11,19,13,20,17,4,13,21,9,12,3,0.333333333333333,89,14.6067415730337
"6331",2020,"Lindenwood",NA,NA,NA,10,24,20,12,0,17,0,16,16,32,5,19,5,1,4,15,6,9,6,0.6,82,6.09756097560976
"6332",2020,"Loyola (LA)",NA,NA,NA,27,40,16,12,0,41,0,15,17,32,15,36,24,4,20,49,15,34,12,0.444444444444444,141,10.6382978723404
"6333",2020,"Mayville State",NA,NA,NA,9,24,13,11,0,29,0,6,17,23,2,18,6,2,4,24,8,16,2,0.222222222222222,71,2.8169014084507
"6334",2020,"McMurry",NA,NA,NA,16,14,21,11,0,22,0,8,3,11,3,27,19,4,15,8,1,7,7,0.4375,74,4.05405405405405
"6335",2020,"Middle Georgia State",NA,NA,NA,13,20,18,8,0,13,0,12,8,20,8,18,18,4,14,20,3,17,5,0.384615384615385,76,10.5263157894737
"6336",2020,"Minot State",NA,NA,NA,16,25,7,5,1,16,0,12,19,31,5,25,13,4,9,17,5,12,4,0.25,90,5.55555555555556
"6337",2020,"Missouri Baptist",NA,NA,NA,19,33,15,9,0,26,0,8,12,20,12,30,29,8,21,13,8,5,7,0.368421052631579,110,10.9090909090909
"6338",2020,"Missouri-St. Louis",NA,NA,NA,8,23,23,14,0,16,0,8,17,25,7,15,14,2,12,13,5,8,2,0.25,64,10.9375
"6339",2020,"Mobile",NA,NA,NA,36,41,25,15,0,43,0,18,33,51,18,27,54,17,37,34,11,23,9,0.25,158,11.3924050632911
"6340",2020,"Molloy",NA,NA,NA,12,27,13,9,0,13,0,8,17,25,6,18,15,3,12,16,5,11,4,0.333333333333333,78,7.69230769230769
"6341",2020,"Mont St Billings",NA,NA,NA,11,30,9,6,0,19,0,3,1,4,3,19,28,10,18,26,6,20,4,0.363636363636364,81,3.7037037037037
"6342",2020,"Montana State-Northern",NA,NA,NA,15,37,25,17,0,27,0,9,16,25,6,46,39,6,33,22,7,15,4,0.266666666666667,124,4.83870967741935
"6343",2020,"Montevallo",NA,NA,NA,14,17,12,5,0,27,0,10,5,15,5,20,19,7,12,21,6,15,3,0.214285714285714,76,6.57894736842105
"6344",2020,"Montreat College",NA,NA,NA,14,24,6,4,0,25,0,5,11,16,5,29,18,5,13,24,6,18,2,0.142857142857143,84,5.95238095238095
"6345",2020,"Morris College",NA,NA,NA,16,33,19,11,0,17,0,10,8,18,12,24,25,8,17,28,6,22,3,0.1875,101,11.8811881188119
"6346",2020,"Multnomah",NA,NA,NA,14,29,12,7,0,12,0,5,2,7,5,26,33,11,22,20,2,18,5,0.357142857142857,90,5.55555555555556
"6347",2020,"Muskingum",NA,NA,NA,4,20,3,2,0,15,0,2,3,5,10,27,25,11,14,21,6,15,2,0.5,72,13.8888888888889
"6348",2020,"NC Pembroke",NA,NA,NA,13,18,19,11,0,27,0,7,6,13,6,19,17,5,12,21,2,19,3,0.230769230769231,70,8.57142857142857
"6349",2020,"NW Missouri State",NA,NA,NA,5,24,6,5,0,22,0,4,8,12,8,23,19,6,13,19,9,10,1,0.2,74,10.8108108108108
"6350",2020,"Nebraska Wesleyan",NA,NA,NA,14,17,13,9,0,16,0,3,12,15,5,32,14,4,10,14,5,9,5,0.357142857142857,80,6.25
"6351",2020,"Newberry",NA,NA,NA,12,25,13,5,0,17,0,5,17,22,6,16,15,7,8,18,5,13,0,0,71,8.45070422535211
"6352",2020,"Northern New Mexico",NA,NA,NA,11,26,13,8,0,17,0,4,8,12,4,26,20,6,14,20,4,16,0,0,80,5
"6353",2020,"Northwest Christian",NA,NA,NA,11,24,5,4,0,8,0,9,8,17,10,19,12,4,8,34,10,24,4,0.363636363636364,79,12.6582278481013
"6354",2020,"Norwich",NA,NA,NA,8,24,14,9,0,10,0,6,10,16,2,21,20,3,17,5,2,3,0,0,66,3.03030303030303
"6355",2020,"Notre Dame College",NA,NA,NA,8,18,7,5,0,22,0,12,9,21,12,13,17,2,15,30,6,24,0,0,60,20
"6356",2020,"Notre Dame of Maryland University",NA,NA,NA,13,19,10,6,0,19,0,8,9,17,4,35,28,6,22,7,0,7,2,0.153846153846154,86,4.65116279069767
"6357",2020,"Oakwood",NA,NA,NA,11,12,16,8,0,20,0,5,10,15,12,39,16,4,12,10,3,7,2,0.181818181818182,75,16
"6358",2020,"Ottawa (AZ)",NA,NA,NA,35,57,35,23,0,34,0,11,19,30,19,34,64,18,46,36,13,23,8,0.228571428571429,175,10.8571428571429
"6359",2020,"Our Lady Of The Lake",NA,NA,NA,12,22,14,9,0,21,0,6,11,17,11,13,31,17,14,16,6,10,5,0.416666666666667,81,13.5802469135802
"6360",2020,"Pacific Union",NA,NA,NA,11,27,8,6,0,19,0,6,6,12,6,34,23,5,18,14,1,13,6,0.545454545454545,85,7.05882352941176
"6361",2020,"Paine",NA,NA,NA,20,29,19,9,0,26,1,11,4,15,7,26,32,5,27,16,5,11,5,0.25,100,7
"6362",2020,"Palm Beach Atlantic University",NA,NA,NA,19,50,31,18,0,24,1,10,21,31,7,41,32,9,23,41,9,32,3,0.157894736842105,144,4.86111111111111
"6363",2020,"Paul Quinn",NA,NA,NA,39,64,47,29,0,64,0,18,30,48,22,68,66,19,47,41,15,26,13,0.333333333333333,232,9.48275862068965
"6364",2020,"Peru State College",NA,NA,NA,7,23,19,13,0,11,0,8,10,18,12,23,23,6,17,17,4,13,0,0,77,15.5844155844156
"6365",2020,"Pittsburgh-Johnstown",NA,NA,NA,9,32,8,5,0,13,0,6,17,23,3,35,4,1,3,14,3,11,1,0.111111111111111,89,3.37078651685393
"6366",2020,"Post University",NA,NA,NA,16,23,12,7,0,25,0,8,10,18,7,21,18,2,16,18,4,14,4,0.25,78,8.97435897435897
"6367",2020,"Queens University",NA,NA,NA,10,30,12,8,0,25,1,4,9,13,4,22,26,7,19,19,4,15,2,0.2,81,4.93827160493827
"6368",2020,"Rogers State University",NA,NA,NA,7,17,6,3,0,17,0,8,7,15,4,18,12,4,8,23,4,19,2,0.285714285714286,60,6.66666666666667
"6369",2020,"Savannah State",NA,NA,NA,17,34,18,11,0,20,0,10,14,24,12,17,27,15,12,30,9,21,8,0.470588235294118,108,11.1111111111111
"6370",2020,"Schreiner",NA,NA,NA,7,17,16,11,0,21,0,5,4,9,6,33,15,5,10,13,0,13,4,0.571428571428571,71,8.45070422535211
"6371",2020,"Shorter",NA,NA,NA,12,14,11,9,0,17,0,12,16,28,6,14,33,6,27,0,0,0,1,0.0833333333333333,61,9.83606557377049
"6372",2020,"South Carolina",NA,NA,NA,342,650,340,222,1,315,1,299,169,468,211,305,654,258,396,253,94,159,109,0.318713450292398,2031,10.3889709502708
"6373",2020,"Southern-New Orleans",NA,NA,NA,20,25,6,6,0,19,0,13,12,25,6,31,15,5,10,24,5,19,4,0.2,101,5.94059405940594
"6374",2020,"St Thomas University-Houston",NA,NA,NA,16,42,30,15,0,44,0,16,11,27,17,45,41,12,29,41,11,30,7,0.4375,149,11.4093959731544
"6375",2020,"St. Andrews",NA,NA,NA,4,17,4,3,0,12,1,7,11,18,8,34,15,7,8,18,8,10,0,0,79,10.126582278481
"6376",2020,"Stanislaus State",NA,NA,NA,19,21,18,11,0,14,0,8,6,14,7,17,30,8,22,19,5,14,4,0.210526315789474,83,8.43373493975904
"6377",2020,"Staten Island",NA,NA,NA,17,21,9,5,0,14,0,3,8,11,6,22,22,10,12,19,8,11,3,0.176470588235294,82,7.31707317073171
"6378",2020,"Stevenson",NA,NA,NA,8,27,3,1,0,12,0,3,6,9,4,31,27,4,23,13,7,6,2,0.25,81,4.93827160493827
"6379",2020,"Texas A&M-International",NA,NA,NA,25,39,18,10,0,34,0,21,22,43,18,56,10,3,7,41,11,30,2,0.08,158,11.3924050632911
"6380",2020,"Texas A&M-Kingsville",NA,NA,NA,11,35,14,9,0,23,1,5,13,18,16,38,29,8,21,53,14,39,2,0.181818181818182,112,14.2857142857143
"6381",2020,"Texas Lutheran",NA,NA,NA,20,35,22,15,0,37,0,8,13,21,17,56,38,8,30,34,7,27,4,0.2,136,12.5
"6382",2020,"Texas Permian Basin",NA,NA,NA,12,23,23,12,0,22,0,6,7,13,7,19,16,8,8,23,1,22,3,0.25,74,9.45945945945946
"6383",2020,"Texas Wesleyan",NA,NA,NA,28,32,25,17,0,25,1,18,16,34,13,28,36,11,25,54,15,39,10,0.357142857142857,141,9.21985815602837
"6384",2020,"Thomas University",NA,NA,NA,11,19,13,7,0,23,0,5,12,17,4,34,13,4,9,12,3,9,6,0.545454545454545,81,4.93827160493827
"6385",2020,"Tiffin",NA,NA,NA,8,25,10,6,0,16,0,9,6,15,6,26,20,7,13,18,4,14,3,0.375,83,7.2289156626506
"6386",2020,"Tougaloo",NA,NA,NA,23,56,19,13,0,46,0,18,18,36,20,78,22,12,10,32,9,23,4,0.173913043478261,199,10.0502512562814
"6387",2020,"Trinity Baptist",NA,NA,NA,10,16,10,6,0,25,0,4,8,12,8,27,20,3,17,28,6,22,0,0,67,11.9402985074627
"6388",2020,"Truman State",NA,NA,NA,15,27,12,7,0,18,0,10,21,31,2,19,10,4,6,25,8,17,5,0.333333333333333,86,2.32558139534884
"6389",2020,"Tuskegee",NA,NA,NA,19,13,11,8,0,23,1,3,4,7,6,12,43,16,27,20,3,17,7,0.368421052631579,68,8.82352941176471
"6390",2020,"UC Merced",NA,NA,NA,13,21,7,3,0,9,0,5,9,14,2,27,18,2,16,16,3,13,3,0.230769230769231,73,2.73972602739726
"6391",2020,"UC Santa Cruz",NA,NA,NA,20,21,17,9,0,16,0,5,12,17,2,13,20,6,14,27,5,22,8,0.4,74,2.7027027027027
"6392",2020,"UConn",NA,NA,NA,260,583,206,136,0,204,0,276,165,441,175,265,454,187,267,269,105,164,103,0.396153846153846,1729,10.1214574898785
"6393",2020,"USAO",NA,NA,NA,11,23,5,3,0,8,0,9,12,21,8,18,14,4,10,25,4,21,3,0.272727272727273,69,11.5942028985507
"6394",2020,"University of the Southwest",NA,NA,NA,19,47,17,10,0,37,0,17,23,40,6,43,34,16,18,42,11,31,3,0.157894736842105,157,3.82165605095541
"6395",2020,"Urbana",NA,NA,NA,19,28,10,4,0,17,0,5,5,10,6,19,29,7,22,22,6,16,4,0.210526315789474,85,7.05882352941176
"6396",2020,"Utah Tech",NA,NA,NA,3,27,4,4,0,11,0,7,15,22,3,13,12,6,6,18,5,13,1,0.333333333333333,61,4.91803278688525
"6397",2020,"VU of Lynchburg",NA,NA,NA,36,68,31,19,0,60,2,16,33,49,20,98,71,14,57,59,14,45,9,0.25,253,7.90513833992095
"6398",2020,"Virginia-Wise",NA,NA,NA,17,21,6,3,0,15,0,12,14,26,4,19,12,5,7,26,6,20,6,0.352941176470588,82,4.8780487804878
"6399",2020,"Waldorf College",NA,NA,NA,12,46,4,3,0,18,0,8,21,29,9,55,49,7,42,21,3,18,2,0.166666666666667,131,6.87022900763359
"6400",2020,"Warner Pacific College",NA,NA,NA,16,25,4,2,0,14,0,5,4,9,3,20,28,8,20,25,6,19,4,0.25,81,3.7037037037037
"6401",2020,"Warner University",NA,NA,NA,4,21,13,8,0,21,0,10,5,15,3,22,22,5,17,19,2,17,2,0.5,66,4.54545454545455
"6402",2020,"Washington Adventist",NA,NA,NA,20,61,25,17,0,37,0,18,21,39,8,68,10,5,5,40,10,30,5,0.25,188,4.25531914893617
"6403",2020,"Wesley",NA,NA,NA,7,24,7,6,0,13,0,4,8,12,4,34,12,3,9,12,1,11,1,0.142857142857143,73,5.47945205479452
"6404",2020,"Wesleyan College",NA,NA,NA,12,19,2,1,0,18,0,7,3,10,6,37,10,1,9,39,5,34,3,0.25,82,7.31707317073171
"6405",2020,"West New Mexico",NA,NA,NA,13,22,10,7,0,15,0,3,4,7,3,25,23,7,16,21,9,12,7,0.538461538461538,84,3.57142857142857
"6406",2020,"Westcliff",NA,NA,NA,79,113,58,37,0,58,0,36,54,90,33,113,118,18,100,99,22,77,24,0.30379746835443,399,8.27067669172932
"6407",2020,"Western Colorado",NA,NA,NA,5,22,10,7,0,21,0,7,5,12,5,30,10,2,8,13,6,7,3,0.6,74,6.75675675675676
"6408",2020,"Western Oregon",NA,NA,NA,14,21,6,3,0,11,0,3,6,9,7,22,33,7,26,16,3,13,4,0.285714285714286,71,9.85915492957746
"6409",2020,"Wheaton College (MA)",NA,NA,NA,14,26,12,8,0,17,0,5,17,22,6,21,16,2,14,23,7,16,5,0.357142857142857,82,7.31707317073171
"6410",2020,"Whittier",NA,NA,NA,12,16,7,5,0,18,0,5,8,13,9,17,19,7,12,17,3,14,4,0.333333333333333,62,14.5161290322581
"6411",2020,"Wiley",NA,NA,NA,22,40,49,28,0,49,2,13,11,24,6,57,32,8,24,13,4,9,10,0.454545454545455,153,3.92156862745098
"6412",2020,"Willamette",NA,NA,NA,14,20,5,1,0,15,0,7,7,14,11,35,20,9,11,13,3,10,3,0.214285714285714,88,12.5
"6413",2020,"William Carey",NA,NA,NA,27,53,16,9,0,37,0,10,14,24,17,57,50,15,35,38,12,26,5,0.185185185185185,178,9.55056179775281
"6414",2020,"William Jessup",NA,NA,NA,10,23,10,5,0,6,0,7,12,19,6,21,19,1,18,18,3,15,2,0.2,66,9.09090909090909
"6415",2020,"William Jewell",NA,NA,NA,13,12,14,7,0,23,0,0,0,0,6,18,50,11,39,14,3,11,4,0.307692307692308,60,10
"6416",2020,"William Peace",NA,NA,NA,12,30,5,4,0,22,0,9,7,16,3,36,10,2,8,14,2,12,2,0.166666666666667,92,3.26086956521739
"6417",2020,"Xavier (LA)",NA,NA,NA,33,44,19,9,0,30,0,7,7,14,15,41,54,15,39,29,7,22,6,0.181818181818182,148,10.1351351351351
"6418",2021,"Angelo State",NA,NA,NA,10,23,6,4,0,21,0,8,7,15,0,16,41,8,33,0,0,0,1,0.1,66,0
"6419",2021,"Arizona Christian",NA,NA,NA,17,27,16,11,0,17,0,9,9,18,4,36,41,10,31,0,0,0,3,0.176470588235294,101,3.96039603960396
"6420",2021,"Arlington Baptist",NA,NA,NA,11,24,21,11,0,21,0,7,12,19,5,28,33,9,24,0,0,0,4,0.363636363636364,83,6.02409638554217
"6421",2021,"Berry",NA,NA,NA,14,12,5,4,0,19,0,5,13,18,6,31,37,9,28,0,0,0,3,0.214285714285714,74,8.10810810810811
"6422",2021,"Bluefield State",NA,NA,NA,10,34,8,6,0,15,0,11,19,30,3,16,41,11,30,0,0,0,4,0.4,84,3.57142857142857
"6423",2021,"Canisius",NA,NA,NA,33,82,38,23,0,69,0,26,24,50,26,56,167,44,123,0,0,0,10,0.303030303030303,247,10.5263157894737
"6424",2021,"Carson Newman",NA,NA,NA,9,27,13,9,0,15,0,9,6,15,5,27,30,11,19,0,0,0,0,0,87,5.74712643678161
"6425",2021,"Central Baptist College",NA,NA,NA,21,51,18,11,0,30,0,16,18,34,4,38,87,21,66,0,0,0,6,0.285714285714286,151,2.64900662251656
"6426",2021,"Champion Christian College",NA,NA,NA,11,22,11,6,0,16,0,4,6,10,2,28,39,8,31,0,0,0,1,0.0909090909090909,75,2.66666666666667
"6427",2021,"College of Idaho",NA,NA,NA,37,72,17,8,0,33,0,23,33,56,32,66,109,24,85,0,0,0,9,0.243243243243243,227,14.0969162995595
"6428",2021,"Colorado Christian",NA,NA,NA,15,41,15,10,0,17,0,8,8,16,14,40,75,22,53,0,0,0,3,0.2,128,10.9375
"6429",2021,"Columbia International",NA,NA,NA,14,31,6,5,0,19,0,3,6,9,9,26,60,17,43,0,0,0,4,0.285714285714286,92,9.78260869565217
"6430",2021,"Concordia (TX)",NA,NA,NA,21,19,16,8,0,21,0,3,8,11,8,20,49,10,39,0,0,0,6,0.285714285714286,76,10.5263157894737
"6431",2021,"Concordia University (CA)",NA,NA,NA,10,28,14,10,0,15,0,4,11,15,6,20,38,10,28,0,0,0,2,0.2,76,7.89473684210526
"6432",2021,"Converse College",NA,NA,NA,37,72,19,10,0,58,0,19,23,42,16,74,120,26,94,0,0,0,9,0.243243243243243,231,6.92640692640693
"6433",2021,"Covenant",NA,NA,NA,12,20,7,4,0,15,0,5,16,21,5,25,32,4,28,0,0,0,0,0,67,7.46268656716418
"6434",2021,"Duke",NA,NA,NA,68,126,38,24,0,52,0,60,39,99,21,66,148,56,92,0,0,0,26,0.382352941176471,386,5.44041450777202
"6435",2021,"Edward Waters",NA,NA,NA,41,64,35,19,0,45,1,22,27,49,23,55,139,29,110,0,0,0,8,0.195121951219512,219,10.5022831050228
"6436",2021,"Erskine",NA,NA,NA,14,42,18,10,0,32,0,9,19,28,18,33,94,22,72,0,0,0,6,0.428571428571429,123,14.6341463414634
"6437",2021,"Flagler",NA,NA,NA,45,97,34,18,0,57,0,17,36,53,17,60,126,39,87,0,0,0,15,0.333333333333333,265,6.41509433962264
"6438",2021,"Florida Memorial",NA,NA,NA,51,109,66,39,0,68,0,49,50,99,32,95,134,42,92,0,0,0,22,0.431372549019608,362,8.83977900552486
"6439",2021,"Fort Valley State",NA,NA,NA,12,16,11,7,0,17,0,3,9,12,10,17,61,13,48,0,0,0,3,0.25,64,15.625
"6440",2021,"Georgia Southwestern",NA,NA,NA,16,20,21,12,0,26,0,11,9,20,14,26,44,11,33,0,0,0,5,0.3125,91,15.3846153846154
"6441",2021,"Howard Payne",NA,NA,NA,4,16,11,5,0,25,0,4,9,13,2,24,33,12,21,0,0,0,1,0.25,63,3.17460317460317
"6442",2021,"LaGrange College",NA,NA,NA,12,23,13,8,0,24,0,7,15,22,10,37,39,11,28,0,0,0,1,0.0833333333333333,92,10.8695652173913
"6443",2021,"Le Tourneau",NA,NA,NA,12,28,8,6,0,11,0,5,8,13,8,29,38,10,28,0,0,0,4,0.333333333333333,86,9.30232558139535
"6444",2021,"Life University",NA,NA,NA,39,52,38,21,0,29,2,24,19,43,11,46,85,20,65,0,0,0,13,0.333333333333333,191,5.75916230366492
"6445",2021,"Lincoln MO",NA,NA,NA,12,25,12,9,0,14,0,3,3,6,6,22,57,8,49,0,0,0,3,0.25,75,8
"6446",2021,"Lincoln PA",NA,NA,NA,40,89,55,32,0,56,0,18,28,46,18,51,123,35,88,0,0,0,11,0.275,246,7.31707317073171
"6447",2021,"Louisiana College",NA,NA,NA,13,22,12,6,0,28,1,6,9,15,13,19,55,13,42,0,0,0,4,0.307692307692308,77,16.8831168831169
"6448",2021,"McMurry",NA,NA,NA,14,18,9,5,0,16,0,6,10,16,3,29,33,5,28,0,0,0,1,0.0714285714285714,73,4.10958904109589
"6449",2021,"Mercyhurst",NA,NA,NA,7,31,6,5,0,16,0,7,11,18,2,20,39,13,26,0,0,0,0,0,78,2.56410256410256
"6450",2021,"Midland University",NA,NA,NA,11,19,10,6,0,18,0,3,6,9,9,20,45,9,36,0,0,0,2,0.181818181818182,63,14.2857142857143
"6451",2021,"Midwestern State",NA,NA,NA,11,42,25,18,0,47,0,16,17,33,15,49,67,18,49,0,0,0,3,0.272727272727273,140,10.7142857142857
"6452",2021,"Mobile",NA,NA,NA,4,18,5,4,0,18,0,8,7,15,4,25,33,13,20,0,0,0,2,0.5,70,5.71428571428571
"6453",2021,"NC Wesleyan",NA,NA,NA,57,124,32,19,0,78,0,48,38,86,25,91,185,51,134,0,0,0,18,0.31578947368421,373,6.70241286863271
"6454",2021,"Newberry",NA,NA,NA,16,48,8,5,0,28,0,11,19,30,7,43,69,27,42,0,0,0,3,0.1875,148,4.72972972972973
"6455",2021,"Northwest College",NA,NA,NA,39,57,26,14,0,39,0,14,35,49,19,74,123,41,82,0,0,0,9,0.230769230769231,230,8.26086956521739
"6456",2021,"Our Lady Of The Lake",NA,NA,NA,13,18,16,12,0,18,0,14,8,22,12,24,40,11,29,0,0,0,3,0.230769230769231,84,14.2857142857143
"6457",2021,"Park University Gilbert",NA,NA,NA,32,63,25,14,0,42,0,17,23,40,22,78,125,36,89,0,0,0,10,0.3125,230,9.56521739130435
"6458",2021,"Piedmont",NA,NA,NA,9,20,8,6,0,11,0,4,6,10,8,18,46,15,31,0,0,0,4,0.444444444444444,67,11.9402985074627
"6459",2021,"Purdue Northwest",NA,NA,NA,14,20,16,10,0,26,0,15,20,35,8,11,34,7,27,0,0,0,2,0.142857142857143,72,11.1111111111111
"6460",2021,"Queens University",NA,NA,NA,9,20,7,4,0,16,0,12,15,27,6,16,34,8,26,0,0,0,2,0.222222222222222,67,8.95522388059701
"6461",2021,"Quincy",NA,NA,NA,10,16,15,10,0,15,0,8,5,13,6,12,49,10,39,0,0,0,1,0.1,61,9.83606557377049
"6462",2021,"Regis University",NA,NA,NA,15,17,13,10,0,23,0,4,6,10,1,14,48,17,31,0,0,0,4,0.266666666666667,69,1.44927536231884
"6463",2021,"Rockford",NA,NA,NA,15,23,12,6,0,16,0,2,4,6,9,29,41,8,33,0,0,0,4,0.266666666666667,80,11.25
"6464",2021,"Rogers State University",NA,NA,NA,6,30,11,5,0,18,0,5,7,12,3,16,43,17,26,0,0,0,2,0.333333333333333,74,4.05405405405405
"6465",2021,"Salem University",NA,NA,NA,28,66,37,22,0,74,1,22,25,47,24,75,167,39,128,0,0,0,7,0.25,235,10.2127659574468
"6466",2021,"Shepherd College",NA,NA,NA,5,22,13,8,0,18,0,13,7,20,6,13,32,9,23,0,0,0,2,0.4,62,9.67741935483871
"6467",2021,"South Carolina State",NA,NA,NA,47,108,35,20,0,70,0,32,36,68,35,117,201,42,159,0,0,0,9,0.191489361702128,358,9.77653631284916
"6468",2021,"St. Edwards",NA,NA,NA,17,20,22,15,0,26,0,11,5,16,10,27,36,8,28,0,0,0,5,0.294117647058824,88,11.3636363636364
"6469",2021,"St. Louis Pharmacy",NA,NA,NA,9,44,15,12,0,34,0,10,24,34,12,42,54,18,36,0,0,0,3,0.333333333333333,127,9.4488188976378
"6470",2021,"St. Martins",NA,NA,NA,14,24,4,2,0,15,0,6,3,9,4,17,61,20,41,0,0,0,6,0.428571428571429,81,4.93827160493827
"6471",2021,"Sul Ross",NA,NA,NA,6,29,10,7,0,17,0,7,2,9,6,22,38,12,26,0,0,0,4,0.666666666666667,78,7.69230769230769
"6472",2021,"Tennessee Southern",NA,NA,NA,18,49,12,8,0,41,0,18,13,31,24,47,101,32,69,0,0,0,2,0.111111111111111,166,14.4578313253012
"6473",2021,"Texas A&M-Commerce",NA,NA,NA,13,21,12,7,0,20,0,5,3,8,4,14,57,10,47,0,0,0,2,0.153846153846154,66,6.06060606060606
"6474",2021,"Texas A&M-International",NA,NA,NA,28,59,26,18,0,35,0,20,18,38,18,39,75,28,47,0,0,0,5,0.178571428571429,179,10.0558659217877
"6475",2021,"Texas Dallas",NA,NA,NA,10,19,7,5,0,18,0,2,13,15,1,31,25,9,16,0,0,0,1,0.1,72,1.38888888888889
"6476",2021,"Texas-Tyler",NA,NA,NA,21,52,20,11,0,34,0,8,26,34,14,55,65,17,48,0,0,0,5,0.238095238095238,157,8.9171974522293
"6477",2021,"Transylvania",NA,NA,NA,11,23,13,11,0,18,0,10,8,18,6,30,33,9,24,0,0,0,2,0.181818181818182,85,7.05882352941176
"6478",2021,"Trevecca Nazarene",NA,NA,NA,9,24,19,14,0,19,0,14,9,23,3,19,30,9,21,0,0,0,7,0.777777777777778,80,3.75
"6479",2021,"UNT Dallas",NA,NA,NA,14,27,12,6,0,19,0,6,11,17,3,22,33,11,22,0,0,0,3,0.214285714285714,83,3.6144578313253
"6480",2021,"Utah Tech",NA,NA,NA,43,88,32,18,0,53,0,19,24,43,16,47,141,49,92,0,0,0,11,0.255813953488372,253,6.32411067193676
"6481",2021,"Warner Pacific College",NA,NA,NA,30,53,14,7,0,22,0,10,21,31,15,48,83,18,65,0,0,0,7,0.233333333333333,163,9.20245398773006
"6482",2021,"Webber International",NA,NA,NA,12,60,8,5,0,28,0,21,21,42,13,37,79,24,55,0,0,0,3,0.25,154,8.44155844155844
"6483",2021,"Western Colorado",NA,NA,NA,20,63,31,19,0,33,0,24,25,49,11,44,60,18,42,0,0,0,5,0.25,174,6.32183908045977
"6484",2021,"William Carey",NA,NA,NA,33,50,25,15,0,46,0,13,25,38,15,48,60,17,43,0,0,0,10,0.303030303030303,168,8.92857142857143
"6485",2021,"William Jessup",NA,NA,NA,48,125,51,31,0,86,0,43,65,108,38,108,175,51,124,0,0,0,8,0.166666666666667,381,9.9737532808399
"6486",2021,"William Jewell",NA,NA,NA,9,24,6,5,0,10,0,13,9,22,9,21,35,11,24,0,0,0,4,0.444444444444444,78,11.5384615384615
"6487",2021,"Williams Baptist",NA,NA,NA,6,28,2,2,0,17,0,5,13,18,3,20,47,14,33,0,0,0,1,0.166666666666667,74,4.05405405405405
"6488",2022,"Academy Of Art University",NA,NA,NA,25,48,18,8,0,33,0,20,16,36,18,29,88,20,68,0,0,0,5,0.2,146,12.3287671232877
"6489",2022,"Agnes Scott College",NA,NA,NA,24,41,11,5,0,23,0,10,13,23,9,75,78,10,68,0,0,0,6,0.25,163,5.52147239263804
"6490",2022,"Alabama-Huntsville",NA,NA,NA,15,18,14,9,0,16,0,8,10,18,4,28,40,12,28,0,0,0,5,0.333333333333333,85,4.70588235294118
"6491",2022,"Alcorn State",NA,NA,NA,159,287,158,94,0,320,4,68,91,159,94,287,590,177,413,0,0,0,48,0.30188679245283,1014,9.27021696252466
"6492",2022,"Alderson-Broaddus",NA,NA,NA,14,30,7,3,0,24,0,8,3,11,5,29,44,13,31,0,0,0,4,0.285714285714286,95,5.26315789473684
"6493",2022,"Angelo State",NA,NA,NA,14,24,14,11,0,12,0,9,11,20,5,20,34,7,27,0,0,0,5,0.357142857142857,77,6.49350649350649
"6494",2022,"Antelope Valley",NA,NA,NA,47,81,40,22,0,44,0,12,39,51,21,67,128,19,109,0,0,0,16,0.340425531914894,236,8.89830508474576
"6495",2022,"Arizona Christian",NA,NA,NA,14,25,17,8,0,12,0,13,2,15,9,41,30,4,26,0,0,0,8,0.571428571428571,103,8.7378640776699
"6496",2022,"Ark Baptist",NA,NA,NA,4,22,6,2,0,11,0,1,7,8,6,27,45,10,35,0,0,0,1,0.25,65,9.23076923076923
"6497",2022,"Arlington Baptist",NA,NA,NA,38,70,28,14,0,48,1,30,48,78,14,120,145,29,116,0,0,0,9,0.236842105263158,290,4.82758620689655
"6498",2022,"Asbury",NA,NA,NA,14,25,1,1,0,16,0,6,4,10,6,14,63,9,54,0,0,0,1,0.0714285714285714,68,8.82352941176471
"6499",2022,"Auburn-Montgomery",NA,NA,NA,19,53,17,9,0,33,0,22,13,35,5,51,52,14,38,0,0,0,11,0.578947368421053,167,2.9940119760479
"6500",2022,"Ave Maria University",NA,NA,NA,51,118,40,25,0,57,0,17,28,45,31,109,174,51,123,0,0,0,12,0.235294117647059,352,8.80681818181818
"6501",2022,"BRIAR CLIFF",NA,NA,NA,10,22,8,4,0,16,0,4,7,11,7,25,43,8,35,0,0,0,2,0.2,71,9.85915492957746
"6502",2022,"Baker University",NA,NA,NA,5,22,11,8,0,12,0,8,9,17,4,21,29,6,23,0,0,0,0,0,65,6.15384615384615
"6503",2022,"Belmont Abbey",NA,NA,NA,9,21,13,7,0,15,1,5,7,12,8,25,34,9,25,0,0,0,4,0.444444444444444,72,11.1111111111111
"6504",2022,"Bethel (TN)",NA,NA,NA,8,22,15,11,0,24,0,9,8,17,4,16,26,4,22,0,0,0,2,0.25,64,6.25
"6505",2022,"Bethesda University",NA,NA,NA,19,38,12,6,0,25,0,4,12,16,8,72,77,12,65,0,0,0,2,0.105263157894737,146,5.47945205479452
"6506",2022,"Biola",NA,NA,NA,5,25,5,5,0,10,0,14,9,23,8,21,33,11,22,0,0,0,3,0.6,79,10.126582278481
"6507",2022,"Blackburn",NA,NA,NA,8,20,13,9,0,18,0,7,5,12,14,34,42,9,33,0,0,0,3,0.375,80,17.5
"6508",2022,"Blue Mountain College",NA,NA,NA,15,21,10,7,0,18,0,7,11,18,6,18,38,9,29,0,0,0,6,0.4,72,8.33333333333333
"6509",2022,"Bluefield State",NA,NA,NA,24,39,22,12,0,24,0,4,9,13,10,45,84,20,64,0,0,0,8,0.333333333333333,138,7.2463768115942
"6510",2022,"Bob Jones University",NA,NA,NA,7,15,15,9,0,13,0,4,8,12,10,30,32,5,27,0,0,0,0,0,63,15.8730158730159
"6511",2022,"Bowie State",NA,NA,NA,19,25,10,3,0,24,0,3,4,7,5,30,34,8,26,0,0,0,3,0.157894736842105,86,5.81395348837209
"6512",2022,"Brevard College",NA,NA,NA,14,20,4,3,0,15,0,11,18,29,8,31,28,4,24,0,0,0,6,0.428571428571429,81,9.87654320987654
"6513",2022,"Brewton Parker",NA,NA,NA,22,28,15,7,0,16,0,10,18,28,4,18,33,4,29,0,0,0,9,0.409090909090909,85,4.70588235294118
"6514",2022,"Bryn Athyn",NA,NA,NA,14,14,7,4,0,13,0,1,9,10,8,19,46,8,38,0,0,0,1,0.0714285714285714,57,14.0350877192982
"6515",2022,"Bushnell",NA,NA,NA,5,29,8,3,0,11,0,8,7,15,4,28,28,9,19,0,0,0,1,0.2,81,4.93827160493827
"6516",2022,"Cal Lutheran",NA,NA,NA,19,27,7,3,0,23,0,5,7,12,9,32,47,10,37,0,0,0,5,0.263157894736842,94,9.57446808510638
"6517",2022,"Cal State-Los Angeles",NA,NA,NA,35,43,18,11,0,26,0,14,25,39,11,29,98,28,70,0,0,0,8,0.228571428571429,154,7.14285714285714
"6518",2022,"Caldwell University",NA,NA,NA,12,22,7,4,0,12,0,5,9,14,9,23,40,8,32,0,0,0,1,0.0833333333333333,70,12.8571428571429
"6519",2022,"Campbellsville-Harrodsburg",NA,NA,NA,15,25,14,11,0,22,0,3,9,12,17,23,52,17,35,0,0,0,2,0.133333333333333,85,20
"6520",2022,"Carver College",NA,NA,NA,15,15,4,1,0,20,1,4,15,19,3,49,30,2,28,0,0,0,1,0.0666666666666667,86,3.48837209302326
"6521",2022,"Centenary",NA,NA,NA,26,39,28,15,0,31,0,13,23,36,18,41,77,18,59,0,0,0,6,0.230769230769231,145,12.4137931034483
"6522",2022,"Central Baptist College",NA,NA,NA,32,52,22,17,0,41,0,15,17,32,10,52,64,10,54,0,0,0,13,0.40625,169,5.91715976331361
"6523",2022,"Central Christian College",NA,NA,NA,2,13,4,2,0,15,0,6,4,10,4,24,36,13,23,0,0,0,1,0.5,59,6.77966101694915
"6524",2022,"Chadron State",NA,NA,NA,7,17,3,1,0,11,0,1,5,6,5,14,46,19,27,0,0,0,2,0.285714285714286,58,8.62068965517241
"6525",2022,"Champion Christian College",NA,NA,NA,54,98,68,42,0,72,1,35,37,72,32,83,161,34,127,0,0,0,19,0.351851851851852,325,9.84615384615385
"6526",2022,"Chestnut Hill",NA,NA,NA,15,24,16,9,0,18,0,8,10,18,2,24,39,9,30,0,0,0,8,0.533333333333333,86,2.32558139534884
"6527",2022,"Chowan",NA,NA,NA,18,35,16,9,0,18,0,8,9,17,1,26,47,11,36,0,0,0,7,0.388888888888889,100,1
"6528",2022,"Clarion",NA,NA,NA,15,50,25,14,0,23,0,16,18,34,9,30,73,16,57,0,0,0,4,0.266666666666667,131,6.87022900763359
"6529",2022,"Coker",NA,NA,NA,20,29,17,10,0,18,0,8,15,23,8,16,36,8,28,0,0,0,6,0.3,84,9.52380952380952
"6530",2022,"College St. Mary (SD)",NA,NA,NA,9,21,11,7,0,17,0,4,6,10,10,25,45,14,31,0,0,0,0,0,73,13.6986301369863
"6531",2022,"College of Ozarks",NA,NA,NA,7,28,8,6,0,14,0,11,7,18,4,31,38,8,30,0,0,0,4,0.571428571428571,87,4.59770114942529
"6532",2022,"Colorado Christian",NA,NA,NA,31,56,14,9,0,29,0,10,14,24,8,35,101,27,74,0,0,0,12,0.387096774193548,163,4.9079754601227
"6533",2022,"Colorado Springs",NA,NA,NA,15,25,8,4,0,14,0,11,11,22,14,26,36,9,27,0,0,0,5,0.333333333333333,87,16.0919540229885
"6534",2022,"Colorado State-Pueblo",NA,NA,NA,18,57,8,6,0,39,0,10,12,22,11,18,99,26,73,0,0,0,3,0.166666666666667,130,8.46153846153846
"6535",2022,"Columbia International",NA,NA,NA,6,20,5,3,0,11,0,5,2,7,6,31,34,10,24,0,0,0,4,0.666666666666667,74,8.10810810810811
"6536",2022,"Connecticut College",NA,NA,NA,15,18,8,3,0,8,0,1,13,14,10,18,47,12,35,0,0,0,4,0.266666666666667,66,15.1515151515152
"6537",2022,"Converse College",NA,NA,NA,11,18,11,7,0,25,0,8,8,16,9,30,40,13,27,0,0,0,3,0.272727272727273,83,10.8433734939759
"6538",2022,"Dakota Wesleyan University",NA,NA,NA,11,19,0,0,0,16,0,11,13,24,5,17,37,10,27,0,0,0,4,0.363636363636364,68,7.35294117647059
"6539",2022,"Davis & Elkins",NA,NA,NA,7,22,5,2,0,18,0,0,2,2,2,15,51,10,41,0,0,0,1,0.142857142857143,54,3.7037037037037
"6540",2022,"Dickinson State",NA,NA,NA,7,17,7,5,0,24,0,10,5,15,4,29,29,6,23,0,0,0,0,0,69,5.79710144927536
"6541",2022,"E. Stroudsburg",NA,NA,NA,16,27,7,3,0,14,0,3,12,15,4,32,37,10,27,0,0,0,3,0.1875,89,4.49438202247191
"6542",2022,"ELIZABETH CITY",NA,NA,NA,7,22,5,3,0,16,0,2,8,10,4,31,37,12,25,0,0,0,1,0.142857142857143,75,5.33333333333333
"6543",2022,"Ecclesia College",NA,NA,NA,4,20,17,11,0,7,0,6,16,22,6,27,23,4,19,0,0,0,0,0,65,9.23076923076923
"6544",2022,"Edward Waters",NA,NA,NA,40,44,39,23,0,39,0,18,21,39,23,40,85,23,62,0,0,0,14,0.35,173,13.2947976878613
"6545",2022,"Erskine",NA,NA,NA,36,58,40,17,0,37,0,13,12,25,27,71,106,11,95,0,0,0,8,0.222222222222222,196,13.7755102040816
"6546",2022,"Evergreen State",NA,NA,NA,22,48,22,12,0,21,0,12,31,43,11,39,71,21,50,0,0,0,11,0.5,145,7.58620689655172
"6547",2022,"Faulkner",NA,NA,NA,12,27,11,8,0,12,0,8,12,20,3,23,28,8,20,0,0,0,2,0.166666666666667,81,3.7037037037037
"6548",2022,"Fisher College",NA,NA,NA,21,71,17,12,0,42,0,13,20,33,12,90,110,19,91,0,0,0,5,0.238095238095238,217,5.52995391705069
"6549",2022,"Florida National",NA,NA,NA,4,17,9,5,0,19,0,4,12,16,11,28,33,8,25,0,0,0,0,0,63,17.4603174603175
"6550",2022,"Fort Valley State",NA,NA,NA,24,20,24,14,0,23,0,11,8,19,12,30,48,14,34,0,0,0,9,0.375,107,11.214953271028
"6551",2022,"Freed-Hardeman",NA,NA,NA,14,22,13,7,0,11,0,20,12,32,10,13,26,9,17,0,0,0,7,0.5,82,12.1951219512195
"6552",2022,"Frostburg",NA,NA,NA,12,25,12,7,0,17,0,9,12,21,3,23,37,10,27,0,0,0,4,0.333333333333333,81,3.7037037037037
"6553",2022,"Gettysburg",NA,NA,NA,8,24,12,6,0,26,0,5,12,17,5,22,33,7,26,0,0,0,2,0.25,69,7.2463768115942
"6554",2022,"Grace Christian",NA,NA,NA,9,12,12,8,0,14,0,6,7,13,8,29,40,8,32,0,0,0,1,0.111111111111111,65,12.3076923076923
"6555",2022,"Graceland University",NA,NA,NA,7,30,9,6,0,13,0,7,16,23,2,32,22,5,17,0,0,0,2,0.285714285714286,84,2.38095238095238
"6556",2022,"Greenville",NA,NA,NA,17,31,2,1,0,13,0,5,7,12,5,24,58,19,39,0,0,0,5,0.294117647058824,96,5.20833333333333
"6557",2022,"Harris Stowe",NA,NA,NA,18,21,31,19,0,23,0,7,19,26,10,22,28,6,22,0,0,0,3,0.166666666666667,77,12.987012987013
"6558",2022,"Haskell Indian Nations",NA,NA,NA,5,26,8,3,0,17,0,4,9,13,10,19,48,13,35,0,0,0,1,0.2,69,14.4927536231884
"6559",2022,"Hendrix College",NA,NA,NA,29,46,17,8,0,24,0,7,15,22,10,33,103,22,81,0,0,0,5,0.172413793103448,140,7.14285714285714
"6560",2022,"Holy Names College",NA,NA,NA,5,18,5,4,0,5,0,2,10,12,6,33,23,7,16,0,0,0,3,0.6,66,9.09090909090909
"6561",2022,"Howard Payne",NA,NA,NA,27,40,26,15,0,37,0,3,17,20,7,48,86,22,64,0,0,0,7,0.259259259259259,143,4.8951048951049
"6562",2022,"Huston-Tillotson",NA,NA,NA,31,45,24,16,0,35,0,14,23,37,16,51,76,16,60,0,0,0,12,0.387096774193548,164,9.75609756097561
"6563",2022,"Immaculata",NA,NA,NA,16,25,15,8,0,9,0,7,13,20,9,19,41,7,34,0,0,0,5,0.3125,75,12
"6564",2022,"Jamestown",NA,NA,NA,8,23,5,3,0,18,0,3,11,14,8,23,39,11,28,0,0,0,2,0.25,69,11.5942028985507
"6565",2022,"John Carroll",NA,NA,NA,8,23,12,6,0,15,0,3,12,15,4,28,33,12,21,0,0,0,0,0,78,5.12820512820513
"6566",2022,"Johnson & Wales (NC)",NA,NA,NA,8,30,5,3,0,24,0,2,10,12,5,29,55,10,45,0,0,0,1,0.125,80,6.25
"6567",2022,"Johnson University (FL)",NA,NA,NA,3,9,4,2,0,15,0,4,5,9,3,40,32,10,22,0,0,0,2,0.666666666666667,68,4.41176470588235
"6568",2022,"Kansas Wesleyan",NA,NA,NA,5,22,5,5,0,10,0,10,11,21,9,16,37,11,26,0,0,0,1,0.2,66,13.6363636363636
"6569",2022,"Kentucky State",NA,NA,NA,27,79,39,16,0,68,0,34,19,53,31,87,109,33,76,0,0,0,8,0.296296296296296,264,11.7424242424242
"6570",2022,"King College TN",NA,NA,NA,7,27,8,8,0,16,0,12,13,25,10,23,26,7,19,0,0,0,1,0.142857142857143,77,12.987012987013
"6571",2022,"King's College (PA)",NA,NA,NA,11,24,4,3,0,13,0,3,9,12,3,18,49,16,33,0,0,0,5,0.454545454545455,73,4.10958904109589
"6572",2022,"LSU Alexandria",NA,NA,NA,12,19,3,1,0,12,0,5,9,14,10,24,49,14,35,0,0,0,2,0.166666666666667,74,13.5135135135135
"6573",2022,"LSU Shreveport",NA,NA,NA,25,65,28,19,0,45,2,8,12,20,17,79,119,32,87,0,0,0,7,0.28,216,7.87037037037037
"6574",2022,"LaGrange College",NA,NA,NA,12,24,16,10,0,12,0,6,20,26,6,15,31,7,24,0,0,0,6,0.5,69,8.69565217391304
"6575",2022,"Lake Erie College",NA,NA,NA,16,27,2,1,0,12,0,13,20,33,5,17,38,13,25,0,0,0,4,0.25,86,5.81395348837209
"6576",2022,"Lee University",NA,NA,NA,9,14,5,3,0,15,0,3,12,15,7,16,36,11,25,0,0,0,2,0.222222222222222,55,12.7272727272727
"6577",2022,"Lees-McRae",NA,NA,NA,22,44,24,13,0,39,0,15,20,35,23,56,57,13,44,0,0,0,9,0.409090909090909,155,14.8387096774194
"6578",2022,"Lenoir-Rhyne College",NA,NA,NA,17,44,20,13,0,29,0,21,22,43,17,49,49,11,38,0,0,0,6,0.352941176470588,148,11.4864864864865
"6579",2022,"Lewis Clark State",NA,NA,NA,8,35,12,7,0,8,0,7,5,12,3,18,49,9,40,0,0,0,1,0.125,79,3.79746835443038
"6580",2022,"Life Pacific",NA,NA,NA,22,46,14,6,0,16,0,11,21,32,7,22,109,30,79,0,0,0,4,0.181818181818182,133,5.26315789473684
"6581",2022,"Life University",NA,NA,NA,34,63,37,21,0,31,0,16,14,30,7,37,85,20,65,0,0,0,15,0.441176470588235,181,3.86740331491713
"6582",2022,"Lindenwood",NA,NA,NA,8,21,9,3,0,18,0,4,8,12,5,29,32,7,25,0,0,0,1,0.125,71,7.04225352112676
"6583",2022,"Lock Haven",NA,NA,NA,17,17,9,4,0,10,0,11,3,14,7,29,32,8,24,0,0,0,6,0.352941176470588,84,8.33333333333333
"6584",2022,"Louisiana Christian University",NA,NA,NA,12,28,8,5,0,21,0,7,7,14,9,31,38,6,32,0,0,0,3,0.25,86,10.4651162790698
"6585",2022,"Louisiana College",NA,NA,NA,12,25,16,10,0,29,0,6,6,12,7,19,37,11,26,0,0,0,7,0.583333333333333,75,9.33333333333333
"6586",2022,"Loyola (LA)",NA,NA,NA,12,29,16,9,0,16,0,13,12,25,9,20,29,3,26,0,0,0,3,0.25,81,11.1111111111111
"6587",2022,"Manchester",NA,NA,NA,8,22,6,3,0,10,0,2,4,6,3,34,33,10,23,0,0,0,1,0.125,77,3.8961038961039
"6588",2022,"Mansfield",NA,NA,NA,16,16,20,12,0,18,0,4,10,14,8,25,37,9,28,0,0,0,4,0.25,75,10.6666666666667
"6589",2022,"Mars Hill",NA,NA,NA,32,55,26,13,0,40,0,17,14,31,22,72,121,31,90,0,0,0,13,0.40625,213,10.3286384976526
"6590",2022,"Mayville State",NA,NA,NA,17,34,18,11,0,16,0,15,18,33,6,17,34,7,27,0,0,0,5,0.294117647058824,96,6.25
"6591",2022,"McMurry",NA,NA,NA,14,15,10,4,0,12,0,5,6,11,7,25,32,7,25,0,0,0,2,0.142857142857143,67,10.4477611940298
"6592",2022,"Mercyhurst",NA,NA,NA,8,23,12,7,0,27,0,6,7,13,7,27,36,9,27,0,0,0,3,0.375,76,9.21052631578947
"6593",2022,"Mesa College",NA,NA,NA,20,24,4,2,0,9,1,4,13,17,7,16,49,15,34,0,0,0,5,0.25,80,8.75
"6594",2022,"Midway",NA,NA,NA,8,31,11,8,0,15,0,7,9,16,10,33,33,10,23,0,0,0,1,0.125,90,11.1111111111111
"6595",2022,"Millersville",NA,NA,NA,21,43,28,22,0,52,1,13,22,35,12,56,57,9,48,0,0,0,2,0.0952380952380952,144,8.33333333333333
"6596",2022,"Minnesota-Morris",NA,NA,NA,8,24,16,10,0,18,0,6,0,6,4,22,42,11,31,0,0,0,2,0.25,74,5.4054054054054
"6597",2022,"Missouri Baptist",NA,NA,NA,17,40,8,6,0,30,0,12,15,27,14,46,84,20,64,0,0,0,4,0.235294117647059,136,10.2941176470588
"6598",2022,"Missouri S&T",NA,NA,NA,9,50,10,5,0,25,0,21,22,43,9,30,65,26,39,0,0,0,3,0.333333333333333,136,6.61764705882353
"6599",2022,"Mobile",NA,NA,NA,36,45,29,16,0,30,0,18,27,45,16,40,73,20,53,0,0,0,9,0.25,166,9.63855421686747
"6600",2022,"Montevallo",NA,NA,NA,22,24,9,4,0,11,0,14,5,19,11,23,43,7,36,0,0,0,11,0.5,93,11.8279569892473
"6601",2022,"Montreat College",NA,NA,NA,13,18,7,3,0,15,0,1,3,4,3,26,41,8,33,0,0,0,4,0.307692307692308,68,4.41176470588235
"6602",2022,"Mount Olive",NA,NA,NA,13,15,8,6,0,23,0,9,4,13,10,21,50,16,34,0,0,0,3,0.230769230769231,77,12.987012987013
"6603",2022,"Multnomah",NA,NA,NA,9,21,8,5,0,14,0,11,13,24,3,14,35,12,23,0,0,0,5,0.555555555555556,68,4.41176470588235
"6604",2022,"NC Pembroke",NA,NA,NA,9,35,11,7,0,18,0,15,10,25,5,12,33,10,23,0,0,0,5,0.555555555555556,85,5.88235294117647
"6605",2022,"NW Nazarene",NA,NA,NA,17,27,6,5,0,20,0,7,12,19,9,14,60,9,51,0,0,0,3,0.176470588235294,76,11.8421052631579
"6606",2022,"North Carolina Central",NA,NA,NA,333,498,317,203,0,416,5,206,251,457,205,420,795,209,586,0,0,0,81,0.243243243243243,1740,11.7816091954023
"6607",2022,"Northland",NA,NA,NA,4,16,4,2,0,12,0,1,4,5,5,28,39,7,32,0,0,0,1,0.25,57,8.7719298245614
"6608",2022,"Northwest College",NA,NA,NA,16,23,11,6,0,13,0,2,6,8,8,25,48,8,40,0,0,0,2,0.125,75,10.6666666666667
"6609",2022,"Notre Dame College",NA,NA,NA,13,19,6,3,0,18,0,12,7,19,5,23,43,9,34,0,0,0,7,0.538461538461538,76,6.57894736842105
"6610",2022,"Notre Dame of Maryland University",NA,NA,NA,9,19,18,10,0,12,0,6,13,19,6,36,23,4,19,0,0,0,1,0.111111111111111,78,7.69230769230769
"6611",2022,"Oakland City",NA,NA,NA,18,45,31,18,0,42,2,11,13,24,15,56,73,28,45,0,0,0,5,0.277777777777778,165,9.09090909090909
"6612",2022,"Oakwood",NA,NA,NA,16,17,23,12,0,24,0,5,12,17,11,23,33,3,30,0,0,0,5,0.3125,69,15.9420289855072
"6613",2022,"Ohio Christian",NA,NA,NA,9,26,4,3,0,17,0,7,4,11,2,22,52,13,39,0,0,0,3,0.333333333333333,78,2.56410256410256
"6614",2022,"Olivet College",NA,NA,NA,5,18,10,4,0,11,0,5,9,14,5,41,22,6,16,0,0,0,1,0.2,78,6.41025641025641
"6615",2022,"Oregon Tech",NA,NA,NA,10,31,10,7,0,14,0,10,7,17,4,27,34,8,26,0,0,0,0,0,88,4.54545454545455
"6616",2022,"Palm Beach Atlantic University",NA,NA,NA,34,44,18,11,0,40,0,20,32,52,12,49,68,16,52,0,0,0,6,0.176470588235294,167,7.18562874251497
"6617",2022,"Park University Gilbert",NA,NA,NA,38,69,29,15,0,48,0,30,40,70,24,95,86,26,60,0,0,0,11,0.289473684210526,263,9.1254752851711
"6618",2022,"Paul Quinn",NA,NA,NA,40,72,47,25,0,41,0,20,19,39,13,55,73,19,54,0,0,0,18,0.45,219,5.93607305936073
"6619",2022,"Pfeiffer",NA,NA,NA,40,44,14,8,0,38,0,12,20,32,14,53,109,20,89,0,0,0,9,0.225,171,8.18713450292398
"6620",2022,"Philander Smith",NA,NA,NA,16,28,14,6,0,13,0,8,4,12,10,16,45,12,33,0,0,0,6,0.375,84,11.9047619047619
"6621",2022,"Piedmont",NA,NA,NA,14,24,6,5,0,11,0,12,17,29,7,25,34,12,22,0,0,0,3,0.214285714285714,89,7.86516853932584
"6622",2022,"Pittsburgh-Johnstown",NA,NA,NA,17,19,13,6,0,21,0,4,3,7,9,17,51,16,35,0,0,0,6,0.352941176470588,76,11.8421052631579
"6623",2022,"Point Park",NA,NA,NA,8,25,4,2,0,22,0,6,4,10,5,27,42,11,31,0,0,0,1,0.125,77,6.49350649350649
"6624",2022,"Quincy",NA,NA,NA,24,49,10,8,0,28,0,17,22,39,8,43,73,20,53,0,0,0,4,0.166666666666667,154,5.1948051948052
"6625",2022,"Randolph Collge",NA,NA,NA,6,18,2,2,0,17,0,3,4,7,6,28,43,9,34,0,0,0,2,0.333333333333333,64,9.375
"6626",2022,"Regis University",NA,NA,NA,17,27,5,4,0,6,0,10,9,19,5,19,38,8,30,0,0,0,3,0.176470588235294,81,6.17283950617284
"6627",2022,"SAGU American Indian College",NA,NA,NA,16,31,13,8,0,26,0,10,24,34,20,42,93,26,67,0,0,0,1,0.0625,127,15.748031496063
"6628",2022,"Salem University",NA,NA,NA,12,18,9,6,0,19,0,1,12,13,9,14,62,13,49,0,0,0,3,0.25,59,15.2542372881356
"6629",2022,"Schreiner",NA,NA,NA,37,39,27,13,0,34,0,16,24,40,21,48,80,19,61,0,0,0,10,0.27027027027027,167,12.5748502994012
"6630",2022,"Shorter",NA,NA,NA,26,48,19,15,0,36,0,12,27,39,10,26,94,21,73,0,0,0,6,0.230769230769231,138,7.2463768115942
"6631",2022,"Simpson College",NA,NA,NA,10,21,8,6,0,14,0,7,7,14,10,15,58,14,44,0,0,0,1,0.1,70,14.2857142857143
"6632",2022,"Simpson University (CA)",NA,NA,NA,26,46,11,8,0,18,0,10,19,29,16,34,102,32,70,0,0,0,3,0.115384615384615,152,10.5263157894737
"6633",2022,"Slippery Rock",NA,NA,NA,14,32,11,7,0,17,0,11,25,36,6,15,32,9,23,0,0,0,6,0.428571428571429,84,7.14285714285714
"6634",2022,"Sonoma State",NA,NA,NA,12,24,10,5,0,13,0,6,8,14,5,16,40,14,26,0,0,0,5,0.416666666666667,76,6.57894736842105
"6635",2022,"Southern Wesleyan",NA,NA,NA,10,22,6,3,0,14,0,4,7,11,8,24,55,17,38,0,0,0,2,0.2,79,10.126582278481
"6636",2022,"Southwest Assemblies of God",NA,NA,NA,25,48,19,12,0,31,0,22,28,50,19,47,67,16,51,0,0,0,6,0.24,161,11.8012422360248
"6637",2022,"Spalding",NA,NA,NA,12,13,9,6,0,7,0,5,6,11,4,21,41,12,29,0,0,0,5,0.416666666666667,64,6.25
"6638",2022,"Spring Hill",NA,NA,NA,18,26,16,8,0,21,0,6,10,16,6,20,44,14,30,0,0,0,8,0.444444444444444,89,6.74157303370786
"6639",2022,"St Thomas University-Houston",NA,NA,NA,10,21,16,10,0,20,0,9,8,17,5,24,37,3,34,0,0,0,3,0.3,71,7.04225352112676
"6640",2022,"St. Andrews",NA,NA,NA,9,15,6,4,0,25,0,4,7,11,4,32,39,8,31,0,0,0,2,0.222222222222222,71,5.63380281690141
"6641",2022,"St. Edwards",NA,NA,NA,23,41,17,14,0,41,0,10,18,28,10,49,75,16,59,0,0,0,4,0.173913043478261,142,7.04225352112676
"6642",2022,"St. Francis (ILL)",NA,NA,NA,1,17,5,3,0,11,0,8,8,16,9,13,39,16,23,0,0,0,0,0,55,16.3636363636364
"6643",2022,"St. Louis Pharmacy",NA,NA,NA,6,25,15,8,0,16,0,8,11,19,5,20,26,7,19,0,0,0,1,0.166666666666667,70,7.14285714285714
"6644",2022,"Stanislaus State",NA,NA,NA,27,56,25,15,0,26,0,18,22,40,10,22,96,29,67,0,0,0,9,0.333333333333333,158,6.32911392405063
"6645",2022,"Stephens College",NA,NA,NA,13,24,15,10,0,16,0,6,14,20,7,36,29,3,26,0,0,0,1,0.0769230769230769,84,8.33333333333333
"6646",2022,"Talladega",NA,NA,NA,24,39,22,15,0,45,0,26,18,44,16,33,94,32,62,0,0,0,9,0.375,159,10.062893081761
"6647",2022,"Taylor University",NA,NA,NA,15,34,8,6,0,10,0,7,5,12,6,23,47,15,32,0,0,0,4,0.266666666666667,96,6.25
"6648",2022,"Tennessee Southern",NA,NA,NA,38,48,9,7,0,24,0,17,26,43,10,37,92,18,74,0,0,0,10,0.263157894736842,159,6.28930817610063
"6649",2022,"Tennessee Wesleyan",NA,NA,NA,10,41,16,9,0,22,0,14,25,39,11,32,67,16,51,0,0,0,3,0.3,116,9.48275862068965
"6650",2022,"Texas A&M-International",NA,NA,NA,13,26,11,7,0,10,0,15,16,31,12,20,30,11,19,0,0,0,3,0.230769230769231,89,13.4831460674157
"6651",2022,"Texas A&M-Kingsville",NA,NA,NA,14,22,9,6,0,22,0,6,6,12,0,12,44,14,30,0,0,0,3,0.214285714285714,71,0
"6652",2022,"Texas A&M-Texarkana",NA,NA,NA,7,27,9,7,0,20,1,12,14,26,8,25,28,9,19,0,0,0,1,0.142857142857143,82,9.75609756097561
"6653",2022,"Texas College",NA,NA,NA,5,11,9,5,0,13,1,2,6,8,8,12,47,9,38,0,0,0,0,0,40,20
"6654",2022,"Texas Lutheran",NA,NA,NA,13,16,14,5,0,28,0,10,4,14,7,15,38,9,29,0,0,0,4,0.307692307692308,64,10.9375
"6655",2022,"Texas Wesleyan",NA,NA,NA,20,24,13,8,0,18,0,5,13,18,10,23,43,9,34,0,0,0,9,0.45,86,11.6279069767442
"6656",2022,"Thomas University",NA,NA,NA,9,27,13,7,0,26,0,5,10,15,3,42,27,6,21,0,0,0,3,0.333333333333333,92,3.26086956521739
"6657",2022,"Tougaloo",NA,NA,NA,13,23,8,5,0,20,0,2,11,13,6,19,44,14,30,0,0,0,2,0.153846153846154,72,8.33333333333333
"6658",2022,"Transylvania",NA,NA,NA,13,27,11,7,0,16,0,6,3,9,6,22,48,11,37,0,0,0,4,0.307692307692308,82,7.31707317073171
"6659",2022,"Trinity Baptist",NA,NA,NA,8,16,15,8,0,19,0,0,0,0,5,37,44,8,36,0,0,0,0,0,70,7.14285714285714
"6660",2022,"UC Merced",NA,NA,NA,41,58,22,11,0,45,0,19,34,53,16,66,105,24,81,0,0,0,5,0.121951219512195,210,7.61904761904762
"6661",2022,"UNT Dallas",NA,NA,NA,12,19,9,5,0,13,0,4,7,11,1,19,44,13,31,0,0,0,3,0.25,69,1.44927536231884
"6662",2022,"UVF",NA,NA,NA,4,16,4,2,0,15,0,3,10,13,4,26,37,3,34,0,0,0,0,0,53,7.54716981132075
"6663",2022,"Union",NA,NA,NA,9,20,6,5,0,13,0,5,16,21,2,19,33,7,26,0,0,0,1,0.111111111111111,60,3.33333333333333
"6664",2022,"Union Ky College",NA,NA,NA,18,19,7,6,0,28,0,9,6,15,3,37,45,10,35,0,0,0,2,0.111111111111111,94,3.19148936170213
"6665",2022,"University of Science and Arts",NA,NA,NA,38,76,34,21,0,64,0,31,41,72,31,67,112,27,85,0,0,0,14,0.368421052631579,248,12.5
"6666",2022,"University of the Southwest",NA,NA,NA,8,19,12,7,0,16,0,8,6,14,3,18,42,7,35,0,0,0,1,0.125,62,4.83870967741935
"6667",2022,"Upper Iowa University",NA,NA,NA,17,28,10,7,0,23,0,4,10,14,4,15,47,14,33,0,0,0,4,0.235294117647059,83,4.81927710843374
"6668",2022,"Ursinus",NA,NA,NA,6,18,6,3,0,4,0,1,5,6,5,27,39,8,31,0,0,0,1,0.166666666666667,61,8.19672131147541
"6669",2022,"Warner Pacific College",NA,NA,NA,36,66,15,10,0,39,0,26,15,41,25,75,131,36,95,0,0,0,15,0.416666666666667,244,10.2459016393443
"6670",2022,"Warner University",NA,NA,NA,29,75,36,23,0,36,0,21,27,48,10,78,104,26,78,0,0,0,9,0.310344827586207,239,4.18410041841004
"6671",2022,"Warren Wilson",NA,NA,NA,13,17,9,5,0,21,0,5,11,16,6,24,44,8,36,0,0,0,2,0.153846153846154,69,8.69565217391304
"6672",2022,"Washington Adventist",NA,NA,NA,14,33,15,7,0,17,0,9,15,24,2,40,17,3,14,0,0,0,1,0.0714285714285714,104,1.92307692307692
"6673",2022,"Webber International",NA,NA,NA,25,44,29,18,0,37,0,16,24,40,18,45,78,19,59,0,0,0,9,0.36,157,11.4649681528662
"6674",2022,"Wesleyan College",NA,NA,NA,4,16,9,5,0,9,0,3,4,7,3,44,32,10,22,0,0,0,0,0,77,3.8961038961039
"6675",2022,"West Chester",NA,NA,NA,8,26,4,1,0,16,0,4,5,9,8,20,50,9,41,0,0,0,0,0,68,11.7647058823529
"6676",2022,"West New Mexico",NA,NA,NA,7,23,10,5,0,18,0,4,10,14,3,26,31,10,21,0,0,0,3,0.428571428571429,73,4.10958904109589
"6677",2022,"Westcliff",NA,NA,NA,38,69,25,15,0,31,0,13,30,43,18,45,154,43,111,0,0,0,5,0.131578947368421,213,8.45070422535211
"6678",2022,"Western Oregon",NA,NA,NA,9,26,4,2,0,11,0,4,8,12,12,18,47,10,37,0,0,0,0,0,68,17.6470588235294
"6679",2022,"Wiley",NA,NA,NA,31,59,24,16,0,43,0,12,16,28,20,68,86,29,57,0,0,0,8,0.258064516129032,201,9.95024875621891
"6680",2022,"William Carey",NA,NA,NA,14,50,21,15,0,31,1,4,15,19,13,45,75,16,59,0,0,0,6,0.428571428571429,134,9.70149253731343
"6681",2022,"William Jessup",NA,NA,NA,6,22,2,1,0,11,0,2,12,14,8,25,42,10,32,0,0,0,0,0,65,12.3076923076923
"6682",2022,"William Jewell",NA,NA,NA,6,22,6,3,0,17,0,3,0,3,7,23,48,6,42,0,0,0,0,0,61,11.4754098360656
"6683",2022,"William Peace",NA,NA,NA,12,26,18,10,0,21,0,3,9,12,8,32,28,11,17,0,0,0,6,0.5,86,9.30232558139535
"6684",2022,"Winston Salem",NA,NA,NA,12,34,16,8,0,22,0,7,10,17,7,26,33,9,24,0,0,0,5,0.416666666666667,91,7.69230769230769
"6685",2022,"Xavier (LA)",NA,NA,NA,25,48,21,15,0,44,2,11,25,36,16,51,61,15,46,0,0,0,3,0.12,152,10.5263157894737
"6686",2022,"Young Harris College",NA,NA,NA,6,27,7,4,0,17,0,17,12,29,3,18,25,6,19,0,0,0,2,0.333333333333333,74,4.05405405405405
"6687",2023,"Academy Of Art University",NA,NA,NA,9,12,6,4,0,6,0,5,14,19,9,16,41,5,36,0,0,0,2,0.222222222222222,50,18
"6688",2023,"Adams State",NA,NA,NA,27,49,18,10,0,33,0,25,21,46,14,42,67,25,42,0,0,0,6,0.222222222222222,172,8.13953488372093
"6689",2023,"Agnes Scott College",NA,NA,NA,28,41,17,10,0,25,0,12,17,29,10,81,80,11,69,0,0,0,5,0.178571428571429,178,5.61797752808989
"6690",2023,"Alaska Anchorage",NA,NA,NA,6,32,14,10,0,25,0,13,6,19,9,19,39,16,23,0,0,0,1,0.166666666666667,87,10.3448275862069
"6691",2023,"Alice Lloyd College",NA,NA,NA,13,22,4,2,0,16,0,7,8,15,9,27,51,13,38,0,0,0,4,0.307692307692308,83,10.8433734939759
"6692",2023,"Allen",NA,NA,NA,17,27,15,7,0,27,0,9,10,19,9,29,42,7,35,0,0,0,6,0.352941176470588,93,9.67741935483871
"6693",2023,"American International",NA,NA,NA,15,18,13,6,0,13,0,6,11,17,13,12,37,12,25,0,0,0,6,0.4,67,19.4029850746269
"6694",2023,"Antelope Valley",NA,NA,NA,12,20,9,5,0,26,2,4,7,11,9,23,50,11,39,0,0,0,4,0.333333333333333,71,12.6760563380282
"6695",2023,"Arizona Christian",NA,NA,NA,20,26,10,5,0,9,0,7,7,14,6,36,44,12,32,0,0,0,4,0.2,102,5.88235294117647
"6696",2023,"Ark Baptist",NA,NA,NA,33,52,33,16,1,46,1,10,14,24,14,57,86,24,62,0,0,0,8,0.242424242424242,185,7.56756756756757
"6697",2023,"Arlington Baptist",NA,NA,NA,28,46,19,11,0,57,0,10,35,45,22,63,118,32,86,0,0,0,6,0.214285714285714,185,11.8918918918919
"6698",2023,"Auburn-Montgomery",NA,NA,NA,17,29,12,9,0,19,0,10,17,27,8,25,39,8,31,0,0,0,6,0.352941176470588,91,8.79120879120879
"6699",2023,"Ave Maria University",NA,NA,NA,6,29,10,6,0,17,0,6,11,17,7,31,28,6,22,0,0,0,4,0.666666666666667,81,8.64197530864197
"6700",2023,"Bellevue University",NA,NA,NA,15,31,24,15,0,29,0,13,19,32,11,31,77,17,60,0,0,0,4,0.266666666666667,111,9.90990990990991
"6701",2023,"Berry",NA,NA,NA,8,24,6,3,0,18,0,4,2,6,9,16,48,12,36,0,0,0,2,0.25,65,13.8461538461538
"6702",2023,"Bethel (KS)",NA,NA,NA,11,23,9,6,0,12,0,4,16,20,4,19,37,7,30,0,0,0,2,0.181818181818182,66,6.06060606060606
"6703",2023,"Bethel College Indiana",NA,NA,NA,7,17,6,4,0,16,0,12,7,19,9,28,33,9,24,0,0,0,2,0.285714285714286,74,12.1621621621622
"6704",2023,"Biola",NA,NA,NA,5,14,9,5,0,17,0,7,5,12,9,17,36,11,25,0,0,0,3,0.6,58,15.5172413793103
"6705",2023,"Birmingham-Southern",NA,NA,NA,17,25,4,2,0,20,0,7,9,16,7,19,70,22,48,0,0,0,4,0.235294117647059,91,7.69230769230769
"6706",2023,"Bloomsburg University",NA,NA,NA,17,41,17,11,0,26,0,13,13,26,12,39,75,23,52,0,0,0,6,0.352941176470588,138,8.69565217391304
"6707",2023,"Bluefield State",NA,NA,NA,24,43,19,9,0,32,0,19,33,52,21,35,72,22,50,0,0,0,11,0.458333333333333,146,14.3835616438356
"6708",2023,"Bluefield University",NA,NA,NA,13,15,7,4,0,10,0,2,9,11,5,24,54,9,45,0,0,0,4,0.307692307692308,65,7.69230769230769
"6709",2023,"Brescia",NA,NA,NA,23,53,44,26,0,38,0,20,21,41,18,65,51,11,40,0,0,0,9,0.391304347826087,183,9.83606557377049
"6710",2023,"Brevard College",NA,NA,NA,14,19,8,4,0,22,0,5,15,20,11,31,34,6,28,0,0,0,4,0.285714285714286,76,14.4736842105263
"6711",2023,"Bryn Athyn",NA,NA,NA,8,22,1,0,0,12,0,1,6,7,6,26,48,10,38,0,0,0,2,0.25,67,8.95522388059701
"6712",2023,"Cal Lutheran",NA,NA,NA,11,21,9,5,0,20,0,5,4,9,8,21,47,11,36,0,0,0,4,0.363636363636364,72,11.1111111111111
"6713",2023,"Cal State East Bay",NA,NA,NA,18,30,17,11,0,24,0,14,18,32,6,21,34,9,25,0,0,0,5,0.277777777777778,95,6.31578947368421
"6714",2023,"Carolina University",NA,NA,NA,13,22,6,1,0,15,0,6,11,17,6,24,33,11,22,0,0,0,6,0.461538461538462,76,7.89473684210526
"6715",2023,"Carroll (MT)",NA,NA,NA,8,14,4,3,0,14,0,3,5,8,5,11,43,14,29,0,0,0,1,0.125,51,9.80392156862745
"6716",2023,"Cedarville",NA,NA,NA,6,13,4,4,0,14,0,5,4,9,4,16,48,15,33,0,0,0,0,0,56,7.14285714285714
"6717",2023,"Centenary",NA,NA,NA,12,28,5,2,0,17,0,4,13,17,2,35,33,6,27,0,0,0,1,0.0833333333333333,85,2.35294117647059
"6718",2023,"Central Baptist College",NA,NA,NA,10,26,14,7,0,22,1,3,9,12,7,21,38,6,32,0,0,0,1,0.1,67,10.4477611940298
"6719",2023,"Central Christian College",NA,NA,NA,8,24,5,4,0,14,0,5,6,11,4,22,50,8,42,0,0,0,2,0.25,68,5.88235294117647
"6720",2023,"Chicago State",NA,NA,NA,336,731,359,225,0,589,5,272,285,557,188,560,1146,344,802,0,0,0,99,0.294642857142857,2340,8.03418803418803
"6721",2023,"Christian Brothers",NA,NA,NA,17,48,19,13,0,35,0,12,23,35,7,23,93,30,63,0,0,0,7,0.411764705882353,136,5.14705882352941
"6722",2023,"Clarion",NA,NA,NA,12,22,17,11,0,18,0,4,5,9,8,26,40,9,31,0,0,0,1,0.0833333333333333,73,10.958904109589
"6723",2023,"Coastal Georgia",NA,NA,NA,9,30,20,14,0,21,0,7,7,14,1,19,42,8,34,0,0,0,3,0.333333333333333,77,1.2987012987013
"6724",2023,"Coker",NA,NA,NA,6,16,12,5,0,18,0,10,13,23,7,28,31,6,25,0,0,0,1,0.166666666666667,69,10.1449275362319
"6725",2023,"Colby-Sawyer",NA,NA,NA,5,19,6,4,0,16,0,4,5,9,4,31,26,4,22,0,0,0,2,0.4,65,6.15384615384615
"6726",2023,"College St. Mary (SD)",NA,NA,NA,2,28,1,1,0,10,0,5,5,10,6,23,45,8,37,0,0,0,1,0.5,66,9.09090909090909
"6727",2023,"College of Idaho",NA,NA,NA,9,27,7,4,0,18,0,14,13,27,7,19,30,9,21,0,0,0,3,0.333333333333333,79,8.86075949367089
"6728",2023,"Colorado Christian",NA,NA,NA,10,26,15,9,0,21,0,15,10,25,6,17,34,11,23,0,0,0,2,0.2,81,7.40740740740741
"6729",2023,"Colorado Springs",NA,NA,NA,9,38,6,5,0,18,0,11,5,16,7,35,34,10,24,0,0,0,5,0.555555555555556,104,6.73076923076923
"6730",2023,"Columbia College",NA,NA,NA,13,19,4,2,0,13,0,7,9,16,12,29,41,9,32,0,0,0,4,0.307692307692308,78,15.3846153846154
"6731",2023,"Concord College",NA,NA,NA,13,27,7,5,0,18,0,4,15,19,5,23,36,11,25,0,0,0,1,0.0769230769230769,80,6.25
"6732",2023,"Concordia University (CA)",NA,NA,NA,15,21,2,1,0,15,0,13,10,23,7,11,46,11,35,0,0,0,5,0.333333333333333,71,9.85915492957746
"6733",2023,"Connecticut College",NA,NA,NA,8,30,10,5,0,15,0,8,6,14,5,24,31,9,22,0,0,0,1,0.125,81,6.17283950617284
"6734",2023,"Converse College",NA,NA,NA,31,52,25,13,0,30,0,7,18,25,8,54,73,13,60,0,0,0,10,0.32258064516129,164,4.8780487804878
"6735",2023,"Corban University",NA,NA,NA,8,23,9,5,0,14,0,6,6,12,3,26,31,12,19,0,0,0,2,0.25,77,3.8961038961039
"6736",2023,"Cumberland (TN)",NA,NA,NA,15,17,14,7,0,16,0,6,12,18,6,21,31,7,24,0,0,0,4,0.266666666666667,69,8.69565217391304
"6737",2023,"Davis & Elkins",NA,NA,NA,14,23,4,1,0,8,0,10,10,20,4,14,48,9,39,0,0,0,5,0.357142857142857,71,5.63380281690141
"6738",2023,"Dillard",NA,NA,NA,5,28,9,4,0,24,0,5,10,15,6,36,24,8,16,0,0,0,2,0.4,85,7.05882352941176
"6739",2023,"ELIZABETH CITY",NA,NA,NA,3,21,5,1,0,14,0,6,4,10,5,48,25,5,20,0,0,0,1,0.333333333333333,84,5.95238095238095
"6740",2023,"Ecclesia College",NA,NA,NA,11,21,6,3,0,18,0,5,10,15,5,28,45,5,40,0,0,0,1,0.0909090909090909,71,7.04225352112676
"6741",2023,"Emerson College",NA,NA,NA,5,21,9,4,0,13,0,5,12,17,6,23,36,5,31,0,0,0,2,0.4,61,9.83606557377049
"6742",2023,"Emmanuel",NA,NA,NA,13,19,7,5,0,21,0,11,9,20,10,24,38,9,29,0,0,0,3,0.230769230769231,78,12.8205128205128
"6743",2023,"Emory & Henry",NA,NA,NA,20,59,12,7,0,27,0,11,6,17,10,41,101,26,75,0,0,0,6,0.3,158,6.32911392405063
"6744",2023,"Erskine",NA,NA,NA,22,53,21,13,0,54,0,9,15,24,19,93,99,22,77,0,0,0,3,0.136363636363636,200,9.5
"6745",2023,"Eureka College",NA,NA,NA,14,34,10,6,0,22,0,3,16,19,4,26,43,14,29,0,0,0,3,0.214285714285714,92,4.34782608695652
"6746",2023,"Evergreen State",NA,NA,NA,34,79,24,14,0,61,0,18,21,39,28,94,167,43,124,0,0,0,10,0.294117647058824,274,10.2189781021898
"6747",2023,"Findlay",NA,NA,NA,5,23,5,5,0,11,0,8,11,19,4,17,36,10,26,0,0,0,0,0,64,6.25
"6748",2023,"Fisher College",NA,NA,NA,6,14,4,2,0,9,0,3,11,14,6,20,34,10,24,0,0,0,1,0.166666666666667,54,11.1111111111111
"6749",2023,"Fisk",NA,NA,NA,44,68,49,31,0,42,0,20,38,58,3,57,53,15,38,0,0,0,15,0.340909090909091,215,1.3953488372093
"6750",2023,"Flagler",NA,NA,NA,8,27,10,7,0,21,0,11,13,24,2,28,28,9,19,0,0,0,5,0.625,86,2.32558139534884
"6751",2023,"Florida National",NA,NA,NA,18,42,9,5,0,35,0,12,15,27,16,66,79,17,62,0,0,0,6,0.333333333333333,157,10.1910828025478
"6752",2023,"Fresno Pacific",NA,NA,NA,15,29,13,7,0,25,0,6,9,15,4,22,39,11,28,0,0,0,7,0.466666666666667,86,4.65116279069767
"6753",2023,"Georgia College",NA,NA,NA,15,26,14,7,0,10,0,11,11,22,5,18,40,7,33,0,0,0,4,0.266666666666667,80,6.25
"6754",2023,"Georgia Southwestern",NA,NA,NA,12,16,14,9,0,17,0,9,12,21,10,23,24,2,22,0,0,0,4,0.333333333333333,64,15.625
"6755",2023,"Goshen College",NA,NA,NA,13,22,10,6,0,21,0,10,17,27,1,27,22,6,16,0,0,0,1,0.0769230769230769,78,1.28205128205128
"6756",2023,"Guilford",NA,NA,NA,13,30,13,7,0,21,1,22,12,34,3,28,25,8,17,0,0,0,4,0.307692307692308,105,2.85714285714286
"6757",2023,"Gwynedd-Mercy",NA,NA,NA,12,18,3,2,0,9,0,2,12,14,5,18,46,12,34,0,0,0,2,0.166666666666667,62,8.06451612903226
"6758",2023,"Hannibal-LaGrange",NA,NA,NA,9,12,0,0,0,15,0,3,5,8,3,20,45,14,31,0,0,0,3,0.333333333333333,58,5.17241379310345
"6759",2023,"Hendrix College",NA,NA,NA,19,47,23,12,0,26,0,12,18,30,9,38,82,25,57,0,0,0,5,0.263157894736842,146,6.16438356164384
"6760",2023,"Hillsdale",NA,NA,NA,5,22,11,7,0,17,1,5,7,12,1,12,41,16,25,0,0,0,1,0.2,64,1.5625
"6761",2023,"Hiram",NA,NA,NA,6,18,14,9,0,24,0,2,12,14,0,35,24,5,19,0,0,0,0,0,67,0
"6762",2023,"Howard Payne",NA,NA,NA,22,50,18,10,0,29,0,14,28,42,4,55,59,12,47,0,0,0,6,0.272727272727273,157,2.54777070063694
"6763",2023,"Huston-Tillotson",NA,NA,NA,13,16,10,5,0,23,0,14,9,23,4,41,23,4,19,0,0,0,2,0.153846153846154,89,4.49438202247191
"6764",2023,"Indiana University East",NA,NA,NA,15,23,15,8,0,16,0,12,10,22,3,31,30,5,25,0,0,0,3,0.2,90,3.33333333333333
"6765",2023,"Jarvis Christian",NA,NA,NA,44,90,57,38,0,65,1,27,39,66,18,83,103,30,73,0,0,0,13,0.295454545454545,287,6.27177700348432
"6766",2023,"Johnson & Wales (NC)",NA,NA,NA,24,30,22,12,0,29,0,15,13,28,19,54,76,23,53,0,0,0,4,0.166666666666667,152,12.5
"6767",2023,"Johnson C. Smith",NA,NA,NA,30,43,37,24,0,37,1,16,33,49,21,49,65,16,49,0,0,0,12,0.4,165,12.7272727272727
"6768",2023,"Johnson University (FL)",NA,NA,NA,5,23,9,5,0,10,0,2,9,11,2,22,31,4,27,0,0,0,1,0.2,57,3.50877192982456
"6769",2023,"King College TN",NA,NA,NA,10,31,5,3,0,16,0,4,10,14,3,11,47,16,31,0,0,0,4,0.4,74,4.05405405405405
"6770",2023,"LSU Alexandria",NA,NA,NA,9,46,15,11,0,36,0,12,9,21,22,64,66,13,53,0,0,0,2,0.222222222222222,147,14.9659863945578
"6771",2023,"LSU Shreveport",NA,NA,NA,22,36,20,11,0,24,0,11,15,26,18,40,67,16,51,0,0,0,11,0.5,130,13.8461538461538
"6772",2023,"La Sierra University",NA,NA,NA,17,44,18,11,0,17,0,12,17,29,15,47,69,16,53,0,0,0,4,0.235294117647059,142,10.5633802816901
"6773",2023,"La Verne",NA,NA,NA,33,58,27,18,0,25,0,13,32,45,12,41,107,27,80,0,0,0,10,0.303030303030303,177,6.77966101694915
"6774",2023,"LaGrange College",NA,NA,NA,41,44,9,5,0,37,0,12,34,46,9,46,97,21,76,0,0,0,6,0.146341463414634,166,5.42168674698795
"6775",2023,"Le Moyne-Owen",NA,NA,NA,18,24,14,8,0,20,0,6,12,18,6,16,42,10,32,0,0,0,5,0.277777777777778,77,7.79220779220779
"6776",2023,"Le Tourneau",NA,NA,NA,1,32,7,5,0,25,0,4,10,14,9,31,35,7,28,0,0,0,0,0,76,11.8421052631579
"6777",2023,"Lees-McRae",NA,NA,NA,23,26,6,5,0,21,0,8,21,29,6,20,43,4,39,0,0,0,5,0.217391304347826,82,7.31707317073171
"6778",2023,"Lenoir-Rhyne College",NA,NA,NA,23,49,32,19,0,27,0,32,29,61,18,19,60,13,47,0,0,0,8,0.347826086956522,144,12.5
"6779",2023,"Life University",NA,NA,NA,31,44,20,10,0,43,0,19,23,42,16,51,72,22,50,0,0,0,10,0.32258064516129,172,9.30232558139535
"6780",2023,"Limestone",NA,NA,NA,5,12,8,5,0,10,0,5,7,12,13,15,41,13,28,0,0,0,3,0.6,54,24.0740740740741
"6781",2023,"Lincoln PA",NA,NA,NA,17,23,14,9,0,13,0,10,17,27,7,15,38,14,24,0,0,0,6,0.352941176470588,84,8.33333333333333
"6782",2023,"Lincoln University (CA)",NA,NA,NA,7,22,9,5,0,8,1,4,13,17,7,19,38,10,28,0,0,0,2,0.285714285714286,64,10.9375
"6783",2023,"Louisiana College",NA,NA,NA,25,52,18,12,0,39,0,20,17,37,14,58,67,18,49,0,0,0,8,0.32,175,8
"6784",2023,"Loyola (LA)",NA,NA,NA,12,19,13,8,0,19,0,10,18,28,7,15,29,12,17,0,0,0,4,0.333333333333333,71,9.85915492957746
"6785",2023,"Madonna University",NA,NA,NA,7,22,10,6,0,19,0,12,9,21,4,22,32,8,24,0,0,0,3,0.428571428571429,73,5.47945205479452
"6786",2023,"Mayville State",NA,NA,NA,9,27,21,12,0,19,0,9,13,22,7,28,26,10,16,0,0,0,2,0.222222222222222,84,8.33333333333333
"6787",2023,"McMurry",NA,NA,NA,3,20,16,11,0,16,0,9,7,16,7,22,24,6,18,0,0,0,0,0,63,11.1111111111111
"6788",2023,"Mercy",NA,NA,NA,18,23,17,9,0,15,0,5,6,11,8,19,42,10,32,0,0,0,10,0.555555555555556,82,9.75609756097561
"6789",2023,"Meredith College",NA,NA,NA,10,30,4,2,0,20,0,3,9,12,3,37,42,11,31,0,0,0,4,0.4,91,3.2967032967033
"6790",2023,"Mesa",NA,NA,NA,10,18,16,9,0,25,0,6,17,23,11,13,47,15,32,0,0,0,3,0.3,66,16.6666666666667
"6791",2023,"Middle Georgia State",NA,NA,NA,15,24,20,13,0,27,0,14,12,26,5,17,35,3,32,0,0,0,4,0.266666666666667,76,6.57894736842105
"6792",2023,"Midland University",NA,NA,NA,2,18,5,4,0,10,0,5,11,16,3,19,32,9,23,0,0,0,0,0,54,5.55555555555556
"6793",2023,"Midway",NA,NA,NA,16,23,12,9,0,23,0,14,23,37,13,15,34,5,29,0,0,0,3,0.1875,78,16.6666666666667
"6794",2023,"Miles",NA,NA,NA,27,43,22,14,0,35,0,17,19,36,16,29,91,19,72,0,0,0,11,0.407407407407407,138,11.5942028985507
"6795",2023,"Mississippi College",NA,NA,NA,20,23,11,7,0,17,0,6,9,15,7,33,38,8,30,0,0,0,9,0.45,94,7.4468085106383
"6796",2023,"Missouri Baptist",NA,NA,NA,14,29,9,5,0,21,0,4,3,7,11,20,50,14,36,0,0,0,4,0.285714285714286,85,12.9411764705882
"6797",2023,"Missouri-St. Louis",NA,NA,NA,24,51,13,6,0,28,0,12,8,20,4,24,94,31,63,0,0,0,7,0.291666666666667,144,2.77777777777778
"6798",2023,"Mobile",NA,NA,NA,18,43,22,15,0,34,0,26,21,47,20,34,65,22,43,0,0,0,6,0.333333333333333,148,13.5135135135135
"6799",2023,"Montana Tech",NA,NA,NA,14,26,10,5,0,13,0,6,12,18,3,14,42,16,26,0,0,0,9,0.642857142857143,80,3.75
"6800",2023,"Montreat College",NA,NA,NA,14,46,22,11,0,32,0,6,10,16,15,28,86,26,60,0,0,0,4,0.285714285714286,125,12
"6801",2023,"Mount Olive",NA,NA,NA,9,19,6,5,0,23,1,4,3,7,6,30,38,18,20,0,0,0,2,0.222222222222222,82,7.31707317073171
"6802",2023,"Mount Vernon Nazarene",NA,NA,NA,6,26,7,5,0,16,0,5,3,8,6,24,42,9,33,0,0,0,2,0.333333333333333,71,8.45070422535211
"6803",2023,"Multnomah",NA,NA,NA,12,21,9,5,0,16,0,7,8,15,10,16,55,16,39,0,0,0,2,0.166666666666667,73,13.6986301369863
"6804",2023,"NC Wesleyan",NA,NA,NA,42,71,34,16,0,40,0,23,33,56,23,75,111,21,90,0,0,0,9,0.214285714285714,239,9.6234309623431
"6805",2023,"NM Highlands",NA,NA,NA,27,36,14,6,0,24,0,11,26,37,14,35,68,14,54,0,0,0,5,0.185185185185185,126,11.1111111111111
"6806",2023,"New Jersey City",NA,NA,NA,23,58,21,15,0,36,0,10,12,22,11,48,92,32,60,0,0,0,6,0.260869565217391,175,6.28571428571429
"6807",2023,"Northern New Mexico",NA,NA,NA,34,52,16,10,0,36,0,23,50,73,28,67,106,34,72,0,0,0,10,0.294117647058824,213,13.1455399061033
"6808",2023,"Notre Dame College",NA,NA,NA,11,26,8,4,0,14,0,4,6,10,2,22,46,16,30,0,0,0,3,0.272727272727273,81,2.46913580246914
"6809",2023,"Notre Dame of Maryland University",NA,NA,NA,8,18,11,7,0,9,0,12,7,19,3,25,25,7,18,0,0,0,5,0.625,71,4.22535211267606
"6810",2023,"Nyack College",NA,NA,NA,12,24,16,9,0,14,0,8,13,21,11,27,27,8,19,0,0,0,2,0.166666666666667,83,13.2530120481928
"6811",2023,"Oakland City",NA,NA,NA,16,16,12,7,0,18,0,8,15,23,19,33,35,4,31,0,0,0,0,0,78,24.3589743589744
"6812",2023,"Oakwood",NA,NA,NA,11,32,13,8,0,17,0,3,10,13,7,23,45,13,32,0,0,0,4,0.363636363636364,86,8.13953488372093
"6813",2023,"Ohio Christian",NA,NA,NA,8,20,8,4,0,18,0,6,15,21,9,22,40,7,33,0,0,0,2,0.25,64,14.0625
"6814",2023,"Olivet College",NA,NA,NA,8,30,8,5,0,16,0,7,10,17,3,29,32,9,23,0,0,0,0,0,84,3.57142857142857
"6815",2023,"Oswego St",NA,NA,NA,11,18,6,3,0,15,0,1,7,8,9,28,39,10,29,0,0,0,4,0.363636363636364,70,12.8571428571429
"6816",2023,"Otterbein",NA,NA,NA,8,18,2,2,0,22,0,8,18,26,5,25,29,6,23,0,0,0,2,0.25,66,7.57575757575758
"6817",2023,"Our Lady Of The Lake",NA,NA,NA,9,20,12,8,0,21,0,5,8,13,10,20,39,14,25,0,0,0,1,0.111111111111111,70,14.2857142857143
"6818",2023,"Palm Beach Atlantic University",NA,NA,NA,16,43,18,10,0,31,0,16,17,33,12,38,62,10,52,0,0,0,9,0.5625,129,9.30232558139535
"6819",2023,"Peru State College",NA,NA,NA,12,24,16,11,0,22,0,9,21,30,10,25,36,11,25,0,0,0,3,0.25,87,11.4942528735632
"6820",2023,"Pfeiffer",NA,NA,NA,14,45,16,10,0,33,0,16,22,38,18,63,59,13,46,0,0,0,3,0.214285714285714,154,11.6883116883117
"6821",2023,"Philander Smith",NA,NA,NA,11,15,5,4,0,24,0,9,15,24,8,26,36,9,27,0,0,0,2,0.181818181818182,71,11.2676056338028
"6822",2023,"Pittsburgh-Johnstown",NA,NA,NA,14,47,18,11,0,31,0,22,27,49,18,33,71,17,54,0,0,0,2,0.142857142857143,134,13.4328358208955
"6823",2023,"Point Park",NA,NA,NA,23,50,26,15,0,33,0,12,29,41,7,49,79,18,61,0,0,0,6,0.260869565217391,155,4.51612903225806
"6824",2023,"Post University",NA,NA,NA,16,20,9,7,0,10,0,4,2,6,5,15,59,15,44,0,0,0,5,0.3125,72,6.94444444444444
"6825",2023,"ProvidenceMT",NA,NA,NA,24,50,17,12,0,28,0,11,21,32,11,46,68,15,53,0,0,0,10,0.416666666666667,152,7.23684210526316
"6826",2023,"Queens College",NA,NA,NA,6,20,15,10,0,20,0,13,9,22,9,17,29,12,17,0,0,0,2,0.333333333333333,69,13.0434782608696
"6827",2023,"Regis University",NA,NA,NA,26,56,12,8,0,30,0,14,25,39,4,31,82,24,58,0,0,0,8,0.307692307692308,156,2.56410256410256
"6828",2023,"SUNY-Old Westbury",NA,NA,NA,9,23,3,1,0,17,0,1,6,7,4,38,31,6,25,0,0,0,2,0.222222222222222,78,5.12820512820513
"6829",2023,"Salem College",NA,NA,NA,12,22,8,3,0,25,0,9,8,17,9,26,39,10,29,0,0,0,3,0.25,79,11.3924050632911
"6830",2023,"Salem University",NA,NA,NA,13,27,9,4,0,18,0,4,10,14,4,19,39,12,27,0,0,0,3,0.230769230769231,77,5.1948051948052
"6831",2023,"San Diego Christian",NA,NA,NA,12,33,13,7,0,18,0,5,8,13,6,37,34,5,29,0,0,0,3,0.25,95,6.31578947368421
"6832",2023,"Schreiner",NA,NA,NA,8,19,7,6,0,15,0,10,8,18,8,29,29,5,24,0,0,0,3,0.375,74,10.8108108108108
"6833",2023,"Shepherd College",NA,NA,NA,16,26,5,2,0,20,0,5,11,16,4,26,40,10,30,0,0,0,3,0.1875,84,4.76190476190476
"6834",2023,"Shorter",NA,NA,NA,16,21,17,10,0,19,0,9,14,23,6,22,38,2,36,0,0,0,6,0.375,75,8
"6835",2023,"Simmons College Of Kentucky",NA,NA,NA,13,19,20,12,0,21,0,2,5,7,16,21,49,12,37,0,0,0,6,0.461538461538462,72,22.2222222222222
"6836",2023,"Southern Wesleyan",NA,NA,NA,32,65,28,15,0,57,0,17,15,32,30,60,141,38,103,0,0,0,11,0.34375,217,13.8248847926267
"6837",2023,"Spalding",NA,NA,NA,8,26,12,6,0,10,0,9,12,21,3,27,24,5,19,0,0,0,1,0.125,76,3.94736842105263
"6838",2023,"Spring Hill",NA,NA,NA,12,27,6,3,0,19,0,14,10,24,8,28,35,5,30,0,0,0,5,0.416666666666667,87,9.19540229885057
"6839",2023,"St Thomas University-Houston",NA,NA,NA,28,41,33,13,0,32,0,8,15,23,16,48,73,13,60,0,0,0,8,0.285714285714286,143,11.1888111888112
"6840",2023,"St. Andrews",NA,NA,NA,34,40,14,7,0,41,0,8,22,30,22,51,98,13,85,0,0,0,5,0.147058823529412,147,14.9659863945578
"6841",2023,"St. Francis (ILL)",NA,NA,NA,13,38,24,15,0,22,0,15,16,31,7,13,32,8,24,0,0,0,1,0.0769230769230769,94,7.4468085106383
"6842",2023,"St. Louis Pharmacy",NA,NA,NA,7,26,13,10,0,11,0,9,14,23,8,23,17,5,12,0,0,0,3,0.428571428571429,72,11.1111111111111
"6843",2023,"St. Mary's (TX)",NA,NA,NA,11,28,10,6,0,12,0,11,11,22,7,20,29,3,26,0,0,0,2,0.181818181818182,76,9.21052631578947
"6844",2023,"St. Xavier",NA,NA,NA,30,56,35,21,0,52,0,21,25,46,18,47,72,22,50,0,0,0,7,0.233333333333333,183,9.83606557377049
"6845",2023,"Stanislaus State",NA,NA,NA,30,43,25,13,0,40,0,16,19,35,15,48,79,13,66,0,0,0,9,0.3,155,9.67741935483871
"6846",2023,"Sul Ross",NA,NA,NA,17,25,4,3,0,10,0,1,8,9,7,27,47,11,36,0,0,0,2,0.117647058823529,81,8.64197530864197
"6847",2023,"Talladega",NA,NA,NA,8,14,10,6,0,10,0,5,1,6,7,19,38,12,26,0,0,0,2,0.25,59,11.864406779661
"6848",2023,"Tennessee Wesleyan",NA,NA,NA,19,40,17,11,0,26,0,16,24,40,11,39,68,18,50,0,0,0,3,0.157894736842105,133,8.27067669172932
"6849",2023,"Texas Wesleyan",NA,NA,NA,15,15,6,3,0,18,0,8,16,24,9,21,38,9,29,0,0,0,4,0.266666666666667,68,13.2352941176471
"6850",2023,"Tiffin",NA,NA,NA,3,20,4,2,0,25,0,11,9,20,6,19,22,3,19,0,0,0,1,0.333333333333333,57,10.5263157894737
"6851",2023,"Toccoa Falls",NA,NA,NA,12,29,10,5,0,12,0,6,10,16,5,26,37,8,29,0,0,0,2,0.166666666666667,84,5.95238095238095
"6852",2023,"Tougaloo",NA,NA,NA,18,22,10,5,0,23,0,2,10,12,13,19,52,8,44,0,0,0,5,0.277777777777778,71,18.3098591549296
"6853",2023,"Trinity Baptist",NA,NA,NA,10,19,16,8,0,21,0,3,5,8,5,25,53,10,43,0,0,0,1,0.1,73,6.84931506849315
"6854",2023,"UC Merced",NA,NA,NA,8,23,3,1,0,10,0,4,8,12,1,21,39,7,32,0,0,0,1,0.125,63,1.58730158730159
"6855",2023,"UC Santa Cruz",NA,NA,NA,11,28,6,5,0,18,0,6,21,27,6,19,35,4,31,0,0,0,1,0.0909090909090909,69,8.69565217391304
"6856",2023,"UNT Dallas",NA,NA,NA,35,88,37,20,0,81,0,29,47,76,24,90,132,41,91,0,0,0,7,0.2,293,8.19112627986348
"6857",2023,"Union Ky College",NA,NA,NA,14,26,19,11,0,21,0,9,8,17,7,31,34,6,28,0,0,0,3,0.214285714285714,89,7.86516853932584
"6858",2023,"University of the Southwest",NA,NA,NA,20,48,17,11,0,40,0,13,23,36,12,53,69,10,59,0,0,0,7,0.35,149,8.05369127516778
"6859",2023,"VU of Lynchburg",NA,NA,NA,26,52,14,8,0,34,1,12,21,33,25,125,174,32,142,0,0,0,5,0.192307692307692,249,10.0401606425703
"6860",2023,"Valley City State",NA,NA,NA,19,18,22,12,0,24,0,3,12,15,8,26,37,9,28,0,0,0,3,0.157894736842105,78,10.2564102564103
"6861",2023,"Villa Maria",NA,NA,NA,14,20,5,3,0,12,0,7,15,22,9,23,30,5,25,0,0,0,2,0.142857142857143,71,12.6760563380282
"6862",2023,"Virginia Union",NA,NA,NA,15,30,7,5,0,20,0,8,5,13,5,26,46,14,32,0,0,0,3,0.2,95,5.26315789473684
"6863",2023,"W. Virginia Tech",NA,NA,NA,9,17,4,2,0,11,0,5,3,8,3,25,47,11,36,0,0,0,1,0.111111111111111,68,4.41176470588235
"6864",2023,"Warner Pacific College",NA,NA,NA,7,27,9,5,0,15,0,10,6,16,8,24,30,6,24,0,0,0,1,0.142857142857143,77,10.3896103896104
"6865",2023,"Warner University",NA,NA,NA,14,43,28,19,0,31,0,23,15,38,14,40,65,18,47,0,0,0,2,0.142857142857143,147,9.52380952380952
"6866",2023,"Warren Wilson",NA,NA,NA,9,18,5,3,0,11,0,2,4,6,3,21,45,12,33,0,0,0,4,0.444444444444444,63,4.76190476190476
"6867",2023,"Waynesburg College",NA,NA,NA,12,25,10,7,0,22,0,8,4,12,3,37,35,5,30,0,0,0,5,0.416666666666667,92,3.26086956521739
"6868",2023,"West New Mexico",NA,NA,NA,18,22,13,8,0,14,0,12,15,27,5,29,32,8,24,0,0,0,2,0.111111111111111,90,5.55555555555556
"6869",2023,"West Virginia Wesleyan",NA,NA,NA,13,16,10,6,0,15,0,4,8,12,7,25,32,8,24,0,0,0,5,0.384615384615385,69,10.1449275362319
"6870",2023,"Westcliff",NA,NA,NA,5,20,8,6,0,8,0,4,7,11,7,21,35,7,28,0,0,0,0,0,59,11.864406779661
"6871",2023,"Western Colorado",NA,NA,NA,21,48,17,13,0,32,0,11,7,18,4,32,86,24,62,0,0,0,4,0.19047619047619,140,2.85714285714286
"6872",2023,"Westminster College (MO)",NA,NA,NA,4,31,23,14,0,32,0,5,7,12,2,38,27,8,19,0,0,0,2,0.5,92,2.17391304347826
"6873",2023,"Wheeling Jesuit",NA,NA,NA,10,29,11,7,0,21,0,9,16,25,3,24,28,7,21,0,0,0,2,0.2,81,3.7037037037037
"6874",2023,"Whittier",NA,NA,NA,4,23,6,4,0,10,0,3,6,9,4,22,38,8,30,0,0,0,0,0,61,6.55737704918033
"6875",2023,"Wilberforce University",NA,NA,NA,26,40,34,23,0,44,1,19,25,44,17,53,68,16,52,0,0,0,13,0.5,163,10.4294478527607
"6876",2023,"Wiley",NA,NA,NA,16,29,21,13,0,17,1,13,17,30,9,19,35,8,27,0,0,0,7,0.4375,91,9.89010989010989
"6877",2023,"Willamette",NA,NA,NA,6,18,7,4,0,21,0,9,6,15,6,24,35,13,22,0,0,0,2,0.333333333333333,71,8.45070422535211
"6878",2023,"William Carey",NA,NA,NA,10,21,6,3,0,20,0,4,0,4,8,24,46,20,26,0,0,0,3,0.3,81,9.87654320987654
"6879",2023,"William Jessup",NA,NA,NA,8,26,3,2,0,14,0,9,12,21,2,15,44,4,40,0,0,0,1,0.125,64,3.125
"6880",2023,"William Peace",NA,NA,NA,18,20,8,4,0,20,0,7,12,19,3,13,54,9,45,0,0,0,4,0.222222222222222,68,4.41176470588235
"6881",2023,"Wilmington (DE)",NA,NA,NA,28,46,12,6,0,23,0,5,8,13,6,41,97,25,72,0,0,0,6,0.214285714285714,150,4
"6882",2023,"Wisconsin-Superior",NA,NA,NA,11,25,9,5,0,19,0,4,10,14,8,27,38,7,31,0,0,0,4,0.363636363636364,77,10.3896103896104
"6883",2023,"Young Harris College",NA,NA,NA,11,28,14,6,0,20,0,6,4,10,5,27,35,8,27,0,0,0,2,0.181818181818182,83,6.02409638554217
"6884",2024,"Academy of Art",NA,NA,NA,10,22,12,5,0,17,1,10,14,24,11,22,32,10,22,0,0,0,2,0.2,76,14.4736842105263
"6885",2024,"Adelphi",NA,NA,NA,13,29,8,4,0,18,0,9,10,19,8,19,45,8,37,0,0,0,5,0.384615384615385,79,10.126582278481
"6886",2024,"Agnes Scott College",NA,NA,NA,5,14,9,5,0,13,0,4,7,11,3,28,27,5,22,0,0,0,0,0,58,5.17241379310345
"6887",2024,"Alabama-Huntsville",NA,NA,NA,18,36,21,13,0,28,0,15,17,32,11,38,61,21,40,0,0,0,5,0.277777777777778,131,8.3969465648855
"6888",2024,"Alaska",NA,NA,NA,14,30,7,5,0,9,1,7,10,17,8,24,41,15,26,0,0,0,3,0.214285714285714,91,8.79120879120879
"6889",2024,"Alaska Anchorage",NA,NA,NA,29,35,12,6,0,41,0,22,21,43,15,35,83,24,59,0,0,0,6,0.206896551724138,148,10.1351351351351
"6890",2024,"Albany St (GA)",NA,NA,NA,10,18,14,10,0,15,0,3,5,8,6,30,43,12,31,0,0,0,1,0.1,76,7.89473684210526
"6891",2024,"Allen University",NA,NA,NA,18,28,8,4,0,25,1,8,15,23,12,32,51,11,40,0,0,0,2,0.111111111111111,97,12.3711340206186
"6892",2024,"Anderson (SC)",NA,NA,NA,17,21,14,11,0,21,0,14,16,30,12,21,42,11,31,0,0,0,6,0.352941176470588,85,14.1176470588235
"6893",2024,"Angelo State",NA,NA,NA,11,21,6,3,0,20,0,10,11,21,8,18,37,14,23,0,0,0,5,0.454545454545455,76,10.5263157894737
"6894",2024,"Antelope Valley",NA,NA,NA,10,22,8,6,0,15,0,4,5,9,7,24,42,14,28,0,0,0,3,0.3,77,9.09090909090909
"6895",2024,"Apprentice School",NA,NA,NA,25,20,18,9,0,22,0,7,5,12,9,21,49,7,42,0,0,0,9,0.36,84,10.7142857142857
"6896",2024,"Aquinas",NA,NA,NA,13,32,14,10,0,16,0,6,7,13,12,25,39,7,32,0,0,0,3,0.230769230769231,86,13.953488372093
"6897",2024,"Arcadia University",NA,NA,NA,8,23,4,3,0,8,0,4,9,13,7,26,28,9,19,0,0,0,0,0,71,9.85915492957746
"6898",2024,"Arizona Christian",NA,NA,NA,10,23,2,1,0,10,0,10,12,22,6,33,37,8,29,0,0,0,1,0.1,85,7.05882352941176
"6899",2024,"Arkansas Baptist",NA,NA,NA,32,62,38,21,0,53,0,23,46,69,24,78,82,20,62,0,0,0,3,0.09375,223,10.762331838565
"6900",2024,"Arlington Baptist",NA,NA,NA,7,19,11,5,0,27,0,13,18,31,7,26,26,5,21,0,0,0,1,0.142857142857143,70,10
"6901",2024,"Asbury",NA,NA,NA,12,29,13,9,0,12,0,6,9,15,9,28,44,16,28,0,0,0,3,0.25,91,9.89010989010989
"6902",2024,"Auburn-Montgomery",NA,NA,NA,14,18,4,3,0,17,0,5,7,12,5,18,50,14,36,0,0,0,0,0,70,7.14285714285714
"6903",2024,"Ave Maria",NA,NA,NA,10,18,6,3,0,19,0,3,11,14,3,23,36,9,27,0,0,0,4,0.4,65,4.61538461538462
"6904",2024,"Averett",NA,NA,NA,9,26,9,6,0,20,1,5,10,15,10,35,33,4,29,0,0,0,1,0.111111111111111,80,12.5
"6905",2024,"Bellevue University",NA,NA,NA,17,22,16,8,0,18,0,0,4,4,6,26,47,10,37,0,0,0,6,0.352941176470588,80,7.5
"6906",2024,"Berry",NA,NA,NA,11,21,7,5,0,14,0,3,9,12,10,34,36,11,25,0,0,0,1,0.0909090909090909,81,12.3456790123457
"6907",2024,"Bethesda University",NA,NA,NA,29,41,3,2,0,27,0,6,20,26,17,47,116,18,98,0,0,0,4,0.137931034482759,141,12.0567375886525
"6908",2024,"Biola",NA,NA,NA,21,36,18,13,0,28,0,12,19,31,18,38,86,19,67,0,0,0,5,0.238095238095238,131,13.7404580152672
"6909",2024,"Bloomfield",NA,NA,NA,19,23,10,5,0,14,0,6,13,19,5,18,41,8,33,0,0,0,7,0.368421052631579,77,6.49350649350649
"6910",2024,"Bloomsburg",NA,NA,NA,7,25,4,2,0,20,0,10,5,15,5,23,37,15,22,0,0,0,3,0.428571428571429,80,6.25
"6911",2024,"Bob Jones",NA,NA,NA,5,14,4,3,0,17,0,0,11,11,6,30,40,14,26,0,0,0,0,0,64,9.375
"6912",2024,"Bowie State",NA,NA,NA,8,26,12,6,0,26,0,5,13,18,3,21,34,10,24,0,0,0,3,0.375,73,4.10958904109589
"6913",2024,"Brescia",NA,NA,NA,11,16,10,6,0,16,0,6,10,16,8,19,33,7,26,0,0,0,5,0.454545454545455,62,12.9032258064516
"6914",2024,"Brevard",NA,NA,NA,15,26,9,3,0,16,0,4,12,16,6,23,40,10,30,0,0,0,2,0.133333333333333,79,7.59493670886076
"6915",2024,"Bridgewater State (MA)",NA,NA,NA,8,19,13,8,0,16,0,15,13,28,11,17,30,9,21,0,0,0,3,0.375,72,15.2777777777778
"6916",2024,"Bryan (TN)",NA,NA,NA,9,20,9,4,0,18,0,12,10,22,6,18,30,10,20,0,0,0,4,0.444444444444444,72,8.33333333333333
"6917",2024,"Bryant & Stratton",NA,NA,NA,17,13,11,7,0,14,0,12,18,30,11,25,30,10,20,0,0,0,5,0.294117647058824,79,13.9240506329114
"6918",2024,"Bushnell",NA,NA,NA,6,22,10,7,0,10,0,8,2,10,8,12,42,15,27,0,0,0,1,0.166666666666667,65,12.3076923076923
"6919",2024,"Cal Lutheran",NA,NA,NA,18,33,6,3,0,21,0,8,8,16,3,27,46,11,35,0,0,0,6,0.333333333333333,98,3.06122448979592
"6920",2024,"Cal Maritime",NA,NA,NA,10,10,10,6,0,8,0,4,12,16,2,21,38,11,27,0,0,0,5,0.5,59,3.38983050847458
"6921",2024,"Cal State East Bay",NA,NA,NA,19,18,15,11,0,14,0,11,11,22,6,20,34,12,22,0,0,0,6,0.31578947368421,82,7.31707317073171
"6922",2024,"Caltech",NA,NA,NA,5,12,1,1,0,10,0,3,10,13,9,11,48,14,34,0,0,0,1,0.2,45,20
"6923",2024,"Campbellsville-Harrodsburg",NA,NA,NA,14,44,13,9,0,22,0,5,18,23,1,50,78,19,59,0,0,0,3,0.214285714285714,133,0.75187969924812
"6924",2024,"Carolina University",NA,NA,NA,15,26,13,7,0,18,0,11,13,24,9,28,43,8,35,0,0,0,3,0.2,90,10
"6925",2024,"Carroll (MT)",NA,NA,NA,6,13,8,7,0,13,0,3,3,6,4,14,46,10,36,0,0,0,1,0.166666666666667,48,8.33333333333333
"6926",2024,"Centenary (LA)",NA,NA,NA,11,29,27,14,0,19,0,4,11,15,4,30,34,7,27,0,0,0,0,0,86,4.65116279069767
"6927",2024,"Central Baptist College",NA,NA,NA,7,32,7,6,0,22,0,3,7,10,9,30,38,6,32,0,0,0,1,0.142857142857143,80,11.25
"6928",2024,"Chadron State",NA,NA,NA,7,17,5,3,0,10,0,8,15,23,4,15,24,4,20,0,0,0,0,0,51,7.84313725490196
"6929",2024,"Chaminade",NA,NA,NA,10,16,16,9,0,15,0,9,12,21,9,9,49,14,35,0,0,0,4,0.4,60,15
"6930",2024,"Champion Christian",NA,NA,NA,27,57,20,13,0,34,0,8,11,19,17,80,87,22,65,0,0,0,10,0.37037037037037,200,8.5
"6931",2024,"Chapman",NA,NA,NA,18,16,13,7,0,24,0,4,6,10,8,27,48,9,39,0,0,0,5,0.277777777777778,75,10.6666666666667
"6932",2024,"Chestnut Hill College",NA,NA,NA,12,27,7,4,0,14,0,7,20,27,3,14,33,13,20,0,0,0,5,0.416666666666667,75,4
"6933",2024,"Cheyney (PA)",NA,NA,NA,5,14,10,4,0,21,0,2,6,8,8,16,44,9,35,0,0,0,0,0,47,17.0212765957447
"6934",2024,"Chowan",NA,NA,NA,15,24,8,6,0,19,0,5,5,10,8,29,50,16,34,0,0,0,4,0.266666666666667,89,8.98876404494382
"6935",2024,"Cleary University",NA,NA,NA,12,31,11,6,0,15,0,10,11,21,8,38,28,9,19,0,0,0,7,0.583333333333333,103,7.76699029126214
"6936",2024,"Coastal Georgia",NA,NA,NA,8,17,9,6,0,19,0,2,11,13,5,39,22,5,17,0,0,0,4,0.5,73,6.84931506849315
"6937",2024,"Coker",NA,NA,NA,17,22,11,6,0,19,0,9,10,19,11,21,39,11,28,0,0,0,7,0.411764705882353,83,13.2530120481928
"6938",2024,"College Of Biblical Studies",NA,NA,NA,12,20,9,1,0,14,0,1,2,3,1,57,40,7,33,0,0,0,2,0.166666666666667,97,1.03092783505155
"6939",2024,"College of Idaho",NA,NA,NA,14,25,8,4,0,17,0,3,12,15,8,18,47,9,38,0,0,0,2,0.142857142857143,69,11.5942028985507
"6940",2024,"Colorado Christian",NA,NA,NA,7,22,10,8,0,16,0,7,8,15,7,14,41,14,27,0,0,0,1,0.142857142857143,67,10.4477611940298
"6941",2024,"Colorado-Colorado Springs",NA,NA,NA,7,30,14,9,0,13,0,12,10,22,17,34,19,7,12,0,0,0,2,0.285714285714286,92,18.4782608695652
"6942",2024,"Columbia College (SC)",NA,NA,NA,17,62,19,13,0,30,0,20,25,45,13,47,65,20,45,0,0,0,7,0.411764705882353,172,7.55813953488372
"6943",2024,"Columbia International",NA,NA,NA,11,16,7,5,0,11,0,3,10,13,8,13,49,9,40,0,0,0,3,0.272727272727273,53,15.0943396226415
"6944",2024,"Concord",NA,NA,NA,8,23,8,6,0,21,0,15,12,27,5,19,24,5,19,0,0,0,2,0.25,72,6.94444444444444
"6945",2024,"Concordia Moorhead",NA,NA,NA,12,21,12,7,0,17,0,1,1,2,7,25,50,16,34,0,0,0,5,0.416666666666667,79,8.86075949367089
"6946",2024,"Concordia-Ann Arbor",NA,NA,NA,8,30,17,9,0,19,0,9,12,21,4,12,38,10,28,0,0,0,1,0.125,73,5.47945205479452
"6947",2024,"Concordia-Chicago",NA,NA,NA,9,20,3,2,0,20,0,4,12,16,7,20,46,9,37,0,0,0,2,0.222222222222222,64,10.9375
"6948",2024,"Concordia-Texas",NA,NA,NA,12,27,5,2,0,17,0,12,10,22,6,30,33,7,26,0,0,0,3,0.25,90,6.66666666666667
"6949",2024,"Connecticut College",NA,NA,NA,10,53,10,4,0,20,0,8,30,38,15,43,64,22,42,0,0,0,2,0.2,138,10.8695652173913
"6950",2024,"Converse",NA,NA,NA,21,43,16,8,0,36,0,15,27,42,11,35,70,13,57,0,0,0,4,0.19047619047619,131,8.3969465648855
"6951",2024,"Corban University",NA,NA,NA,10,26,2,2,0,7,0,8,14,22,5,14,44,12,32,0,0,0,2,0.2,72,6.94444444444444
"6952",2024,"Cornell College (IA)",NA,NA,NA,6,13,2,2,0,16,0,2,5,7,5,19,47,18,29,0,0,0,0,0,58,8.62068965517241
"6953",2024,"Cumberland (TN)",NA,NA,NA,24,48,21,13,0,31,0,18,22,40,8,49,74,22,52,0,0,0,10,0.416666666666667,166,4.81927710843374
"6954",2024,"D'Youville",NA,NA,NA,11,20,11,7,0,17,0,12,10,22,7,10,32,9,23,0,0,0,1,0.0909090909090909,66,10.6060606060606
"6955",2024,"Dallas Christian",NA,NA,NA,7,14,2,1,0,9,0,3,6,9,3,23,45,17,28,0,0,0,2,0.285714285714286,65,4.61538461538462
"6956",2024,"Davenport",NA,NA,NA,3,20,5,2,0,19,0,11,12,23,7,20,22,8,14,0,0,0,1,0.333333333333333,62,11.2903225806452
"6957",2024,"Davis & Elkins",NA,NA,NA,13,22,5,3,0,15,0,7,17,24,7,28,35,4,31,0,0,0,0,0,75,9.33333333333333
"6958",2024,"Dickinson State (ND)",NA,NA,NA,6,18,7,4,0,10,0,8,8,16,4,19,38,8,30,0,0,0,1,0.166666666666667,61,6.55737704918033
"6959",2024,"Dillard",NA,NA,NA,16,57,18,12,0,46,0,19,33,52,20,53,61,9,52,0,0,0,4,0.25,156,12.8205128205128
"6960",2024,"Dordt",NA,NA,NA,13,27,9,6,0,16,0,9,21,30,5,14,27,10,17,0,0,0,2,0.153846153846154,76,6.57894736842105
"6961",2024,"East Stroudsburg University",NA,NA,NA,14,29,10,5,0,22,0,4,13,17,4,27,39,11,28,0,0,0,7,0.5,88,4.54545454545455
"6962",2024,"Eastern Mennonite",NA,NA,NA,8,16,3,2,0,16,0,5,19,24,4,18,40,7,33,0,0,0,1,0.125,55,7.27272727272727
"6963",2024,"Ecclesia",NA,NA,NA,4,15,12,6,0,16,0,4,7,11,6,31,26,5,21,0,0,0,1,0.25,62,9.67741935483871
"6964",2024,"Edgewood",NA,NA,NA,1,24,6,6,0,15,0,9,6,15,4,24,25,6,19,0,0,0,0,0,65,6.15384615384615
"6965",2024,"Emmanuel (MA)",NA,NA,NA,21,21,7,3,0,9,0,12,13,25,10,26,32,8,24,0,0,0,4,0.19047619047619,89,11.2359550561798
"6966",2024,"Emory & Henry",NA,NA,NA,12,28,7,4,0,15,0,5,13,18,7,18,41,8,33,0,0,0,3,0.25,74,9.45945945945946
"6967",2024,"Erskine",NA,NA,NA,26,42,24,12,0,36,0,11,25,36,18,52,82,19,63,0,0,0,6,0.230769230769231,156,11.5384615384615
"6968",2024,"Fairmont St",NA,NA,NA,7,17,13,9,0,20,0,14,18,32,11,23,20,5,15,0,0,0,1,0.142857142857143,70,15.7142857142857
"6969",2024,"Farmingdale State",NA,NA,NA,5,14,8,5,0,11,0,4,7,11,1,32,24,4,20,0,0,0,2,0.4,61,1.63934426229508
"6970",2024,"Fisher College",NA,NA,NA,9,17,0,0,0,11,0,4,14,18,4,29,29,6,23,0,0,0,1,0.111111111111111,65,6.15384615384615
"6971",2024,"Five Towns College",NA,NA,NA,14,24,17,11,0,16,0,3,9,12,8,19,39,12,27,0,0,0,2,0.142857142857143,76,10.5263157894737
"6972",2024,"Flagler",NA,NA,NA,8,32,10,8,0,18,0,4,5,9,7,16,47,15,32,0,0,0,4,0.5,77,9.09090909090909
"6973",2024,"Florida National",NA,NA,NA,17,22,20,8,0,22,1,3,19,22,12,33,36,5,31,0,0,0,4,0.235294117647059,84,14.2857142857143
"6974",2024,"Francis Marion",NA,NA,NA,16,25,11,5,0,18,0,10,10,20,7,9,51,13,38,0,0,0,4,0.25,75,9.33333333333333
"6975",2024,"Freed-Hardeman",NA,NA,NA,8,20,8,6,0,22,0,5,1,6,10,23,39,8,31,0,0,0,2,0.25,66,15.1515151515152
"6976",2024,"Fresno Pacific",NA,NA,NA,8,16,9,6,0,20,0,2,12,14,7,26,34,12,22,0,0,0,2,0.25,67,10.4477611940298
"6977",2024,"Frostburg State",NA,NA,NA,12,21,10,6,0,14,0,5,12,17,9,14,40,12,28,0,0,0,7,0.583333333333333,68,13.2352941176471
"6978",2024,"Georgian Court University",NA,NA,NA,29,41,16,9,0,34,0,17,23,40,15,47,74,19,55,0,0,0,4,0.137931034482759,154,9.74025974025974
"6979",2024,"Goucher",NA,NA,NA,7,26,5,3,0,17,0,1,4,5,2,23,57,18,39,0,0,0,1,0.142857142857143,75,2.66666666666667
"6980",2024,"Grand Valley State",NA,NA,NA,7,27,11,7,0,17,0,8,6,14,7,32,27,8,19,0,0,0,0,0,83,8.43373493975904
"6981",2024,"Great Lakes Christian",NA,NA,NA,10,22,7,4,0,19,0,0,4,4,3,31,49,14,35,0,0,0,1,0.1,77,3.8961038961039
"6982",2024,"Guilford",NA,NA,NA,19,23,3,2,0,22,0,10,19,29,7,30,40,7,33,0,0,0,2,0.105263157894737,89,7.86516853932584
"6983",2024,"Gwynedd-Mercy",NA,NA,NA,17,20,4,2,0,10,0,7,16,23,4,15,43,7,36,0,0,0,4,0.235294117647059,67,5.97014925373134
"6984",2024,"Hannibal-LaGrange College",NA,NA,NA,13,21,2,2,0,19,0,3,15,18,3,25,38,6,32,0,0,0,3,0.230769230769231,68,4.41176470588235
"6985",2024,"Hanover",NA,NA,NA,8,22,5,3,0,19,0,4,5,9,6,35,35,13,22,0,0,0,2,0.25,82,7.31707317073171
"6986",2024,"Harris-Stowe State",NA,NA,NA,37,69,52,31,0,49,0,30,47,77,19,82,68,14,54,0,0,0,12,0.324324324324324,246,7.72357723577236
"6987",2024,"Hastings",NA,NA,NA,6,21,3,2,0,20,0,4,8,12,7,22,47,17,30,0,0,0,2,0.333333333333333,72,9.72222222222222
"6988",2024,"Hendrix College",NA,NA,NA,19,37,13,6,1,21,0,3,10,13,7,60,80,10,70,0,0,0,1,0.0526315789473684,133,5.26315789473684
"6989",2024,"Hillsdale",NA,NA,NA,10,15,8,6,0,19,0,5,9,14,7,18,42,12,30,0,0,0,3,0.3,62,11.2903225806452
"6990",2024,"Howard Payne",NA,NA,NA,37,42,38,21,0,43,0,3,20,23,6,44,87,23,64,0,0,0,12,0.324324324324324,160,3.75
"6991",2024,"Huston-Tillotson",NA,NA,NA,19,17,21,11,0,26,0,10,10,20,7,27,35,10,25,0,0,0,7,0.368421052631579,85,8.23529411764706
"6992",2024,"Jamestown",NA,NA,NA,13,22,23,14,0,25,0,11,11,22,3,25,29,7,22,0,0,0,7,0.538461538461538,83,3.6144578313253
"6993",2024,"Johnson & Wales (NC)",NA,NA,NA,36,41,23,16,0,35,0,17,31,48,18,64,79,18,61,0,0,0,10,0.277777777777778,181,9.94475138121547
"6994",2024,"Johnson & Wales (RI)",NA,NA,NA,16,20,11,6,0,14,0,3,7,10,10,22,48,8,40,0,0,0,5,0.3125,71,14.0845070422535
"6995",2024,"Johnson C Smith",NA,NA,NA,21,45,23,13,0,42,0,10,31,41,18,33,67,21,46,0,0,0,10,0.476190476190476,136,13.2352941176471
"6996",2024,"Johnson University (FL)",NA,NA,NA,10,12,3,1,0,15,0,2,4,6,7,29,41,7,34,0,0,0,1,0.1,60,11.6666666666667
"6997",2024,"Johnson University (TN)",NA,NA,NA,8,22,10,7,0,12,0,17,13,30,6,23,24,2,22,0,0,0,1,0.125,76,7.89473684210526
"6998",2024,"Kansas Christian",NA,NA,NA,11,13,16,10,0,22,0,2,7,9,8,34,37,8,29,0,0,0,3,0.272727272727273,71,11.2676056338028
"6999",2024,"Keene State",NA,NA,NA,14,22,4,2,0,11,0,2,5,7,6,16,53,14,39,0,0,0,5,0.357142857142857,69,8.69565217391304
"7000",2024,"Keuka",NA,NA,NA,8,15,0,0,0,9,0,3,6,9,3,29,42,7,35,0,0,0,2,0.25,62,4.83870967741935
"7001",2024,"King (TN)",NA,NA,NA,10,11,6,3,0,11,0,4,11,15,9,22,33,9,24,0,0,0,5,0.5,57,15.7894736842105
"7002",2024,"Knox",NA,NA,NA,9,19,8,5,0,18,0,9,17,26,9,24,33,7,26,0,0,0,1,0.111111111111111,68,13.2352941176471
"7003",2024,"Kutztown",NA,NA,NA,8,9,11,8,0,25,0,7,8,15,5,21,31,7,24,0,0,0,2,0.25,55,9.09090909090909
"7004",2024,"Kuyper",NA,NA,NA,18,15,15,8,0,21,0,5,22,27,6,22,39,6,33,0,0,0,2,0.111111111111111,67,8.95522388059701
"7005",2024,"LSU Alexandria",NA,NA,NA,31,40,24,13,0,39,0,13,14,27,15,59,62,16,46,0,0,0,15,0.483870967741935,165,9.09090909090909
"7006",2024,"LSU Shreveport",NA,NA,NA,17,25,13,6,0,16,0,10,13,23,5,18,29,7,22,0,0,0,4,0.235294117647059,81,6.17283950617284
"7007",2024,"La Roche",NA,NA,NA,8,14,6,3,0,17,0,6,14,20,3,27,28,5,23,0,0,0,1,0.125,61,4.91803278688525
"7008",2024,"La Sierra",NA,NA,NA,7,18,5,4,0,16,0,6,4,10,4,32,34,8,26,0,0,0,2,0.285714285714286,73,5.47945205479452
"7009",2024,"La Verne",NA,NA,NA,17,17,9,6,0,13,0,1,12,13,2,13,63,18,45,0,0,0,4,0.235294117647059,68,2.94117647058824
"7010",2024,"LaGrange",NA,NA,NA,39,50,24,15,0,34,0,15,20,35,6,45,93,20,73,0,0,0,12,0.307692307692308,178,3.37078651685393
"7011",2024,"Lake Erie",NA,NA,NA,11,27,6,4,0,14,0,2,12,14,5,33,32,3,29,0,0,0,0,0,76,6.57894736842105
"7012",2024,"Lancaster Bible College",NA,NA,NA,29,37,12,5,0,12,0,12,29,41,13,44,86,15,71,0,0,0,5,0.172413793103448,138,9.42028985507246
"7013",2024,"LeMoyne-Owen",NA,NA,NA,11,15,13,11,0,26,0,3,10,13,12,25,44,6,38,0,0,0,4,0.363636363636364,63,19.047619047619
"7014",2024,"LeTourneau",NA,NA,NA,9,22,7,4,0,12,0,5,4,9,7,30,45,10,35,0,0,0,1,0.111111111111111,77,9.09090909090909
"7015",2024,"Lees-McRae",NA,NA,NA,30,58,36,19,0,57,0,11,19,30,27,63,123,33,90,0,0,0,9,0.3,203,13.3004926108374
"7016",2024,"Lehman College",NA,NA,NA,5,18,16,7,0,13,0,1,7,8,4,35,26,2,24,0,0,0,0,0,66,6.06060606060606
"7017",2024,"Life Pacific",NA,NA,NA,10,39,4,4,0,26,0,12,21,33,3,32,81,22,59,0,0,0,0,0,116,2.58620689655172
"7018",2024,"Life University",NA,NA,NA,27,50,19,9,0,22,0,20,33,53,14,42,62,10,52,0,0,0,7,0.259259259259259,155,9.03225806451613
"7019",2024,"Lincoln (CA)",NA,NA,NA,11,17,8,5,0,11,0,6,14,20,4,20,40,8,32,0,0,0,3,0.272727272727273,65,6.15384615384615
"7020",2024,"Lincoln (PA)",NA,NA,NA,10,23,8,5,0,17,0,6,6,12,9,22,45,14,31,0,0,0,4,0.4,80,11.25
"7021",2024,"Lincoln Memorial",NA,NA,NA,10,14,6,4,0,19,0,13,7,20,7,19,34,10,24,0,0,0,2,0.2,67,10.4477611940298
"7022",2024,"Livingstone",NA,NA,NA,10,26,4,3,0,10,0,8,11,19,9,24,33,4,29,0,0,0,2,0.2,73,12.3287671232877
"7023",2024,"Louisiana Christian",NA,NA,NA,35,62,40,23,0,55,0,15,15,30,15,74,125,34,91,0,0,0,10,0.285714285714286,224,6.69642857142857
"7024",2024,"Madonna",NA,NA,NA,14,20,8,5,0,24,0,7,18,25,4,30,38,6,32,0,0,0,3,0.214285714285714,79,5.06329113924051
"7025",2024,"Mary Washington",NA,NA,NA,11,21,14,9,0,18,0,6,9,15,4,32,31,8,23,0,0,0,6,0.545454545454545,82,4.8780487804878
"7026",2024,"Master's University",NA,NA,NA,6,28,7,4,0,12,0,11,11,22,7,19,29,7,22,0,0,0,0,0,74,9.45945945945946
"7027",2024,"McMurry",NA,NA,NA,3,28,9,7,0,17,1,9,16,25,8,22,29,11,18,0,0,0,0,0,76,10.5263157894737
"7028",2024,"Menlo",NA,NA,NA,11,22,3,2,0,16,0,10,16,26,7,15,39,6,33,0,0,0,2,0.181818181818182,64,10.9375
"7029",2024,"Mercy",NA,NA,NA,16,18,13,8,0,16,0,8,10,18,8,23,30,5,25,0,0,0,4,0.25,72,11.1111111111111
"7030",2024,"Miami (OH)-Hamilton",NA,NA,NA,5,18,7,4,0,14,0,8,7,15,4,30,34,10,24,0,0,0,2,0.4,74,5.4054054054054
"7031",2024,"Mid-America Christian",NA,NA,NA,15,27,16,11,0,24,0,17,23,40,11,24,29,8,21,0,0,0,3,0.2,94,11.7021276595745
"7032",2024,"Mid-Atlantic Christian",NA,NA,NA,11,15,16,9,0,8,0,2,2,4,2,53,22,2,20,0,0,0,5,0.454545454545455,87,2.29885057471264
"7033",2024,"Millsaps",NA,NA,NA,8,30,14,8,0,17,0,4,5,9,6,24,30,4,26,0,0,0,1,0.125,73,8.21917808219178
"7034",2024,"Minot State",NA,NA,NA,15,16,13,8,0,15,0,4,3,7,8,17,49,13,36,0,0,0,3,0.2,69,11.5942028985507
"7035",2024,"Mobile",NA,NA,NA,32,34,23,16,0,38,0,15,14,29,18,28,95,20,75,0,0,0,11,0.34375,132,13.6363636363636
"7036",2024,"Montreat",NA,NA,NA,21,35,14,9,0,21,0,16,27,43,9,31,59,14,45,0,0,0,7,0.333333333333333,119,7.56302521008403
"7037",2024,"Mount Marty College",NA,NA,NA,8,25,9,4,0,17,0,6,9,15,3,24,40,6,34,0,0,0,1,0.125,69,4.34782608695652
"7038",2024,"Mount Mercy College",NA,NA,NA,8,25,11,6,0,20,0,9,9,18,7,16,43,13,30,0,0,0,1,0.125,71,9.85915492957746
"7039",2024,"Mount Olive",NA,NA,NA,9,21,6,3,0,21,0,3,15,18,9,16,37,12,25,0,0,0,2,0.222222222222222,62,14.5161290322581
"7040",2024,"Mount St. Joseph",NA,NA,NA,9,12,6,4,0,13,0,3,7,10,6,21,43,15,28,0,0,0,1,0.111111111111111,61,9.83606557377049
"7041",2024,"Mount Vernon Nazarene (OH)",NA,NA,NA,5,28,8,5,0,19,0,14,22,36,5,16,24,11,13,0,0,0,1,0.2,75,6.66666666666667
"7042",2024,"NC Wesleyan",NA,NA,NA,44,64,27,16,0,41,0,14,34,48,15,74,135,31,104,0,0,0,13,0.295454545454545,232,6.46551724137931
"7043",2024,"North American",NA,NA,NA,63,89,49,34,0,81,1,41,45,86,36,98,187,51,136,0,0,0,19,0.301587301587302,351,10.2564102564103
"7044",2024,"North Greenville",NA,NA,NA,4,27,12,7,0,16,0,4,9,13,5,16,40,7,33,0,0,0,0,0,58,8.62068965517241
"7045",2024,"Northern New Mexico",NA,NA,NA,10,19,10,7,0,23,0,2,8,10,6,24,45,8,37,0,0,0,2,0.2,64,9.375
"7046",2024,"Northern State",NA,NA,NA,10,26,9,5,0,16,0,5,4,9,5,21,48,17,31,0,0,0,7,0.7,82,6.09756097560976
"7047",2024,"Notre Dame of Maryland University",NA,NA,NA,15,19,9,5,0,14,0,5,13,18,9,31,27,6,21,0,0,0,2,0.133333333333333,79,11.3924050632911
"7048",2024,"Oakland City",NA,NA,NA,19,34,18,13,0,36,0,17,25,42,19,55,54,15,39,0,0,0,5,0.263157894736842,144,13.1944444444444
"7049",2024,"Ohio Dominican",NA,NA,NA,10,16,18,10,0,19,0,11,9,20,8,14,35,12,23,0,0,0,4,0.4,66,12.1212121212121
"7050",2024,"Oklahoma Wesleyan",NA,NA,NA,8,26,6,3,0,18,0,8,12,20,2,25,42,11,31,0,0,0,1,0.125,80,2.5
"7051",2024,"Our Lady Of The Lake",NA,NA,NA,16,44,19,10,0,41,0,13,17,30,14,46,67,14,53,0,0,0,4,0.25,138,10.1449275362319
"7052",2024,"Panhandle State (OK)",NA,NA,NA,13,24,10,7,0,18,0,5,8,13,7,42,35,10,25,0,0,0,1,0.0769230769230769,95,7.36842105263158
"7053",2024,"Park University Gilbert",NA,NA,NA,6,21,20,11,0,27,0,9,7,16,10,22,41,10,31,0,0,0,2,0.333333333333333,72,13.8888888888889
"7054",2024,"Penn State (Beaver)",NA,NA,NA,6,20,9,5,0,10,0,11,12,23,6,23,25,4,21,0,0,0,2,0.333333333333333,66,9.09090909090909
"7055",2024,"Peru State",NA,NA,NA,7,26,7,5,0,28,0,7,11,18,7,12,54,19,35,0,0,0,3,0.428571428571429,72,9.72222222222222
"7056",2024,"Pfeiffer",NA,NA,NA,9,47,16,10,0,31,0,6,13,19,5,56,69,12,57,0,0,0,2,0.222222222222222,131,3.81679389312977
"7057",2024,"Piedmont",NA,NA,NA,10,15,9,6,0,10,0,9,7,16,7,21,42,16,26,0,0,0,4,0.4,75,9.33333333333333
"7058",2024,"Point Park",NA,NA,NA,19,26,5,3,0,10,0,16,8,24,9,38,40,7,33,0,0,0,4,0.210526315789474,107,8.41121495327103
"7059",2024,"Puerto Rico-Mayaguez",NA,NA,NA,18,54,14,8,0,63,1,21,24,45,30,59,112,22,90,0,0,0,7,0.388888888888889,179,16.7597765363128
"7060",2024,"Quincy",NA,NA,NA,28,25,13,7,0,18,0,11,14,25,9,13,56,18,38,0,0,0,9,0.321428571428571,99,9.09090909090909
"7061",2024,"Randolph College",NA,NA,NA,6,22,2,2,0,11,0,3,7,10,9,12,51,15,36,0,0,0,0,0,58,15.5172413793103
"7062",2024,"Regent University",NA,NA,NA,6,11,8,7,0,12,0,1,1,2,5,23,50,14,36,0,0,0,2,0.333333333333333,57,8.7719298245614
"7063",2024,"Regis (CO)",NA,NA,NA,19,32,17,12,0,16,0,17,9,26,3,23,31,6,25,0,0,0,7,0.368421052631579,103,2.9126213592233
"7064",2024,"Rocky Mountain",NA,NA,NA,18,21,8,5,0,13,0,7,9,16,6,17,45,11,34,0,0,0,6,0.333333333333333,75,8
"7065",2024,"Roosevelt",NA,NA,NA,8,14,6,4,0,17,0,4,4,8,4,13,50,13,37,0,0,0,2,0.25,52,7.69230769230769
"7066",2024,"Saginaw Valley State",NA,NA,NA,8,19,20,12,0,16,0,10,7,17,15,22,29,3,26,0,0,0,3,0.375,66,22.7272727272727
"7067",2024,"Saint Augustine's",NA,NA,NA,11,24,6,3,0,19,0,7,3,10,8,17,52,14,38,0,0,0,6,0.545454545454545,74,10.8108108108108
"7068",2024,"Saint Elizabeth",NA,NA,NA,11,24,8,7,0,21,0,3,0,3,15,44,46,15,31,0,0,0,1,0.0909090909090909,99,15.1515151515152
"7069",2024,"Saint Martin's",NA,NA,NA,13,22,7,4,0,13,0,7,18,25,6,15,36,10,26,0,0,0,4,0.307692307692308,68,8.82352941176471
"7070",2024,"Saint Rose",NA,NA,NA,13,23,4,4,0,6,0,7,16,23,8,16,31,10,21,0,0,0,2,0.153846153846154,71,11.2676056338028
"7071",2024,"Salem College",NA,NA,NA,8,18,5,3,0,21,0,8,3,11,7,35,38,14,24,0,0,0,2,0.25,83,8.43373493975904
"7072",2024,"Sarah Lawrence",NA,NA,NA,2,22,3,1,0,13,0,4,11,15,3,39,26,8,18,0,0,0,0,0,75,4
"7073",2024,"Schreiner",NA,NA,NA,40,70,26,14,0,48,0,21,31,52,18,85,105,27,78,0,0,0,10,0.25,248,7.25806451612903
"7074",2024,"Science & Arts (OK)",NA,NA,NA,11,23,11,7,0,20,0,14,12,26,7,11,44,12,32,0,0,0,3,0.272727272727273,74,9.45945945945946
"7075",2024,"Simmons College (KY)",NA,NA,NA,13,18,4,3,0,14,0,8,11,19,5,28,41,7,34,0,0,0,4,0.307692307692308,75,6.66666666666667
"7076",2024,"Slippery Rock",NA,NA,NA,20,36,19,11,0,43,0,5,8,13,16,40,87,20,67,0,0,0,6,0.3,124,12.9032258064516
"7077",2024,"South Dakota Mines",NA,NA,NA,14,26,10,5,0,13,0,2,3,5,4,20,52,18,34,0,0,0,2,0.142857142857143,81,4.93827160493827
"7078",2024,"Southern Wesleyan",NA,NA,NA,24,72,38,22,0,51,0,29,37,66,21,53,99,21,78,0,0,0,7,0.291666666666667,205,10.2439024390244
"7079",2024,"Southern-New Orleans",NA,NA,NA,26,58,24,14,0,41,0,9,12,21,12,72,137,34,103,0,0,0,4,0.153846153846154,203,5.91133004926108
"7080",2024,"Southwestern Assemblies of God",NA,NA,NA,15,21,13,8,0,22,0,7,4,11,9,20,45,11,34,0,0,0,2,0.133333333333333,78,11.5384615384615
"7081",2024,"Spring Hill",NA,NA,NA,10,27,7,5,0,15,0,6,11,17,5,28,35,9,26,0,0,0,1,0.1,80,6.25
"7082",2024,"St. Thomas (FL)",NA,NA,NA,7,23,5,3,0,11,1,4,10,14,6,16,45,19,26,0,0,0,0,0,70,8.57142857142857
"7083",2024,"St. Thomas (TX)",NA,NA,NA,25,58,33,19,0,40,0,3,13,16,10,44,90,24,66,0,0,0,4,0.16,158,6.32911392405063
"7084",2024,"Stanislaus State",NA,NA,NA,24,48,20,16,0,44,0,16,25,41,15,49,89,28,61,0,0,0,5,0.208333333333333,173,8.67052023121387
"7085",2024,"Stephens",NA,NA,NA,26,31,15,9,0,43,0,20,25,45,19,37,72,21,51,0,0,0,8,0.307692307692308,137,13.8686131386861
"7086",2024,"Susquehanna",NA,NA,NA,8,25,15,9,0,22,0,7,12,19,11,24,31,5,26,0,0,0,3,0.375,72,15.2777777777778
"7087",2024,"Tennessee Wesleyan",NA,NA,NA,21,46,19,14,0,27,0,15,20,35,8,50,65,16,49,0,0,0,4,0.19047619047619,152,5.26315789473684
"7088",2024,"Texas A&M-Kingsville",NA,NA,NA,14,37,11,6,0,32,0,19,16,35,10,38,65,22,43,0,0,0,3,0.214285714285714,132,7.57575757575758
"7089",2024,"Texas A&M-Texarkana",NA,NA,NA,12,22,13,9,0,20,0,5,15,20,10,28,39,11,28,0,0,0,2,0.166666666666667,79,12.6582278481013
"7090",2024,"Texas College",NA,NA,NA,21,30,11,8,0,49,0,14,19,33,9,53,76,17,59,0,0,0,5,0.238095238095238,140,6.42857142857143
"7091",2024,"Texas Lutheran",NA,NA,NA,18,21,4,2,0,22,0,5,12,17,5,16,44,10,34,0,0,0,3,0.166666666666667,71,7.04225352112676
"7092",2024,"Tougaloo",NA,NA,NA,24,40,8,5,0,47,1,14,11,25,12,61,92,29,63,0,0,0,7,0.291666666666667,171,7.01754385964912
"7093",2024,"Trevecca Nazarene",NA,NA,NA,10,25,21,16,0,12,0,11,6,17,3,15,30,10,20,0,0,0,2,0.2,75,4
"7094",2024,"Trinity Baptist",NA,NA,NA,27,49,34,20,0,28,0,7,20,27,9,69,81,19,62,0,0,0,7,0.259259259259259,181,4.97237569060773
"7095",2024,"UC Merced",NA,NA,NA,10,14,7,4,0,13,0,7,2,9,2,14,45,12,33,0,0,0,5,0.5,60,3.33333333333333
"7096",2024,"UC Santa Cruz",NA,NA,NA,7,15,10,4,0,8,0,7,7,14,5,19,41,11,30,0,0,0,2,0.285714285714286,60,8.33333333333333
"7097",2024,"UNC Pembroke",NA,NA,NA,11,23,5,4,0,12,0,6,12,18,10,23,42,11,31,0,0,0,2,0.181818181818182,75,13.3333333333333
"7098",2024,"UVA Wise",NA,NA,NA,5,19,10,8,0,18,0,10,14,24,5,15,27,13,14,0,0,0,1,0.2,65,7.69230769230769
"7099",2024,"UW-Parkside",NA,NA,NA,6,15,5,4,0,10,0,10,6,16,8,14,45,12,33,0,0,0,1,0.166666666666667,59,13.5593220338983
"7100",2024,"University Of New England",NA,NA,NA,10,24,10,6,0,18,0,7,5,12,5,29,30,5,25,0,0,0,1,0.1,77,6.49350649350649
"7101",2024,"University of Wisconsin River Falls",NA,NA,NA,7,19,9,7,0,17,0,7,11,18,6,26,39,15,24,0,0,0,4,0.571428571428571,76,7.89473684210526
"7102",2024,"Unt Dallas",NA,NA,NA,36,86,52,25,0,88,0,28,40,68,42,108,156,38,118,0,0,0,7,0.194444444444444,302,13.9072847682119
"7103",2024,"Viterbo",NA,NA,NA,9,13,7,3,0,21,0,10,5,15,7,32,30,4,26,0,0,0,4,0.444444444444444,70,10
"7104",2024,"Vtsu Lyndon",NA,NA,NA,7,14,3,0,0,6,0,4,5,9,1,22,33,11,22,0,0,0,2,0.285714285714286,58,1.72413793103448
"7105",2024,"Walla Walla",NA,NA,NA,18,46,16,7,0,35,0,13,25,38,11,54,55,18,37,0,0,0,3,0.166666666666667,152,7.23684210526316
"7106",2024,"Warner Pacific",NA,NA,NA,37,69,20,13,0,48,0,30,34,64,22,81,99,34,65,0,0,0,9,0.243243243243243,256,8.59375
"7107",2024,"Warner University",NA,NA,NA,29,78,20,14,1,45,0,28,23,51,25,73,117,30,87,0,0,0,10,0.344827586206897,247,10.1214574898785
"7108",2024,"Warren Wilson",NA,NA,NA,12,24,10,5,0,14,0,2,5,7,2,32,38,8,30,0,0,0,4,0.333333333333333,80,2.5
"7109",2024,"Washburn",NA,NA,NA,13,17,13,7,0,22,0,16,19,35,8,9,34,7,27,0,0,0,5,0.384615384615385,66,12.1212121212121
"7110",2024,"Washington Adventist",NA,NA,NA,21,47,19,11,0,35,0,15,22,37,23,50,77,31,46,0,0,0,4,0.19047619047619,167,13.7724550898204
"7111",2024,"Webber International",NA,NA,NA,22,55,22,14,0,40,0,12,23,35,12,60,67,15,52,0,0,0,2,0.0909090909090909,168,7.14285714285714
"7112",2024,"Wesleyan College (GA)",NA,NA,NA,5,16,6,5,0,13,0,4,11,15,4,21,36,8,28,0,0,0,1,0.2,54,7.40740740740741
"7113",2024,"West Virginia State",NA,NA,NA,15,21,14,7,0,15,0,7,14,21,8,27,38,7,31,0,0,0,1,0.0666666666666667,81,9.87654320987654
"7114",2024,"Westcliff",NA,NA,NA,11,18,2,1,0,15,0,1,7,8,8,21,47,16,31,0,0,0,2,0.181818181818182,67,11.9402985074627
"7115",2024,"Western New Mexico",NA,NA,NA,41,65,31,17,0,51,0,23,32,55,20,73,107,38,69,0,0,0,15,0.365853658536585,250,8
"7116",2024,"Westminster (UT)",NA,NA,NA,19,60,20,13,0,22,0,20,21,41,13,55,47,13,34,0,0,0,7,0.368421052631579,171,7.60233918128655
"7117",2024,"Whittier",NA,NA,NA,16,28,10,6,0,13,0,7,4,11,4,19,43,12,31,0,0,0,1,0.0625,83,4.81927710843374
"7118",2024,"Wilberforce",NA,NA,NA,9,30,10,6,0,25,0,5,3,8,11,36,36,12,24,0,0,0,2,0.222222222222222,94,11.7021276595745
"7119",2024,"Wiley",NA,NA,NA,12,20,6,3,0,12,0,10,10,20,5,42,25,4,21,0,0,0,4,0.333333333333333,90,5.55555555555556
"7120",2024,"Willamette",NA,NA,NA,8,22,7,4,0,13,0,4,5,9,4,19,45,11,34,0,0,0,3,0.375,66,6.06060606060606
"7121",2024,"William Carey",NA,NA,NA,10,19,8,4,0,12,0,6,5,11,6,22,44,12,32,0,0,0,5,0.5,71,8.45070422535211
"7122",2024,"William Jessup",NA,NA,NA,11,20,10,6,0,12,0,6,12,18,8,13,42,9,33,0,0,0,4,0.363636363636364,62,12.9032258064516
"7123",2024,"Wingate",NA,NA,NA,12,32,11,9,0,12,0,9,10,19,3,15,37,15,22,0,0,0,1,0.0833333333333333,84,3.57142857142857
"7124",2024,"Wisconsin-Stevens Point",NA,NA,NA,10,15,11,7,0,23,0,3,5,8,10,18,49,15,34,0,0,0,2,0.2,64,15.625
